HEIGHT=16;WIDTH=201;THEME=0;OVERRIDE=false
--------------------------------------------------------------------------------------------------------------------------------------------------------------------------------------------------------
--------------------------------------------------------------------------------------------------------------------------------------------------------------------------------------------------------
--------------------------------------------------------------------------------------------------------------------------------------------------------------------------------------------------------
--------------------------------------------------------------------------------------------------------------------------------------------------------------------------------------------------------
--------------------------------------------------------------------------------------------------------------------------------------------------------------------------------------------------------
--------------------------------------------------------------------------------------------------------------------------------------------------------------------------------------------------------
--------------------------------------------------------------------------------------------------------------------------------------------------------------------------------------------------------
--------------------------%%%%%%------------------------------------------------------------------------------------------------------------------------------------------------------------------------
--------------------------||||||------------------------------------------------------------------------------------------------------------------------------------------------------------------------
--------------------------||y|||------------------------------------------------------------------------------------------------------------------------------------------------------------------------
------------------------%%%%%%||----------------------------------------------------------------------------------#---#---------------------------------------------------------------------------------
--------------------r---||||||||------#--#------------------------------------%%%%-------------------------------##---##--------------------------------------------------------------------------------
---------------%%%%%%---||||||||-----##--##-----------------------------------||||------------------------------###---###--%%---%%----------------------------------------------------------------------
%%%%%%%%%%%%%--|rr|||--%%%%%%%%%%%--###--###-------------#--#-----------------||||--------%%%--%%%%%%%%--%%%%%%%%%%---%%%%%||---||---#--#---------------------------------------------------------------
|||||||||||||%%%%%%%%%%|||||||||||%%%%%--%%%%%%%%--%%%--##--##--%%%---%%%---y-||||--------|||--||||||||--||||||||||---|||||||---||--##--##--------------------------------------------------------------
|||||||||||||||||||||||||||||||||||||||--||||||||--|||XXXX--XXXX|||---|||XXXXXXXXXXXXXXXXX|||--||||||||--||||||||||---|||||||---||XXXX--XXXXXXXXXXXXFXXXXXXXXXXXXXXXXXXXXXXXXXXXXXXXXXXXXXXXXXXXXXXXXXXX
