HEIGHT=16;WIDTH=201;THEME=0;OVERRIDE=false
--------------------------------------------------------------------------------------------------------------------------------------------------------------------------------------------------------
--------------------------------------------------------------------------------------------------------------------------------------------------------------------------------------------------------
--------------------------------------------------------------------------------------------------------------------------------------------------------------------------------------------------------
--------------------------------------------------------------------------------------------------------------------------------------------------------------------------------------------------------
--------------------------------------------------------------------------------------------------------------------------------------------------------------------------------------------------------
--------------------------------------------------------------------------------------------------------------------------------------------------------------------------------------------------------
--------------------------------------------------------------------------------------------------------------------------------------------------------------------------------------------------------
--------------------------------------------------------------------------------------------------------------------------------------------------------------------------------------------------------
--------------------------------------------------------------------------------------------------------------------------------------------------------------------------------------------------------
--------------------------------------------------------------------------------------------------------------------------------------------------------------------------------------------------------
---------------------------------------------------------------------------------------------------------------------------------SS2S-------------------------------------------------------------------
--------------------------------------------------------------------------#---#-------------------------------------------------------------------------------------------------------------------------
-----------------%%%%------------%%%-----------%%%%%%%%%%%---------------##---##------#---#---%%%%%-------%%%--%%%--------------------------------------------------------------------------------------
-----------------||||------------|gk-------%%--|||||||||||----%%%%%%----###---###----##---##--|||||-------|||--|||----------------g---%%---%%-----------------------------------------------------------
------------%%%%%%%%%%%%%%%%%%%%%%%%%%%%%%%||%%|||||||||||----|k||y|--%%%%%---%%%%%%%%%---%%%%|||||-------|||--|||-----%%%%%%%%%%%%%%%||---||%%%%%%%%F%%%%%%%%%%%%%%%%%%%%%%%%%%%%%%%%%%%%%%%%%%%%%%%%%%
XXXXXXXXXXXX||||||||||||||||||||||||||||||||||||||||||||||XXXXXXXXXXXX|||||---|||||||||---|||||||||XX---XX|||--|||XXXXX|||||||||||||||||---||||||||||X||||||||||||||||||||||||||||||||||||||||||||||||||
