HEIGHT=16;WIDTH=201;THEME=0;OVERRIDE=false
--------------------------------------------------------------------------------------------------------------------------------------------------------------------------------------------------------
--------------------------------------------------------------------------------------------------------------------------------------------------------------------------------------------------------
--------------------------------------------------------------------------------------------------------------------------------------------------------------------------------------------------------
--------------------------------------------------------------------------------------------------------------------------------------------------------------------------------------------------------
--------------------------------------------------------------------------------------------------------------------------------------------------------------------------------------------------------
-------------------y-k----------------------------------------------------------------------------------------------------------------------------------------------------------------------------------
-------------------%%%%%%-------------------------------------------------------------------------------------------------------------------------------------------------------------------------------
-------------------||||||-------------------------------------------------------------------------------------------------------------------------------------------------------------------------------
-------------------||||||--------------------C2S--------------------------------------------------------------------------------------------------------------------------------------------------------
----------------y-r||||||-------------------------------------------------------------------------------------------------------------------------------------------------------------------------------
---------------%%%%%%%|||-------------------------------------------------------------------------------------------------------------------------------------------------------------------------------
---------------||||||||||-----------------------------SSCCC---------------------------------------------------------------------------------------------------------------------------------------------
%%%%%%%%%%%%%--||||||||||----------------%%%%%%%%%%%----------------------%%%%%%%------------------------------------%%%%%---%%%%%----------------------------------------------------------------------
|||||||||||||%%%%%%%%%%%%%%%%------------|||||||||||----------------------|||||||------------------------------------|||||---|||||%%---%%---------------------------------------------------------------
|||||||||||||||||||||||||||||%%%%%--%%%%%|||||||||||--r---k--------%%%%%%-||y||||--%%%---%%%%%%--%%%-------%%%%--%%%%|||||---|||||||---||---------------------------------------------------------------
||||||||||||||||||||||||||||||||||--||||||||||||||||XXXXXXXXXXXXXXX||||||XXXXXXXXXX|||---||||||--|||XXXXXXX||||--|||||||||---|||||||---||XXXXXXXXFXXXXXXXXXXXXXXXXXXXXXXXXXXXXXXXXXXXXXXXXXXXXXXXXXXXXXX
