HEIGHT=16;WIDTH=201;THEME=0;OVERRIDE=false
--------------------------------------------------------------------------------------------------------------------------------------------------------------------------------------------------------
--------------------------------------------------------------------------------------------------------------------------------------------------------------------------------------------------------
--------------------------------------------------------------------------------------------------------------------------------------------------------------------------------------------------------
--------------------------------------------------------------------------------------------------------------------------------------------------------------------------------------------------------
--------------------------------------------------------------------------------------------------------------------------------------------------------------------------------------------------------
---------------------------------------------------------------------------------------------------------------y----------------------------------------------------------------------------------------
---------------------------------------------------------------------------------------------------------------%%%%%------------------------------------------------------------------------------------
---------------------------------------------------------------------------------------------------------------|||||------------------------------------------------------------------------------------
-------------------------------------------%%%%%%--------------------------------------------------------------|||||------------------------------------------------------------------------------------
---------------SS2C------------------------||||||--------------------------------------------------------------|||||--y---------------------------------------------------------------------------------
-------------------------------------------||||||----2SSCS-----------------------------------------------------||||%%%%%--------------------------------------------------------------------------------
---------------------------#---#-----------||||||-------------------------------------------#---#------#--#----|||||||||--------------------------------------------------------------------------------
-------------------k------##---##--------%%%%%%%%%%--------------------%%%%--%%%%----------##---##---%%%--%%%--|||||||||--------------------------------------------------------------------------------
%%%%%%%%%%%%%%%%%%%%%%%--###---###-------||||||||||--r-----------------||||--||||%%---%%--###---###--|||--|||%%%%%%%%%%%%%%-----------------------------------------------------------------------------
|||||||||||||||||||||||%%%%%---%%%%%-----||||||||||%%%%%%%%------------||||--||||||---||%%%%%---%%%%%|||--|||||||||||||||||%%%---%%%%%%%%%%%%%%%%%%F%%%%%%%%%%%%%%%%%%%%%%%%%%%%%%%%%%%%%%%%%%%%%%%%%%%%
||||||||||||||||||||||||||||---|||||XXXXX||||||||||||||||||XXXXX--XXXXX||||--||||||---|||||||---||||||||--||||||||||||||||||||---||||||||||||||||||X||||||||||||||||||||||||||||||||||||||||||||||||||||
