HEIGHT=16;WIDTH=201;THEME=0;OVERRIDE=false
--------------------------------------------------------------------------------------------------------------------------------------------------------------------------------------------------------
--------------------------------------------------------------------------------------------------------------------------------------------------------------------------------------------------------
--------------------------------------------------------------------------------------------------------------------------------------------------------------------------------------------------------
--------------------------------------------------------------------------------------------------------------------------------------------------------------------------------------------------------
--------------------------------------------------------------------------------------------------------------------------------------------------------------------------------------------------------
--------------------------------------------------------------------------------------------------------------------------------------------------------------------------------------------------------
--------------------------------------------------------------------------------------------------------------------------------------------------------------------------------------------------------
--------------------------------------------------------------------------------------------------------------------------------------------------------------------------------------------------------
--------------------------------------------------------------------------------------------------------------------------------------------------------------------------------------------------------
--------------------------------------------------------------------#--#--------------------------------------------------------------------------------------------------------------------------------
-------------------------------------------------------------------##--##-------------------------------------------------------------------------------------------------------------------------------
------------------#---#-------------------------------------------###--###------------------------------------------------------------------------------------------------------------------------------
-----------------##---##------------------%%%-------------------%%%%%--%%%%%------------%%%%%---%%%%%---%%%---------------%%--%%------------------------------------------------------------------------
----------------###---###--%%%%%%%%%%%----|||----------%%%---%%%|||||--|||||------------|||||---|||||---|||---------------||--||%%%%---%%%%-------------------------------------------------------------
%%%%%%%%%%%%%%%%%%%---%%%%%|||||||||||----|||yyg-------|||---||||||||--|||||------------|||||---|||||---|||%%%--%%%-------||--||||||---||||%%%%%%%%F%%%%%%%%%%%%%%%%%%%%%%%%%%%%%%%%%%%%%%%%%%%%%%%%%%%%
|||||||||||||||||||---||||||||||||||||XXXXXXXXXXXXXXXXX|||---||||||||--|||||XXXXX--XXXXX|||||---|||||---||||||--|||XX---XX||--||||||---||||||||||||X||||||||||||||||||||||||||||||||||||||||||||||||||||
