HEIGHT=16;WIDTH=201;THEME=0;OVERRIDE=false
--------------------------------------------------------------------------------------------------------------------------------------------------------------------------------------------------------
--------------------------------------------------------------------------------------------------------------------------------------------------------------------------------------------------------
--------------------------------------------------------------------------------------------------------------------------------------------------------------------------------------------------------
--------------------------------------------------------------------------------------------------------------------------------------------------------------------------------------------------------
--------------------------------------------------------------------------------------------------------------------------------------------------------------------------------------------------------
--------------------------------------------------------------------------------------------------------------------------------------------------------------------------------------------------------
--------------------------------------------------------------------------------------------------------------------------------------------------------------------------------------------------------
----------------------------------------------------------------------------SCSSSS----------------------------------------------------------------------------------------------------------------------
--------------------------------------------------------------------------------------------------------------------------------------------------------------------------------------------------------
----------------------------------------------------------------Tt----tt----------------r---------------------------------------------------------------------------------------------------------------
----------------------------------------------------------------tt----tt---------------%%%--------------------------------------------------------------------------------------------------------------
----------------------------------------------------------------tt----tt----%%%%%%-----|||--------------------#---#----Tt-------------------------------------------------------------------------------
------------%%%%%---%%%%%----#---#-----------%%%--%%%--#---#--%%%%%%%%%%%%--||||||-----|||-------%%%%--%%%%--##---##---tt---------#--#------------------------------------------------------------------
%%%%%%%%%%%%|||||---|||||---##---##----------|||--|||%%%---%%%||||||||||||-g||||||-r-%%%%%%%%%%%%||||--||||%%%%---%%%%-tt--------##--##---%%%%%%%%F%%%%%%%%%%%%%%%%%%%%%%%%%%%%%%%%%%%%%%%%%%%%%%%%%%%%%
|||||||||||||||||---|||||--###---###---------|||--||||||---|||||||||||||||%%%%%%%%%%%||||||||||||||||--||||||||---||||%%%%%%%%--###--###--||||||||%|||||||||||||||||||||||||||||||||||||||||||||||||||||
|||||||||||||||||---|||||XXXXX---XXXXXXX---XX|||--||||||---||||||||||||||||||||||||||||||||||||||||||--||||||||---||||||||||||XXXXX--XXXXX||||||||||||||||||||||||||||||||||||||||||||||||||||||||||||||
