HEIGHT=16;WIDTH=201;THEME=0;OVERRIDE=false
--------------------------------------------------------------------------------------------------------------------------------------------------------------------------------------------------------
--------------------------------------------------------------------------------------------------------------------------------------------------------------------------------------------------------
----------------k-r-------------------------------------------------------------------------------------------------------------------------------------------------------------------------------------
---------------%%%%%------------------------------------------------------------------------------------------------------------------------------------------------------------------------------------
---------------|||y|------------------------------------------------------------------------------------------------------------------------------------------------------------------------------------
---------------|%%%|------------------------------------------------------------------------------------------------------------------------------------------------------------------------------------
---------------|||||------------------------------------------------------------------------------------------------------------------------------------------------------------------------------------
---------------|||||------------------------------------------------------------------------------------------------------------------------------------------------------------------------------------
---------------|||||-g---------------------------------------------------------------g------------------------------------------------------------------------------------------------------------------
---------------||%%%%%-----------------------------------------------------------%%%%%%%----------------------------------------------------------------------------------------------------------------
---------------|||||||-----------------------------------------------------------|||||||-----#---#-----------------------------------r------------------------------------------------------------------
---------------|||||||--------------------------------------------#---#------rr--|||||||----##---##------------tt------------------%%%%%%%--------------------------------------------------------------
%%%%%%%%%%%%---||g|kgy-----#---#---%%--%%------------------------##---##--%%%%%%%%%%%%%%%%%%%%---%%%%%%%%%%%%--tt------------------|||||||--------------------------------------------------------------
||||||||||||%%%%%%%%%%%%--##---##--||--||%%--%%--------#---#---%%%%---%%%%||||||||||||||||||||---||||||||||||--tt--%%--%%----------|||||||----%%%%%%%%F%%%%%%%%%%%%%%%%%%%%%%%%%%%%%%%%%%%%%%%%%%%%%%%%%
||||||||||||||||||||||||%%%%---%%%%||--||||--||-------##---##--||||---||||||||||||||||||||||||---||||||||||||%%%%%%||--||%%---%%---|||y|||----||||||||%|||||||||||||||||||||||||||||||||||||||||||||||||
||||||||||||||||||||||||||||---||||||--||||--||XXXXXXXXX---XXXX||||---||||||||||||||||||||||||---||||||||||||||||||||--||||---||XXXXXXXXXXXXXX||||||||||||||||||||||||||||||||||||||||||||||||||||||||||
