HEIGHT=16;WIDTH=201;THEME=0;OVERRIDE=false
--------------------------------------------------------------------------------------------------------------------------------------------------------------------------------------------------------
--------------------------------------------------------------------------------------------------------------------------------------------------------------------------------------------------------
--------------------------------------------------------------------------------------------------------------------------------------------------------------------------------------------------------
--------------------------------------------------------------------------------------------------------------------------------------------------------------------------------------------------------
--------------------------------------------------------------------------------------------------------------------------------------------------------------------------------------------------------
--------------------------------------------------------------------------------------------------------------------------------------------------------------------------------------------------------
--------------------------------------------------------------------------------------------------------------------------------------------------------------------------------------------------------
------------------------------------------------------------------------------------------------CS-CSS--------------------------------------------------------------------------------------------------
----------------------------------------------------------------------------------------SC2S------------------------------------------------------------------------------------------------------------
-------------------------------------------------------------------------S2SS---------------------%-----------------------------------------------------------------------------------------------------
------------------------------------------------------------------------------------------------y-|-----------------------------------------------------------------------------------------------------
-----------------------------------------------------------------------------------------------%%%%%%%--------------------tt----------------------------------------------------------------------------
--------------%%%%%---%%%%%---%%%%%%%--------------------------------------------------%%%%%%%-|||||||--------------------tt----------------------------------------------------------------------------
--------------|||||---|||||---|||||||-------------%%%%%%%-------------%%%%%%%%%%%------|||||||%%%%%%%%%%%%--------------%%%%%%%%%%--%%%%%---------------------------------------------------------------
--------------|||||---|||||---|Y|G|||----g--%%--%%|||||||-------------|||||||||||%%--%%|||||||||||||||||||%%---%%%%---%%||||||||||--|||||%%%%%%%%F%%%%%%%%%%%%%%%%%%%%%%%%%%%%%%%%%%%%%%%%%%%%%%%%%%%%%%
XXXXXXXXXXXXXX|||||---|||||XXXXXXXXXXXXXXXXX||--|||||||||XXXXX---XXXXX|||||||||||||--|||||||||||||||||||||||---||||---||||||||||||--|||||||||||||X||||||||||||||||||||||||||||||||||||||||||||||||||||||
