HEIGHT=16;WIDTH=201;THEME=0;OVERRIDE=false
--------------------------------------------------------------------------------------------------------------------------------------------------------------------------------------------------------
--------------------------------------------------------------------------------------------------------------------------------------------------------------------------------------------------------
--------------------------------------------------------------------------------------------------------------------------------------------------------------------------------------------------------
--------------------------------------------------------------------------------------------------------------------------------------------------------------------------------------------------------
-----------------------y--------------------------------------------------------------------------------------------------------------------------------------------------------------------------------
-------------------%%%%%--------------------------------------------------------------------------------------------------------------------------------------------------------------------------------
-------------------||||y----------------------------------------------------------%%%%%%----------------------------------------------------------------------------------------------------------------
-------------------||%%%%%%-------------------------------------SCSSSS------------||||||----------------------------------------------------------------------------------------------------------------
-------------------||||||||-------------------------------------------------------||||||----------------------------------------------------------------------------------------------------------------
-------------------||||||||--------------2US-------------Tt-----------------------|||||%%%%------#---#--------------------------------------------------------------------------------------------------
-------------------|||%%%%|---------------------------Tt-tt-----k-r-rr------------|||||||||-----##---##-------------------------------------------------------------------------------------------------
-------------------||||||||---------------------------tt-tt-----%%%%%%------------|||||||||----###---###------------------------------------------------------------------------------------------------
%%%%%%%%%%---------||||||||--%%%%--%%%%----g--------%%%%%%%%---g||||||------------K||||||r|--%%%%%---%%%%%%%%--%%%--------------------------------------------------------------------------------------
||||||||||------%%%%%%%%%%%%%||||--||||%%%%%%%%%%%%%||||||||-%%%%|||||---%%---%%%%%%%%%%%%%%%|||||---||||||||--|||---------------#--#--%%%%%--%%%%%%%%%%%%%F%%%%%%%%%%%%%%%%%%%%%%%%%%%%%%%%%%%%%%%%%%%%
||||||||||%%%%%%|||||||||||||||||--|||||||||||||||||||||||||-|||k|||||---||---||||||||||||||||||||---||||||||--|||%%%%%---%%%%%%%%--%%%|||||--|||||||||||||%||||||||||||||||||||||||||||||||||||||||||||
|||||||||||||||||||||||||||||||||--|||||||||||||||||||||||||XXXXXXXXXXXXX||---||||||||||||||||||||---||||||||--||||||||---||||||||--||||||||--||||||||||||||||||||||||||||||||||||||||||||||||||||||||||
