HEIGHT=16;WIDTH=201;THEME=0;OVERRIDE=false
--------------------------------------------------------------------------------------------------------------------------------------------------------------------------------------------------------
--------------------------------------------------------------------------------------------------------------------------------------------------------------------------------------------------------
--------------------------------------------------------------------------------------------------------------------------------------------------------------------------------------------------------
--------------------------------------------------------------------------------------------------------------------------------------------------------------------------------------------------------
--------------------------------------------------------------------------------------------------------------------------------------------------------------------------------------------------------
--------------------------------------------------------------------------------------------------------------------------------------------------------------------------------------------------------
--------------------------------------------------------------------------------------------------------------------------------------------------------------------------------------------------------
--------------------------------------------------------------------------------------------------------------------------------------------------------------------------------------------------------
----------------------------------------------------------------------------r-----------------------------------------------------------S-CS------------------------------------------------------------
-------------------------------------------------------------------------%%%%%%%------------CCUC--------------------------------------------------------------------------------------------------------
----------------------------------------------------------#---#----------|||||||-----------------------------------------------SSUS------|--------------------------------------------------------------
---------------------------------------------------------##---##---------|||||||-------------------------------#---#---------------------gy-------------------------------------------------------------
-------------%%%%--%%----------%%%%--%%%%----#---#------###---###--------|||||y|----------------------#--#----##---##-------------------%%%%%----%%%%%%%%F%%%%%%%%%%%%%%%%%%%%%%%%%%%%%%%%%%%%%%%%%%%%%%
-------------||||--||---#--#---||||--||||---##---##---%%%%%---%%%%%-----%%%%%%%%%%%%%---%%%%%%%%%%%%%%%--%%%%%%%---%%%%-----------g-----|||||----||||||||%||||||||||||||||||||||||||||||||||||||||||||||
-------------||||--||--##--##--||||--||||--###---###--|||||---|||||-----|||||||||||||---|||||||||||||||--|||||||---||||-gy----%%%%%%%%--|||||----|||||||||||||||||||||||||||||||||||||||||||||||||||||||
XXXXXXXXXXXXX||||--||XXXX--XXXX||||--||||XXXXX---XXXXX|||||---|||||XXXXX|||||||||||||---|||||||||||||||--|||||||---||||XXXXXXX||||||||XXXXXXXXXXX|||||||||||||||||||||||||||||||||||||||||||||||||||||||
