HEIGHT=16;WIDTH=201;THEME=0;OVERRIDE=false
--------------------------------------------------------------------------------------------------------------------------------------------------------------------------------------------------------
--------------------------------------------------------------------------------------------------------------------------------------------------------------------------------------------------------
--------------------------------------------------------------------------------------------------------------------------------------------------------------------------------------------------------
--------------------------------------------------------------------------------------------------------------------------------------------------------------------------------------------------------
--------------------------------------------------------------------------------------------------------------------------------------------------------------------------------------------------------
--------------------------------------------------------------------------------------------------------------------------------------------------------------------------------------------------------
--------------------------------------------------------------------------------------------------------------------------------------------------------------------------------------------------------
--------------------------------------------------SSCSC-------------------------------------------------------------------------------------------------------------------------------------------------
--------------------------------------------------------------------------------------------------------------------------------------------------------------------------------------------------------
--------------------------------------------------------------------------------S22---------------------------------------------------------------------------------------------------------------------
----------------------------------------------------g--k------------------------------------------------------------------------------------------------------------------------------------------------
-------------------------------------------------%%%%%%%------------------------------------------------------------#---#-------------------------------------------------------------------------------
------------------------------%%--%%---%%%---%%%-|||y|||--------%%%%%--%%%%%-----y---%%%%--%%%%--------------------##---##------------------------------------------------------------------------------
------------------------------||--||---|||---|||%%%%%%%%%%%%%---|||||--|||||%%%%%%%%%||||--||||------------------%%%%---%%%%----------------------------------------------------------------------------
%%%%%%%%%%%%%%%%%%%-----------||--||---|||---||||||||||||||||%%%|||||--||||||||||||||||||--||||-------%%%%---%%%%||||---||||%%--%%%%%%--%%%%------------------------------------------------------------
|||||||||||||||||||XXXX---XXXX||--||XXX|||---||||||||||||||||||||||||--||||||||||||||||||--||||XXXXXXX||||---||||||||---||||||--||||||--||||XXXXXXXXFXXXXXXXXXXXXXXXXXXXXXXXXXXXXXXXXXXXXXXXXXXXXXXXXXXX
