HEIGHT=16;WIDTH=201;THEME=0;OVERRIDE=false
--------------------------------------------------------------------------------------------------------------------------------------------------------------------------------------------------------
--------------------------------------------------------------------------------------------------------------------------------------------------------------------------------------------------------
--------------------------------------------------------------------------------------------------------------------------------------------------------------------------------------------------------
--------------------------------------------------------------------------------------------------------------------------------------------------------------------------------------------------------
--------------------------------------------------------------------------------------------------------------------------------------------------------------------------------------------------------
--------------------------------------------------------------------------------------------------------------------------------------------------------------------------------------------------------
--------------------------------------------------------------------------------------------------------------------------------------------------------------------------------------------------------
--------------------------------------------------------------------------------------------------------------------------------------------------------------------------------------------------------
-------------------22C----------------------------------------------------------------------------------------------------------------------------------------------------------------------------------
-----------------------------------------------------------------------------------------------------------------------------------------SSS------------------------------------------------------------
----------------------|---------------------------------------------------------------------------------------------------------------------------------------------------------------------------------
----------------------k--------------#--#-----------------------------------------------------S2C-UUS-------------Tt--------------------%---------------------------------------------------------------
%%%%%%%%%%%%%%-----%%%%%------------##--##-----#--#------#--#---%%%%----------------------------------------------tt-Tt---------%%---%%-|----%%%%%%%%F%%%%%%%%%%%%%%%%%%%%%%%%%%%%%%%%%%%%%%%%%%%%%%%%%%
||||||||||||||--r--|||||-kr-------%%%%--%%%%--##--##----##--##--||||---------#---#---------------%----%%%%--%%%%--tt-tt---------||---||%%%%%%||||||||%||||||||||||||||||||||||||||||||||||||||||||||||||
||||||||||||||%%%%%%%%%%%%%%------||||--||||%%%%--%%%%%%%%--%%%%||||-----k-%%%---%%%-------------|----||||--||||%%%%%%%%--------||---|||||||||||||||||||||||||||||||||||||||||||||||||||||||||||||||||||
||||||||||||||||||||||||||||XX--XX||||--||||||||--||||||||--||||||||XXXXXXX|||---|||XXX---XXXXXXXXXXXX||||--||||||||||||XXX--XXX||---|||||||||||||||||||||||||||||||||||||||||||||||||||||||||||||||||||
