HEIGHT=16;WIDTH=201;THEME=0;OVERRIDE=false
--------------------------------------------------------------------------------------------------------------------------------------------------------------------------------------------------------
--------------------------------------------------------------------------------------------------------------------------------------------------------------------------------------------------------
--------------------------------------------------------------------------------------------------------------------------------------------------------------------------------------------------------
--------------------------------------------------------------------------------------------------------------------------------------------------------------------------------------------------------
--------------------------------------------------------------------------------------------------------------------------------------------------------------------------------------------------------
--------------------------------------------------------------------------------------------------------------------------------------------------------------------------------------------------------
--------------------------------------------------------------------------------------------------------------------------------------------------------------------------------------------------------
--------------------------------------------------------------------------------------------------------------------------------------------------------------------------------------------------------
---------------------------------------------------------------------------------------------------------------------------------SSSS-------------------------------------------------------------------
-----------------------------------------------------------------------------------------CS2U-----------------------------------------------------------------------------------------------------------
--------------------------------------------------------------------------------------------------------------------------------------------------------------------------------------------------------
---------------------------------------------------------------------k-----------------------------------------------------------g-r--------------------------------------------------------------------
--------------%%---%%%%%%--%%%%--------------%%%%%------------------%%%%%%------------------g------tt----tt---------------------%%%%%%%%%%%--%%%%%------------------------------------------------------
--------------||---||||||--||||--------------|||||------------------||||||------------%%%%%%%%%-Tt-tt----tt---------------------|||||||||||--|||||------------------------------------------------------
--------------||---||||||--||||-----%%%---%%%|||||--------%%%%--%%%%||||||------------|||||||||-tt-tt----tt--------%%%%%---%%%%%|||||||||||--|||||%%%%%%%%F%%%%%%%%%%%%%%%%%%%%%%%%%%%%%%%%%%%%%%%%%%%%%
XXXXXXXXXXXXXX||---||||||--||||XXXXX|||---||||||||XXXXXXXX||||--||||||||||XXXXX--XXXXX|||||||||XXXXXXXXXXXXXXXXXXXX|||||---||||||||||||||||--|||||||||||||X|||||||||||||||||||||||||||||||||||||||||||||
