HEIGHT=16;WIDTH=201;THEME=0;OVERRIDE=false
--------------------------------------------------------------------------------------------------------------------------------------------------------------------------------------------------------
--------------------------------------------------------------------------------------------------------------------------------------------------------------------------------------------------------
--------------------------------------------------------------------------------------------------------------------------------------------------------------------------------------------------------
--------------------------------------------------------------------------------------------------------------------------------------------------------------------------------------------------------
--------------------------------------------------------------------------------------------------------------------------------------------------------------------------------------------------------
--------------------------------------------------------------------------------------------------------------------------------------------------------------------------------------------------------
--------------------------------------------------------------------------------------------------------------------------------------------------------------------------------------------------------
-----------------k--------------------------------------------------------------------------------------------------------------------------------------------------------------------------------------
-----------------%%%%-----------------------------------------------------------------------------------------------------------------------------------------------------------------------------------
-----------------||||------------------------------------k----------------------------------------------------------------------------------------------------------------------------------------------
-----------------||||-----------------------------------%%%%%-------------------------------------------------------------------------------------------------------------------------------------------
------------%%%%%%%||--------------%%%%%---------------y||g||-------------------------SCSS----------------------------#---#-----------------------------------------------------------------------------
------------|||||||||--%%%--%%%----|||||-------%%%%%%%%%%%%%%%%%------tt---%%%---%%%---------------------------------##---##---------%%%%%%%%%%%F%%%%%%%%%%%%%%%%%%%%%%%%%%%%%%%%%%%%%%%%%%%%%%%%%%%%%%%
------------|||y|g||r--|||--|||----|||||-------|||||||||||||||||---tt-tt---|||---|||--------------------------------###---###--------|||||||||||%|||||||||||||||||||||||||||||||||||||||||||||||||||||||
-----------%%%%%%%%%%%%|||--|||----|||||-------|||||||||||||||||---tt-tt---|||---|||----------------------%%%--%%%%%%%%---%%%%%------|||||||||||||||||||||||||||||||||||||||||||||||||||||||||||||||||||
XXXXXXXXXXX|||||||||||||||--|||XXXXXXXXXXXXXXXX|||||||||||||||||XXXXXXXXXXX|||---|||XXXXXXXXXXXXXXX--XXXXX|||--||||||||---|||||XX--XX|||||||||||||||||||||||||||||||||||||||||||||||||||||||||||||||||||
