HEIGHT=16;WIDTH=201;THEME=0;OVERRIDE=false
--------------------------------------------------------------------------------------------------------------------------------------------------------------------------------------------------------
--------------------------------------------------------------------------------------------------------------------------------------------------------------------------------------------------------
--------------------------------------------------------------------------------------------------------------------------------------------------------------------------------------------------------
--------------------------------------------------------------------------------------------------------------------------------------------------------------------------------------------------------
--------------------------------------------------------------------------------------------------------------------------------------------------------------------------------------------------------
---------------------------------------------%%%%%%%---------------------------------------------------------g------------------------------------------------------------------------------------------
---------------------------------------------|||||||-------------------------------------------------------%%%------------------------------------------------------------------------------------------
---------------------------------------------|||||||-------------------------------------------------------|||------------------------------------------------------------------------------------------
--------------------------------------------g|||||||-------------------------------------------------------|||------------------------------------------------------------------------------------------
-----------------------------------------%%%%%||||||-------------------SC----------------------------------|||------------------------------------------------------------------------------------------
-----------------------------------------|||||||||||---------------------------------------------%%%-------|||-------#---#------------------------------------------------------------------------------
-----------------------------------------|r|||||||||y--------------------%-----------------------|g|-------k||------##---##-----------------------------------------------------------------------------
-------------------------%%%%%---%%%%%%%%%%%%%%%%%%%%%-------------------|--------------%%---%%%%%%%%%%%%%%%%%%%%--###---###----------------------------------------------------------------------------
%%%%%%%%%%--------%%---%%|||||---|||||||||||||||||||||-------------%%%%%%%%%%%%%---%%%%%||---||||||||||||||||||||%%%%%---%%%%%%%%%--%%%%----------------------------------------------------------------
||||||||||--#--#--||---|||||||---|||||||||||||||||||||-------------|||||||||||||---|||||||---|||||||||||||||||||||||||---|||||||||--||||%%%%%%%%F%%%%%%%%%%%%%%%%%%%%%%%%%%%%%%%%%%%%%%%%%%%%%%%%%%%%%%%
||||||||||XXX--XXX||---|||||||---|||||||||||||||||||||XXXXX---XXXXX|||||||||||||---|||||||---|||||||||||||||||||||||||---|||||||||--||||||||||||X|||||||||||||||||||||||||||||||||||||||||||||||||||||||
