HEIGHT=16;WIDTH=201;THEME=0;OVERRIDE=false
--------------------------------------------------------------------------------------------------------------------------------------------------------------------------------------------------------
--------------------------------------------------------------------------------------------------------------------------------------------------------------------------------------------------------
--------------------------------------------------------------------------------------------------------------------------------------------------------------------------------------------------------
--------------------------------------------------------------------------------------------------------------------------------------------------------------------------------------------------------
--------------------------------------------------------------------------------------------------------------------------------------------------------------------------------------------------------
--------------------------------------------------------------------------------------------------------------------------------------------------------------------------------------------------------
--------------------------------------------------------------------------------------------------------------------------------------------------------------------------------------------------------
--------------------------------------------------------------------------------------------------------------------------------------------------------------------------------------------------------
--------------------------------------------------------------------------------------------------------------------------------------------------------------------------------------------------------
-------------------------------------#--#--------g----r---------SUSC-----------------------------------------------------Tt-----------------------------------------------------------------------------
------------------------------------##--##-------%%%%%%-------------------#--#-----------------------------------%%%-----tt----Tt-----------------------------------------------------------------------
-----------------------------------###--###------|k||||------------------##--##----------------------------------|||-----tt----tt-----------------------------------------------------------------------
---------------------------------%%%%%--%%%%%%%%%%%%%%%%%%%%%%-y--------###--###---------%%---%%-------------%%%%%%%%%%%%%%%%%%%%%%%%%%--%%%%%----------------------------------------------------------
%%%%%%%%%%%---#--#-----------%%%%|||||--||||||||||||||||||||||%%%%%%%%%%%%%--%%%%%-------||---||-------------||||||||||||||||||||||||||--|||||----------------------------------------------------------
|||||||||||--##--##--%%%--%%%|||||||||--|||||||||||||||||||||||||||||||||||--|||||-------||---||-------%%--%%||||||||||||||||||||||||||--|||||%%%%%%%%F%%%%%%%%%%%%%%%%%%%%%%%%%%%%%%%%%%%%%%%%%%%%%%%%%
|||||||||||XXXX--XXXX|||--||||||||||||--|||||||||||||||||||||||||||||||||||--|||||XX---XX||---||XX---XX||--||||||||||||||||||||||||||||--|||||||||||||X|||||||||||||||||||||||||||||||||||||||||||||||||
