HEIGHT=16;WIDTH=201;THEME=0;OVERRIDE=false
--------------------------------------------------------------------------------------------------------------------------------------------------------------------------------------------------------
--------------------------------------------------------------------------------------------------------------------------------------------------------------------------------------------------------
--------------------------------------------------------------------------------------------------------------------------------------------------------------------------------------------------------
--------------------------------------------------------------------------------------------------------------------------------------------------------------------------------------------------------
--------------------------------------------------------------------------------------------------------------------------------------------------------------------------------------------------------
--------------------------------------------------------------------------------------------------------------------------------------------------------------------------------------------------------
--------------------------------------------------------------------------------------------------------------------------------------------------------------------------------------------------------
--------------------------------------------------------------------------------------------------------------------------------------------------------------------------------------------------------
----------------------------------------------------------------------------------------------------------------SUCSSCC2--------------------------------------------------------------------------------
----------------------------------------#--#------------------------------------------------------------------------------------------------------------------------------------------------------------
---------------------------------------##--##----------------------------tt-Tt--------------------------------------------------------------------------------------------------------------------------
--------------------------------------###--###----------------------Tt---tt-tt-----------------------------------g--k-----------------------------------------------------------------------------------
--------------------%%%%%-----------%%%%%--%%%%%--------------------tt---tt-tt-%%%%%---%%%%%-------------------%%%%%%%%%%%%%%%---%%%%%--#---#-----------------------------------------------------------
--------------------|||||-----------|||||--|||||%%%---%%%%%%---%%%%%%%%%%%%%%%%|||||---|||||-------------%%--%%|||||||||||||||---|||||%%%---%%%---------------------------------------------------------
-------------%%---%%|||||-----------|||||--||||||||---||||||---|||||||||||||||||||||---|||||%%%%%---%%%%%||--|||||||||||||||||---||||||||---|||%%%%%%%%F%%%%%%%%%%%%%%%%%%%%%%%%%%%%%%%%%%%%%%%%%%%%%%%%
XXXXXXXXXXXXX||---|||||||XXXX---XXXX|||||--||||||||---||||||---|||||||||||||||||||||---||||||||||---|||||||--|||||||||||||||||---||||||||---|||||||||||X||||||||||||||||||||||||||||||||||||||||||||||||
