HEIGHT=16;WIDTH=201;THEME=0;OVERRIDE=false
--------------------------------------------------------------------------------------------------------------------------------------------------------------------------------------------------------
--------------------------------------------------------------------------------------------------------------------------------------------------------------------------------------------------------
--------------------------------------------------------------------------------------------------------------------------------------------------------------------------------------------------------
--------------------------------------------------------------------------------------------------------------------------------------------------------------------------------------------------------
--------------------------------------------------------------------------------------------------------------------------------------------------------------------------------------------------------
--------------------------------------------------------------------------------------------------------------------------------------------------------------------------------------------------------
--------------------------------------------------------------------------------------------------------------------------------------------------------------------------------------------------------
--------------------------------------------------------------------------------------------------------------------------------------------------------------------------------------------------------
--------------------------------------------------------------------------------------------------------------------------------------------------------------------------------------------------------
--------------------------------------------------------------------------------------------------------------------------------------------------------------------------------------------------------
--------------#---#-------------------------------------------------------------------------------------------------------------------------------------------------------------------------------------
-------------##---##------#--#--------------------------------------------------------------------------------------------------------------------------------------------------------------------------
-----------%%%%---%%%%---##--##-------#--#------------------------------------------------%%%--%%%--------------------tt----#--#--%%%%---%%%%%%%%%%%%F%%%%%%%%%%%%%%%%%%%%%%%%%%%%%%%%%%%%%%%%%%%%%%%%%%
-----------||||---||||--###--###-----##--##-----------------------------------------------|||--|||--------%%--%%---Tt-tt--%%%--%%%||||---||||||||||||%||||||||||||||||||||||||||||||||||||||||||||||||||
-----------||||---||||%%%%%--%%%%%--###--###---------------%%%%%%%%%%%%%%--%%%%%----------|||--|||%%%%%%%%||--||---tt-tt--|||--|||||||---|||||||||||||||||||||||||||||||||||||||||||||||||||||||||||||||
XXXXXXXXXXX||||---|||||||||--|||||XXXXX--XXXXXXXXXX---XXXXX||||||||||||||--|||||XXXX--XXXX|||--|||||||||||||--||XXXXXXXXXX|||--|||||||---|||||||||||||||||||||||||||||||||||||||||||||||||||||||||||||||
