HEIGHT=16;WIDTH=201;THEME=0;OVERRIDE=false
--------------------------------------------------------------------------------------------------------------------------------------------------------------------------------------------------------
--------------------------------------------------------------------------------------------------------------------------------------------------------------------------------------------------------
--------------------------------------------------------------------------------------------------------------------------------------------------------------------------------------------------------
--------------------------------------------------------------------------------------------------------------------------------------------------------------------------------------------------------
--------------------------------------------------------------------------------------------------------------------------------------------------------------------------------------------------------
--------------------------------------------------------------------------------------------------------2SS---------------------------------------------------------------------------------------------
--------------------------------------------------------------------------------------------------------------------------------------------------------------------------------------------------------
--------------------------------------------------------------------------------------------------------------------------------------------------------------------------------------------------------
------------------------------------------SUCSCS--------------------------------------------------------------------------------------------------------------------------------------------------------
-------------------------------------------------------------------------------------------------------%%%%%%-------------------------------------------------------------------------------------------
-------------------------------------------------------------------------------------------------------||||||------------------------%%%----------------------------------------------------------------
----------------------------------------g--r-----------------------------------------------------------||||||------------------------|||----------------------------------------------------------------
%%%%%%%%%%%%%-------------------------%%%%%%%%%%%----------------------------------------------r-------||g|||------------------------|||----------------------------------------------------------------
|||||||||||||-------------------------|||||||||||-------------------%%%%%--%%%%%-----------%%%%%%%%%%%%%%%%%%%%------%%---%%----%%%%%%%|-------%%%%%%%%F%%%%%%%%%%%%%%%%%%%%%%%%%%%%%%%%%%%%%%%%%%%%%%%%
|||||||||||||---------%%---%%---------|||||||||||-------------------|||||--|||||%%%%---%%%%||||||||||||||||||||%%--%%||---||----|kg|||y|--r----||||||||%||||||||||||||||||||||||||||||||||||||||||||||||
|||||||||||||XXX---XXX||---||XXXXX--XX|||||||||||XX--XXXXXXX---XXXXX|||||--|||||||||---||||||||||||||||||||||||||--||||---||XXXXXXXXXXXXXXXXXXX|||||||||||||||||||||||||||||||||||||||||||||||||||||||||
