HEIGHT=16;WIDTH=201;THEME=0;OVERRIDE=false
--------------------------------------------------------------------------------------------------------------------------------------------------------------------------------------------------------
--------------------------------------------------------------------------------------------------------------------------------------------------------------------------------------------------------
--------------------------------------------------------------------------------------------------------------------------------------------------------------------------------------------------------
--------------------------------------------------------------------------------------------------------------------------------------------------------------------------------------------------------
--------------------------------------------------------------------------------------------------------------------------------------------------------------------------------------------------------
--------------------------------------------------------------------------------------------------------------------------------------------------------------------------------------------------------
--------------------------------------------------------------------------------------------------------------------------------------------------------------------------------------------------------
--------------------------------------------------------SS2---------------------------------------------------------------------------------------------------------------------------------------------
--------------------------------------------------------------------------------------SSSSS-------------------------------------------------------------------------------------------------------------
--------------------------------------------------------------------------------------------------------------------------------------------------------------------------------------------------------
------------------------------------------------------------------------------------------------tt----tt-------------------------------y----------------------------------------------------------------
--------------------------------------------------------%%%%%%---------------------------y------tt----tt------------------------------%%%%%%------------------------------------------------------------
--------------%%%%---%%%%-------------%%--%%---#---#----||||||-----------------------%%%%%%%%---tt----tt---%%%%%%%--------------------||||||------------------------------------------------------------
--------------||||---||||-------------||--||--##---##---||||||r---y---kg-------------||||||||%%%%%%%%%%%%--|||||||--------------------||||||------------------------------------------------------------
%%%%%%%%%%%%%%||||---||||-------r-----||--||%%%%---%%%%%%%%%%%%%%%%%%%%%%%%%%%%------||||||||||||||||||||--g||k|||------------%%---%%-|||ky|r-----------------------------------------------------------
||||||||||||||||||---||||XX--XXXXXXXXX||--||||||---||||||||||||||||||||||||||||XXXXXX||||||||||||||||||||XXXXXXXXXXXXXXXX--XXX||---||XXXXXXXXXXXXXXXXXXFXXXXXXXXXXXXXXXXXXXXXXXXXXXXXXXXXXXXXXXXXXXXXXXX
