HEIGHT=16;WIDTH=201;THEME=0;OVERRIDE=false
--------------------------------------------------------------------------------------------------------------------------------------------------------------------------------------------------------
--------------------------------------------------------------------------------------------------------------------------------------------------------------------------------------------------------
--------------------------------------------------------------------------------------------------------------------------------------------------------------------------------------------------------
--------------------------------------------------------------------------------------------------------------------------------------------------------------------------------------------------------
--------------------------------------------------------------------------------------------------------------------------------------------------------------------------------------------------------
--------------------------------------------------------------------------------------------------------------------------------------------------------------------------------------------------------
--------------------------------------------------------------------------------------------------------------------------------------------------------------------------------------------------------
--------------------------------------------------------------------------------------------------------------------------------------------------------------------------------------------------------
--------------------------------------------------------------------------------------------------------------------------------------------------------------------------------------------------------
-------------------------------------------------g----------------------------------SSCUSU--------------------------------------------------------------------------------------------------------------
-------------------------------------------------%%%%---------------------------------------------------------------------------------------------------------------------------------------------------
-------------------------------------------------||y|y----------------------#--#----------------#---#---------------------------------------------------------------------------------------------------
----------------------#---#---------------%%%%%%%%%%%%%%%%%%%%%%%%--%%%%%--##--##--------y-----##---##----------------------------------------%%%%%%%%F%%%%%%%%%%%%%%%%%%%%%%%%%%%%%%%%%%%%%%%%%%%%%%%%%
--------------------%%%---%%%-------------||||||||||||||||||||||||--|||||%%%%--%%%%%%%%%%%%%--###---###--%%%--------------------------#---#---||||||||%|||||||||||||||||||||||||||||||||||||||||||||||||
%%%%%%%%%%%%--#--#--|||---|||%%---%%%%--%%||||||||||||||||||||||||--|||||||||--|||||||||||||%%%%%---%%%%%|||%%--%%----%%---%%%%--%%--##---##--||||||||||||||||||||||||||||||||||||||||||||||||||||||||||
||||||||||||XXX--XXX|||---|||||---||||--||||||||||||||||||||||||||--|||||||||--||||||||||||||||||---||||||||||--||XXXX||---||||--||XXXX---XXXX||||||||||||||||||||||||||||||||||||||||||||||||||||||||||
