HEIGHT=16;WIDTH=201;THEME=0;OVERRIDE=false
--------------------------------------------------------------------------------------------------------------------------------------------------------------------------------------------------------
--------------------------------------------------------------------------------------------------------------------------------------------------------------------------------------------------------
--------------------------------------------------------------------------------------------------------------------------------------------------------------------------------------------------------
--------------------------------------------------------------------------------------------------------------------------------------------------------------------------------------------------------
--------------------------------------------------------------------------------------------------------------------------------------------------------------------------------------------------------
--------------------------------------------------------------------------------------------------------------------------------------------------------------------------------------------------------
--------------------------------------------------------------------------------------------------------------------------------------------------------------------------------------------------------
--------------------------------------------------------------------------------------------------------------------------------------------------------------------------------------------------------
--------------------------------------------------------------------------------------------------------------------------------------------------------------------------------------------------------
--------------------------------------------------------------------------------------------------------------------------------------------------------------------------------------------------------
----------------------------y------------------------------------------------------------------------------------tt-------------------------------------------------------------------------------------
--------------------------%%%----------------------------------------------------------------------tt------------tt-------------------------------------------------------------------------------------
--------------------------|||---------tt-tt--------------------------------------------------------tt---tt-------tt-------------------------------------------------------------------------------------
------------%%%%%--%%%%%--|||---------tt-tt--------------------%%%%%---%%%%%%%%%%---%%%%%----------tt---tt----%%%%%%%%%---%%%%%--%%%--------------------------------------------------------------------
%%%%%%%%%%%%|||||--|||||--||k---------tt-tt-----%%---%%%%%--%%%|||||---||||||||||---|||||%%---%%%%%%%%%%%%%%%%|||||||||---|||||--|||%%%%%%%%%%%%%%F%%%%%%%%%%%%%%%%%%%%%%%%%%%%%%%%%%%%%%%%%%%%%%%%%%%%%
|||||||||||||||||--|||||XXXXXXXXXXXXXXXXXXXXXXXX||---|||||--||||||||---||||||||||---|||||||---|||||||||||||||||||||||||---|||||--|||||||||||||||||X|||||||||||||||||||||||||||||||||||||||||||||||||||||
