HEIGHT=16;WIDTH=201;THEME=0;OVERRIDE=false
--------------------------------------------------------------------------------------------------------------------------------------------------------------------------------------------------------
--------------------------------------------------------------------------------------------------------------------------------------------------------------------------------------------------------
--------------------------------------------------------------------------------------------------------------------------------------------------------------------------------------------------------
-------------------------------------------------------r------------------------------------------------------------------------------------------------------------------------------------------------
------------------------------------------------------%%%%%%%-------------------------------------------------------------------------------------------------------------------------------------------
------------------------------------------------------|||||||-------------------------------------------------------------------------------------------------------------------------------------------
------------------------------------------------------|||||||-------------------------------------------------------------------------------------------------------------------------------------------
------------------------------------------------------|||||||-------------------------------------------------------------------------------------------------------------------------------------------
------------------------------------------------------|%%%%||-------------------------------------------------------------------------------------------------------------------------------------------
------------------------------------------------------|||||||-------------------------------------------------------------------------------------------------------------------------------------------
------------------------#--#--------------------------|||||||-------------------------------------------------------------------------------------------------------------------------------------------
-----------------------##--##-------------------------||r||||k---------------------------C22S2-----#--#-------------------------------------------------------------------------------------------------
--------------%%---%%%%%%--%%%%----------------------%%%%%%%%%%-----------%%%%%%%%--%%%-----------##--##---------------%%--%%%%%%%--%%%%%---------------------------------------------------------------
--------------||---||||||--||||---#---#--------------||||||||||--%%%---%%%||||||||--|||----------###--###--%%%%%--%%%%%||--|||||||--|||||---------------------------------------------------------------
%%%%%%%%%%%%%%||---||||||--||||--##---##------%%%%%%%||||||||||%%|||---|||||||||||--|||--------%%%%%--%%%%%|||||--|||||||--|||||||--|||||%%%%%%%%F%%%%%%%%%%%%%%%%%%%%%%%%%%%%%%%%%%%%%%%%%%%%%%%%%%%%%%
||||||||||||||||---||||||--||||XXXX---XXXXXXXX||||||||||||||||||||||---|||||||||||--|||XXXXXXXX|||||--||||||||||--|||||||--|||||||--|||||||||||||X||||||||||||||||||||||||||||||||||||||||||||||||||||||
