HEIGHT=16;WIDTH=201;THEME=0;OVERRIDE=false
--------------------------------------------------------------------------------------------------------------------------------------------------------------------------------------------------------
--------------------------------------------------------------------------------------------------------------------------------------------------------------------------------------------------------
-----------------------------k--------------------------------------------------------------------------------------------------------------------------------------------------------------------------
-----------------------------%%%------------------------------------------------------------------------------------------------------------------------------------------------------------------------
-----------------------------|||------------------------------------------------------------------------------------------------------------------------------------------------------------------------
-----------------------------|||------------------------------------------------------------------------------------------------------------------------------------------------------------------------
--------------------------%%%%%|------------------------------------------------------------------------------------------------------------------------------------------------------------------------
--------------------------||||||------------------------------------------------------------------------------------------------------------------------------------------------------------------------
--------------------------||||||-------------------------------------------SSUSCS2----------------------------------------------------------------------------------------------------------------------
--------------------------||y|||------------------------------------CCU---------------------------------------------------------------------------------------------------------------------------------
--------------------------|%%%%%%%------------------------SCCCS-----------------------------------------------------------------------------------------------------------------------------------------
--------------------------||||||||--------G-------------------------------------------------------------------------------------------------------------------------------------------------------------
--------------------------||||||||------%%%%%%%%%%%%--%%%---------------y-%%%%%%%%%%----------%%%%---%%%%-----%%%%--------------------------------------------------------------------------------------
--------------------------||||||k|------||||||||||||--|||----gg--%%%%%%%%%||||||||||----------||||---||||-----||||-------------%%%%%%%%-----------%%%%%%%%F%%%%%%%%%%%%%%%%%%%%%%%%%%%%%%%%%%%%%%%%%%%%%
-----------------------%%%%%%%%%%%%%%%%%||||||||||||--|||%%%%%%%%|||||||||||||||||||----------||||---||||-----||||-------------||||||||-----------||||||||%|||||||||||||||||||||||||||||||||||||||||||||
XXXXXXXXXXXXXXX---XXXXX|||||||||||||||||||||||||||||--||||||||||||||||||||||||||||||XXXX--XXXX||||---||||XXXXX||||XXXXX---XXXXX||||||||XXXX---XXXX||||||||||||||||||||||||||||||||||||||||||||||||||||||
