HEIGHT=16;WIDTH=201;THEME=0;OVERRIDE=false
--------------------------------------------------------------------------------------------------------------------------------------------------------------------------------------------------------
--------------------------------------------------------------------------------------------------------------------------------------------------------------------------------------------------------
--------------------------------------------------------------------------------------------------------------------------------------------------------------------------------------------------------
--------------------------------------------------------------------------------------------------------------------------------------------------------------------------------------------------------
--------------------------------------------------------------------------------------------------------------------------------------------------------------------------------------------------------
--------------------------------------------------------------------------------------------------------------------------------------------------------------------------------------------------------
--------------------------------------------------------------------------------------------------------------------------------------------------------------------------------------------------------
--------------------------------------------------------------------------------------------------------------------------------------------------------------------------------------------------------
--------------------------------------------------------------------------------------------------------------------------------------------------------------------------------------------------------
--------------------------------------------------------------------------------------------------------------------------------------------------------------------------------------------------------
--------------------------------------------------------------------------------------------------------------------------------------------------------------------------------------------------------
-----------------------------------------------------2S2CCSSS-------------------------------------------------------------------------------------------------------------------------------------------
%%%%%%%%%%%%%%%%%%--%%---%%-----------%%%--%%%----------------%%%%%--%%%%%----------------------------------------------------------%%%%%---%%%%%%%%%%%%%F%%%%%%%%%%%%%%%%%%%%%%%%%%%%%%%%%%%%%%%%%%%%%%
||||||||||||||||||%%||---||---#---#---|||--|||%%%%%%----------|||||--|||||-----------------------%%%%--%%%%-----#---#---------------|||||---|||||||||||||%||||||||||||||||||||||||||||||||||||||||||||||
||||||||||||||||||||||---||--##---##--|||--|||||||||---k------|||||--|||||%%---%%%%---%%%%%---%%%||||--||||%%--##---##--%%%%%--%%%%%|||||---||||||||||||||||||||||||||||||||||||||||||||||||||||||||||||
||||||||||||||||||||||---||XXXX---XXXX|||--|||||||||XXXXXXXXXX|||||--|||||||---||||---|||||---|||||||--||||||XXXX---XXXX|||||--||||||||||---||||||||||||||||||||||||||||||||||||||||||||||||||||||||||||
