HEIGHT=16;WIDTH=201;THEME=0;OVERRIDE=false
--------------------------------------------------------------------------------------------------------------------------------------------------------------------------------------------------------
--------------------------------------------------------------------------------------------------------------------------------------------------------------------------------------------------------
--------------------------------------------------------------------------------------------------------------------------------------------------------------------------------------------------------
--------------------------------------------------------------------------------------------------------------------------------------------------------------------------------------------------------
--------------------------------------------------------------------------------------------------------------------------------------------------------------------------------------------------------
--------------------------------------------------------------------------------------------------------------------------------------------------------------------------------------------------------
--------------------------------------------------------------------------------------------------------------------------------------------------------------------------------------------------------
--------------------------------------------------------------------------------------------------------------------------------------------------------------------------------------------------------
--------------------------------------------------------------------------------------------------------------------------------------------------------------------------------------------------------
-----------tt-------------------------------------------------------------------------------------------------------------------------------------------------------------------------------------------
-----------tt-----------------------------------------------------------------------------------tt--------------------#---#-----------------------------------------------------------------------------
-----------tt-----------------------------------------------------------------------------------tt--Tt---------------##---##----------------------------------------------------------------------------
%%%%%%%%%%%%%%%%%%---------tt-Tt-----%%%%-------------------%%%%%---%%%%%%%%--%%%---------------tt--tt-------------%%%%---%%%%-----------%%%%%%%%F%%%%%%%%%%%%%%%%%%%%%%%%%%%%%%%%%%%%%%%%%%%%%%%%%%%%%%
||||||||||||||||||---------tt-tt--Tt-||||--------%%%%---%%%%|||||---||||||||--|||---#---#---%%%%%%%%%%%%%%%--------||||---||||-----------||||||||%||||||||||||||||||||||||||||||||||||||||||||||||||||||
||||||||||||||||||---------tt-tt--tt-||||--#--#--||||---|||||||||---||||||||--|||--##---##--|||||||||||||||%%%--%%%||||---||||-----------|||||||||||||||||||||||||||||||||||||||||||||||||||||||||||||||
||||||||||||||||||XX---XXXXXXXXXXXXXX||||XXX--XXX||||---|||||||||---||||||||--|||XXXX---XXXX||||||||||||||||||--|||||||---||||XXXX---XXXX|||||||||||||||||||||||||||||||||||||||||||||||||||||||||||||||
