HEIGHT=16;WIDTH=201;THEME=0;OVERRIDE=false
--------------------------------------------------------------------------------------------------------------------------------------------------------------------------------------------------------
--------------------------------------------------------------------------------------------------------------------------------------------------------------------------------------------------------
--------------------------------------------------------------------------------------------------------------------------------------------------------------------------------------------------------
--------------------------------------------------------------------------------------------------------------------------------------------------------------------------------------------------------
--------------------------------------------------------------------------------------------------------------------------------------------------------------------------------------------------------
--------------------------------------------------------------------------------------------------------------------------------------------------------------------------------------------------------
--------------------------------------------------------------------------------------------------------------------------------------------------------------------------------------------------------
--------------------------------------------------------------------------------------------------------------------------------------------------------------------------------------------------------
------------------------2CSU2---------------------------------------------------------------------------------------------------------------------------------------------------------------------------
-------------------------------------------------------------------------------------------------------------------------------------SCCS---------------------------------------------------------------
----------------------------------------------------------------------------------------tt--------------------------------------------------------------------------------------------------------------
------------------------k---------------------------------------------------------------tt--Tt----Tt-------------Tt-------------------------------------------------------------------------------------
--------------------%%%%%%%%%%%%%%--#---#--%%%%%--%%%%%---------------------------------tt--tt----tt-------------tt--------#--#-------------------------------------------------------------------------
%%%%%%%%%%%%%-------||||||||||||||%%%---%%%|||||--|||||-------------------------%%---%%%%%%%%%%%%%%%%------------tt-------##--##---%%%%%%%%%%-----------------------------------------------------------
|||||||||||||%%---%%|||||||||||||||||---||||||||--|||||%%%%--%%%%%%%---%%%%%%%%%||---||||||||||||||||%%%------%%%%%%%%%--###--###--||||||||||-----------------------------------------------------------
|||||||||||||||---|||||||||||||||||||---||||||||--|||||||||--|||||||---|||||||||||---|||||||||||||||||||XX--XX|||||||||XXXXX--XXXXX||||||||||XXXXXXXXFXXXXXXXXXXXXXXXXXXXXXXXXXXXXXXXXXXXXXXXXXXXXXXXXXX
