HEIGHT=16;WIDTH=201;THEME=0;OVERRIDE=false
--------------------------------------------------------------------------------------------------------------------------------------------------------------------------------------------------------
--------------------------------------------------------------------------------------------------------------------------------------------------------------------------------------------------------
--------------------------------------------------------------------------------------------------------------------------------------------------------------------------------------------------------
--------------------------------------------------------------------------------------------------------------------------------------------------------------------------------------------------------
--------------------------------------------------------------------------------------------------------------------------------------------------------------------------------------------------------
--------------------------------------------------------------------------------------------------------------------------------------------------------------------------------------------------------
--------------------------------------------------------------------------------------------------------------------------------------------------------------------------------------------------------
--------------------------------------------------------------------------------------------------------------------------------------------------------------------------------------------------------
--------------------------------------------------------------------------------------------------------------------------------------------------------------------------------------------------------
--------------------------------------------------------------------------------------------------------------------------------------------------------------------------------------------------------
--------------------------------SUS------------------------------------------------#--#-----------------------------------------------------------------------------------------------------------------
-------------------------%%%------------------------------------------------------##--##----------------------------------#---#-------------------------------------------------------------------------
-------------------------Kr|---%------------------------------%%---%%------------###--###--------------------------------##---##------------------------------------------------------------------------
--------------------%%%%%%%%%%-|y-----------------%%%%%--%%%%%||---||---#--#---%%%%%--%%%%%%%%%%---%%%%%%%%%%%---------%%%%---%%%%%%--%%%%%%%%%%F%%%%%%%%%%%%%%%%%%%%%%%%%%%%%%%%%%%%%%%%%%%%%%%%%%%%%%%
%%%%%%%%%%%%%%%%--%%||||||||||%%%%%%%%%%%%%---%%%%|||||--|||||||---||--##--##--|||||--||||||||||---|||||||||||---------||||---||||||--||||||||||%|||||||||||||||||||||||||||||||||||||||||||||||||||||||
||||||||||||||||--|||||||||||||||||||||||||---|||||||||--|||||||---||XXXX--XXXX|||||--||||||||||---|||||||||||XXXX---XX||||---||||||--||||||||||||||||||||||||||||||||||||||||||||||||||||||||||||||||||
