HEIGHT=16;WIDTH=201;THEME=0;OVERRIDE=false
--------------------------------------------------------------------------------------------------------------------------------------------------------------------------------------------------------
--------------------------------------------------------------------------------------------------------------------------------------------------------------------------------------------------------
--------------------------------------------------------------------------------------------------------------------------------------------------------------------------------------------------------
--------------------------------------------------------------------------------------------------------------------------------------------------------------------------------------------------------
--------------------------------------------------------------------------------------------------------------------------------------------------------------------------------------------------------
--------------------------------------------------------------------------------------------------------------------------------------------------------------------------------------------------------
--------------------------------------------------------------------------------------------------------------------------------------------------------------------------------------------------------
--------------------------------------------------------------------------------------------------------------------------------------------------------------------------------------------------------
--------------------------------------------------------------------------------------------------------------------------------------------------------------------------------------------------------
-------------S2UU2--------------------------------------------------------------------------------------------------------------------------------------------------------------------------------------
--------------------------------------------------------------------------------------------------------------------------------------------------------------------------------------------------------
---------------------%%%---------------------------------------------------------------------%%%---------------------CSU--------------------------------------------------------------------------------
---------------------r||-------y--------------%%%%%---%%%%%--------------------------%%--%%--|||----------------------------tt---%%---------------------------------------------------------------------
----------%%%%%%%%%%%%%%%%%%%%%%%%-------r----|||||---|||||%%%%%---%%%%%-------------||--||%%%%%%%%%%%%%%%%%--%%%%%---------tt---||%%---%%--------------------------------------------------------------
%%%%%%%%%%||||||||||||||||||||||||%%%%%%%%%%%%|||||---||||||||||---|||||%%%%%---%%%%%||--|||||||||||||||||||--|||||---k---%%%%%%%||||---||%%%%%%%%F%%%%%%%%%%%%%%%%%%%%%%%%%%%%%%%%%%%%%%%%%%%%%%%%%%%%%
|||||||||||||||||||||||||||||||||||||||||||||||||||---||||||||||---||||||||||---|||||||--|||||||||||||||||||--|||||XXXXXXX|||||||||||---||||||||||X|||||||||||||||||||||||||||||||||||||||||||||||||||||
