HEIGHT=16;WIDTH=201;THEME=0;OVERRIDE=false
--------------------------------------------------------------------------------------------------------------------------------------------------------------------------------------------------------
--------------------------------------------------------------------------------------------------------------------------------------------------------------------------------------------------------
--------------------------------------------------------------------------------------------------------------------------------------------------------------------------------------------------------
--------------------------------------------------------------------------------------------------------------------------------------------------------------------------------------------------------
--------------------------------------------------------------------------------------------------------------------------------------------------------------------------------------------------------
--------------------------------------------------------------------------------------------------------------------------------------------------------------------------------------------------------
--------------------------------------------------------------------------------------------------------------------------------------------------------------------------------------------------------
--------------------------------------------------------------------------------------------------------------------------------------------------------------------------------------------------------
--------------------------------------------------------------------------------------------------------------------------------------------------------------------------------------------------------
---------------------------------------------------------------------------------%%%%-------------------------------------------------------------------------------------------------------------------
---------------%%%---------------------------------------------#--#--------------||||-------------------------------------------------------------------------------------------------------------------
---------------|||--------------------------------------------##--##-------------||||--------------------------------------------SSSSS------------------------------------------------------------------
---------------|||----------------------------------tt-------###--###------------||||-k-------------#--#------------------------------------------------------------------------------------------------
---------------|||-------------#---#----------------tt--Tt-%%%%%--%%%%%%%%%%%%%%%%%%%%%%%----------##--##---%%%%%---%%%%%-------------------------------------------------------------------------------
%%%%%%%%%%%%%%%%%%%%%%%%%%%%%%%%---%%%--------------tt--tt-|||||--|||||||||||||||||||||||%%%%%%%--###--###--|||||---|||||%%--%%---k------%%%%%%%%F%%%%%%%%%%%%%%%%%%%%%%%%%%%%%%%%%%%%%%%%%%%%%%%%%%%%%%
||||||||||||||||||||||||||||||||---|||XXXXX---XXXXXXXXXXXXX|||||--||||||||||||||||||||||||||||||XXXXX--XXXXX|||||---|||||||--||XXXXXXXXXX||||||||X||||||||||||||||||||||||||||||||||||||||||||||||||||||
