HEIGHT=16;WIDTH=201;THEME=0;OVERRIDE=false
--------------------------------------------------------------------------------------------------------------------------------------------------------------------------------------------------------
--------------------------------------------------------------------------------------------------------------------------------------------------------------------------------------------------------
--------------------------------------------------------------------------------------------------------------------------------------------------------------------------------------------------------
--------------------------------------------------------------------------------------------------------------------------------------------------------------------------------------------------------
--------------------------------------------------------------------------------------------------------------------------------------------------------------------------------------------------------
--------------------------------------------------------------------------------------------------------------------------SS2S--------------------------------------------------------------------------
--------------------------------------------------------------------------------------------------------------------------------------------------------------------------------------------------------
--------------------------------------------------------------------------------------------------------------------------------------------------------------------------------------------------------
----------------------k------SSSCUSSC--------------------------------------------------------------------------------------y-g--------------------------------------------------------------------------
------------------%%%%%%-----------------------------------------------------------------------------------#--#----------%%%%%%%------------------------------------------------------------------------
------------------||||||---------------------%%%%---------------------------------------------------------##--##---------|||||||------------------------------------------------------------------------
------------------|||k||---------------------||||-------------------k------------------------------------###--###--------|||k|||------------------------------------------------------------------------
%%%%%%%%%%%%%-----|%%%||----%%%%%%%%%%%%%%%%%%%%%%%%%%%%%%%%---%%%%%%----------------------------------%%%%%--%%%%%-----%%%%%%%%%%----------------------------------------------------------------------
|||||||||||||-----||||||----||||||||||||||||||||||||||||||||---||||||---------------------%%%%%%%--%%%%|||||--|||||-tt--||||||||||---%%%%%--%%%%%%%%%%%%%F%%%%%%%%%%%%%%%%%%%%%%%%%%%%%%%%%%%%%%%%%%%%%%
|||||||||||||-----|||||r----||||||||||||||||||||||||||||||||---|||k||---------------------|||||||--|||||||||--|||||-tt--||||||||||---|||||--|||||||||||||%||||||||||||||||||||||||||||||||||||||||||||||
|||||||||||||XXXXXXXXXXXXXXX||||||||||||||||||||||||||||||||XXXXXXXXXXXXXXXXXXX--XXXXX--XX|||||||--|||||||||--|||||XXXXX||||||||||XXX|||||--||||||||||||||||||||||||||||||||||||||||||||||||||||||||||||
