HEIGHT=16;WIDTH=201;THEME=0;OVERRIDE=false
--------------------------------------------------------------------------------------------------------------------------------------------------------------------------------------------------------
--------------------------------------------------------------------------------------------------------------------------------------------------------------------------------------------------------
--------------------------------------------------------------------------------------------------------------------------------------------------------------------------------------------------------
--------------------------------------------------------------------------------------------------------------------------------------------------------------------------------------------------------
--------------------------------------------------------------------------------------------------------------------------------------------------------------------------------------------------------
--------------------------------------------------------------------------------------------------------------------------------------------------------------------------------------------------------
--------------------------------------------------------------------------------------------------------------------------------------------------------------------------------------------------------
--------------------------------------------------------------------------------------------------------------------------------------------------------------------------------------------------------
--------------------------------------------------------------------------------------------------------------------------------------------------------------------------------------------------------
--------------------------------------------------------------------------------------------------------------------------------------------------------------------------------------------------------
--------------------------------------------------------------------------------------------------Tt---%%%%---------------------------------------------------------------------------------------------
----------------------------#---#--------------------------------------------------------------Tt-tt---|||r--g---g--------------------------------------------------------------------------------------
--------------------------%%%---%%%------------%%%%%--%%%%%------------------------------------tt-tt--%%%%%%%%%%%%%%%%%%%%--%%%%%-----------------------------------------------------------------------
%%%%%%%%%%%%%-------------|||---|||%%%%%--%%%%%|||||--|||||---------------------------------%%%%%%%%%%||||||||||||||||||||--|||||%%%--%%%---------------------------------------------------------------
|||||||||||||-------%%--%%|||---||||||||--||||||||||--|||||--#---#----#--#----#---#---------||||||||||||||||||||||||||||||--||||||||--|||%%%%%%%%F%%%%%%%%%%%%%%%%%%%%%%%%%%%%%%%%%%%%%%%%%%%%%%%%%%%%%%
|||||||||||||XX---XX||--|||||---||||||||--||||||||||--|||||XXX---XXXXXX--XXXXXX---XXXXX---XX||||||||||||||||||||||||||||||--||||||||--|||||||||||X||||||||||||||||||||||||||||||||||||||||||||||||||||||
