HEIGHT=16;WIDTH=201;THEME=0;OVERRIDE=false
--------------------------------------------------------------------------------------------------------------------------------------------------------------------------------------------------------
--------------------------------------------------------------------------------------------------------------------------------------------------------------------------------------------------------
--------------------------------------------------------------------------------------------------------------------------------------------------------------------------------------------------------
--------------------------------------------------------------------------------------------------------------------------------------------------------------------------------------------------------
--------------------------------------------------------------------------------------------------------------------------------------------------------------------------------------------------------
--------------------------------------------------------------------------------------------------------------------------------------------------------------------------------------------------------
--------------------------------------------------------------------------------------------------------------------------------------------------------------------------------------------------------
--------------------------------------------------------------------------------------------------------------------------------------------------------------------------------------------------------
--------------------------------------------------------------------------------------------------------------------------------------------------------------------------------------------------------
-----------------------------------------------------------------SS2------------------------------------------------------------------------------------------------------------------------------------
---------------------------------------------------------------------------------------------------------------------------------------g----------------------------------------------------------------
----------------#--#--------------------------------------------------------------#---#---------------#---#----------------------%%%%%%%----------------------------------------------------------------
%%%%%%%%%%%%---##--##--------------------%%%%--%%%%--tt--------r--gg-y-----------##---##---%%---%%---##---##---%%---%%%%--%%-----|||||||----------------------------------------------------------------
||||||||||||--###--###-------------%%--%%||||--||||--tt--------%%%%%%%----------###---###--||---||--###---###--||---||||--||-----|||r|||----------------------------------------------------------------
||||||||||||%%%%%--%%%%%%%%%---%%%%||--||||||--||||--tt--------|||||||--------%%%%%---%%%%%||---||%%%%%---%%%%%||---||||--||%%%%%%%%%%%%%%%%%%----------------------------------------------------------
|||||||||||||||||--|||||||||---||||||--||||||--||||XXXXXXXXXXXXXXXXXXXXXXXXXXX|||||---|||||||---|||||||---|||||||---||||--||||||||||||||||||||XXXXXXXXFXXXXXXXXXXXXXXXXXXXXXXXXXXXXXXXXXXXXXXXXXXXXXXXXX
