HEIGHT=16;WIDTH=201;THEME=0;OVERRIDE=false
--------------------------------------------------------------------------------------------------------------------------------------------------------------------------------------------------------
--------------------------------------------------------------------------------------------------------------------------------------------------------------------------------------------------------
--------------------------------------------------------------------------------------------------------------------------------------------------------------------------------------------------------
--------------------------------------------------------------------------------------------------------------------------------------------------------------------------------------------------------
--------------------------------------------------------------------------------------------------------------------------------------------------------------------------------------------------------
--------------------------------------------------------------------------------------------------------------------------------------------------------------------------------------------------------
--------------------------------------------------------------------------------------------------------------------------------------------------------------------------------------------------------
--------------------------------------------------------------------------------------------------------------------------------------------------------------------------------------------------------
-----------------------------SSS------------------------------------------------------------------------------------------------------------------------------------------------------------------------
-----------------------------------------------------------------------------------------------------------------------2SU------------------------------------------------------------------------------
--------------------------------------------------------------------------------------------------------------------------------------------------------------------------------------------------------
----------------------------------y---------------------------------------------------------------------------------------|-----------------------------------------------------------------------------
%%%%%%%%%%%%%%-------------%%%%%%%%%-------------------%%%%%--------#---#----------------------------------%%%-------g----k-----Tt----------------------------------------------------------------------
||||||||||||||-------------|||||||||-------------------|||||------%%%---%%%------------%%%%%---%%%%%-------|||------%%%%%%%%%---tt----%%--%%------------------------------------------------------------
||||||||||||||%%%%%---%%%%%|||||||||------%%%%%---%%%%%|||||------|||---|||%%%%%--%%%%%|||||---|||||-------|||------|||||||||---tt----||--||%%%%%%%%F%%%%%%%%%%%%%%%%%%%%%%%%%%%%%%%%%%%%%%%%%%%%%%%%%%%
|||||||||||||||||||---||||||||||||||XX--XX|||||---||||||||||XX--XX|||---||||||||--||||||||||---|||||XXXXXXX|||XX--XX|||||||||XXXXXXXXX||--||||||||||X|||||||||||||||||||||||||||||||||||||||||||||||||||
