HEIGHT=16;WIDTH=201;THEME=0;OVERRIDE=false
--------------------------------------------------------------------------------------------------------------------------------------------------------------------------------------------------------
--------------------------------------------------------------------------------------------------------------------------------------------------------------------------------------------------------
--------------------------------------------------------------------------------------------------------------------------------------------------------------------------------------------------------
--------------------------------------------------------------------------------------------------------------------------------------------------------------------------------------------------------
--------------------------------------------------------------------------------------------------------------------------------------------------------------------------------------------------------
--------------------------------------------------------------------------------------------------------------------------------------------------------------------------------------------------------
-----------------------------------------------------------------------------------------------------g--------------------------------------------------------------------------------------------------
----------------------------------------------------------------------------------------------------%%%%%%----------------------------------------------------------------------------------------------
----------------------------SS2SC2------------------------------------------------------------------||||||----------------------------------------------------------------------------------------------
----------------------------------------------------------------------------------------------------||||||--------------------------r--g----------------------------------------------------------------
---------------------------------------------------------USSSSSS------------------------------------||||||---------------SCC-------%%%%%%---------------------------------------------------------------
----------------------------k--------------------------------------------------------------------%%%%|||||-------------------------||||||---------------------------------------------------------------
----------------------------%%%%%%%------k-------%%%%%%-------------------%%--%%------%%%--%%%---|||||||||----g--------------------k|||||----g----%%%%%%%%F%%%%%%%%%%%%%%%%%%%%%%%%%%%%%%%%%%%%%%%%%%%%%
------------%%--%%----------|||||||---%%%%%%%----||||||-------------------||--||%%%%--|||--|||%%%%%%%%%%%%%%%%%%---------------%%%%%%%%%%%%%%%%%%%||||||||%|||||||||||||||||||||||||||||||||||||||||||||
------------||--||----------|||||k|---|||||||----||||||%%%%%%%%%%%%%%--%%%||--||||||%%|||--|||||||||||||||||||||--#--#--%%%%%%%|||||||||||||||||||||||||||||||||||||||||||||||||||||||||||||||||||||||||
XXXXXXXXXXXX||--||XXX---XXXXXXXXXXXXXX|||||||XXXX||||||||||||||||||||--|||||--|||||||||||--|||||||||||||||||||||XXX--XXX||||||||||||||||||||||||||||||||||||||||||||||||||||||||||||||||||||||||||||||||
