HEIGHT=16;WIDTH=201;THEME=0;OVERRIDE=false
--------------------------------------------------------------------------------------------------------------------------------------------------------------------------------------------------------
--------------------------------------------------------------------------------------------------------------------------------------------------------------------------------------------------------
--------------------------------------------------------------------------------------------------------------------------------------------------------------------------------------------------------
--------------------------------------------------------------------------------------------------------------------------------------------------------------------------------------------------------
--------------------------------------------------------------------------------------------------------------------------------------------------------------------------------------------------------
--------------------------------------------------------------------------------------------------------------------------------------------------------------------------------------------------------
--------------------------------------------------------------------------------------------------------------------------------------------------------------------------------------------------------
--------------------------------------------------------------------------------------------------------------------------------------------------------------------------------------------------------
--------------USCCS-------------------------------------------------------------------------------------------------------------------------------------------------------------------------------------
---------------------------------SSUU-------------------------------------------------------------------------------------------------------------------------------------------------------------------
-----------------------------------------------------------------------USC-------------SS2SSC-----------------------------------------------------------------------------------------------------------
------------------k---------------------------------------------------------------------------------------------------k---------------------------------------------------------------------------------
------------%%%%%%%%%-------------------------------%%%%--%%%%---------------%%%---%%%---------------------%%--%%---%%%%%-------------------------------------------------------------------------------
%%%%%%%%%%%%|||||||||-----------%%%%%%%%------------||||--||||---------------|||---|||---------r-%%%%--%%%%||--||---|||||--------------------%%%%%%%%F%%%%%%%%%%%%%%%%%%%%%%%%%%%%%%%%%%%%%%%%%%%%%%%%%%
|||||||||||||||||||||%%%%---%%%%||||||||%%%%%--%%%%%||||--||||%%---%%%%%%%%%%|||---|||%%%%%%%%%%%||||--||||||--||---|||ky---k-%%--%%--#---#--||||||||%||||||||||||||||||||||||||||||||||||||||||||||||||
|||||||||||||||||||||||||---|||||||||||||||||--|||||||||--||||||---|||||||||||||---||||||||||||||||||--||||||--||XXXXXXXXXXXXX||--||XXX---XXX|||||||||||||||||||||||||||||||||||||||||||||||||||||||||||
