HEIGHT=16;WIDTH=201;THEME=0;OVERRIDE=false
--------------------------------------------------------------------------------------------------------------------------------------------------------------------------------------------------------
--------------------------------------------------------------------------------------------------------------------------------------------------------------------------------------------------------
--------------------------------------------------------------------------------------------------------------------------------------------------------------------------------------------------------
--------------------------------------------------------------------------------------------------------------------------------------------------------------------------------------------------------
--------------------------------------------------------------------------------------------------------------------------------------------------------------------------------------------------------
--------------------------------------------------------------------------------------------------------------------------------------------------------------------------------------------------------
--------------------------------------------------------------------------------------------------------------------------------------------------------------------------------------------------------
--------------------------------------------------------------------------------------------------------------------------------------------------------------------------------------------------------
------------------------------------------SSC--2---%%%%%%%----------------------------------------------------------------------------------------------------------------------------------------------
---------------------------------------------------|||||||--------------------------------------------------------------------tt------------------------------------------------------------------------
---------------------------------------------%%----|||||||--------------------------------------------------------------------tt------------------------------------------------------------------------
---------------------------------------------||Y---|||||||----------------------------------------------#---#-----------------tt------------------------------------------------------------------------
%%%%%%%%%%-------------------------------%%%%%%%%%-||%%%%|-----------------------%%%%%--%%%%%---------%%%---%%%%%%%---%%%%%%%%%%%%%%%%---%%%%%%%%%%F%%%%%%%%%%%%%%%%%%%%%%%%%%%%%%%%%%%%%%%%%%%%%%%%%%%%
||||||||||-------------------------------|||||||||-|||||r|-------------%%%%--%%%%|||||--|||||---------|||---|||||||---||||||||||||||||---||||||||||%||||||||||||||||||||||||||||||||||||||||||||||||||||
||||||||||-------------------------------|||||||||%%%%%%%%%%%----------||||--|||||||||--|||||---------|||---|||||||---||||||||||||||||---|||||||||||||||||||||||||||||||||||||||||||||||||||||||||||||||
||||||||||XXX---XXXXXXX---XXXXXXXX---XXXX||||||||||||||||||||XXXX--XXXX||||--|||||||||--|||||XXXXXXXXX|||---|||||||---||||||||||||||||---|||||||||||||||||||||||||||||||||||||||||||||||||||||||||||||||
