HEIGHT=16;WIDTH=201;THEME=0;OVERRIDE=false
--------------------------------------------------------------------------------------------------------------------------------------------------------------------------------------------------------
--------------------------------------------------------------------------------------------------------------------------------------------------------------------------------------------------------
-----------------------------------------------------SSS------------------------------------------------------------------------------------------------------------------------------------------------
--------------------------------------------------------------------------------------------------------------------------------------------------------------------------------------------------------
--------------------------------------------------------------------------------------------------------------------------------------------------------------------------------------------------------
--------------------------------------------------G--g--------------------------------------------------------------------------------------------------------------------------------------------------
--------------------------------------------------%%%%%%------------------------------------------------------------------------------------------------------------------------------------------------
--------------------------------------------------||||||------------------------------------------------------------------------------------------------------------------------------------------------
--------------------------------------------------||||||------------------------------------------------------------------------------------------------------------------------------------------------
--------------------------------------------------||||%%%%%%--------------------------------------------------------------------------------------------------------------------------------------------
------------------------------#---#---------------||||||||||--------------------------------------------------------------------------------------------------------------------------------------------
-----------------------------##---##--------------||||||||||-------------------------------------------------------%%%----------------------------------------------------------------------------------
%%%%%%%%%%%%%%-------------%%%%---%%%%------------|||||||k||G-----------------------------------%%%%--%%%%---------|||----------------------------------------------------------------------------------
||||||||||||||-------------||||---||||--%%%------%%%%%%%%%%%%%%%%%------------------------------||||--||||---------|||-k--------------------------------------------------------------------------------
||||||||||||||%%%%%---%%%%%||||---||||--y||------|||||||||||||||||--------%%%%%%%--%%-----------||||--||||------%%%%%%%%%%%%%---------------------------------------------------------------------------
|||||||||||||||||||---|||||||||---||||XXXXXXXXXXX|||||||||||||||||XXX--XXX|||||||--||XXXX---XXXX||||--||||XX--XX|||||||||||||XXXX---XXXXXXXXXXXXFXXXXXXXXXXXXXXXXXXXXXXXXXXXXXXXXXXXXXXXXXXXXXXXXXXXXXXX
