HEIGHT=16;WIDTH=201;THEME=0;OVERRIDE=false
--------------------------------------------------------------------------------------------------------------------------------------------------------------------------------------------------------
--------------------------------------------------------------------------------------------------------------------------------------------------------------------------------------------------------
--------------------------------------------------------------------------------------------------------------------------------------------------------------------------------------------------------
--------------------------------------------------------------------------------------------------------------------------------------------------------------------------------------------------------
--------------------------------------------------------------------------------------------------------------------------------------------------------------------------------------------------------
--------------------------------------------------------------------------------------------------------------------------------------------------------------------------------------------------------
--------------------------------------------------------------------------------------------------------------------------------------------------------------------------------------------------------
--------------------------------------------------------------------------------------------------------------------------------------------------------------------------------------------------------
--------------------------------------------------------------------------------------------------------------------------------------------------------------------------------------------------------
--------------------------------------------------------------------------------------------------------------------------------------------------------------------------------------------------------
--------------------------------------------------------------------------------k-----------CSU-----CCSS2-----------------------------------------------------------------------------------------------
------------------------------------------------------------------------------%%%---r-------------------------------------------------------------------------------------------------------------------
-------------------------------------%%%%--%%%%------------------------r--y---|||--%%%%%%---------------------------------------------------------------------------------------------------------------
------------%%%--%%%--#--#----#---#--||||--||||---------------------%%%%%%%%%%%%%%%||||||--k----G--k---g---%%%--#--#--%%--%%%%--%%%%%%--%%%%------------------------------------------------------------
------------|||--|||%%%--%%%%%%---%%%||||--||||--#---#--%%--%%------|||||||||||||||||||||%%%%%%%%%%%%%%%%%%|||%%%--%%%||--||||--||||||--||||------------------------------------------------------------
XXXXXXXXXXXX|||--||||||--||||||---|||||||--||||XXX---XXX||--||XX--XX|||||||||||||||||||||||||||||||||||||||||||||--|||||--||||--||||||--||||XXXXXXXXFXXXXXXXXXXXXXXXXXXXXXXXXXXXXXXXXXXXXXXXXXXXXXXXXXXX
