HEIGHT=16;WIDTH=201;THEME=0;OVERRIDE=false
--------------------------------------------------------------------------------------------------------------------------------------------------------------------------------------------------------
--------------------------------------------------------------------------------------------------------------------------------------------------------------------------------------------------------
--------------------------------------------------------------------------------------------------------------------------------------------------------------------------------------------------------
--------------------------------------------------------------------------------------------------------------------------------------------------------------------------------------------------------
--------------------------------------------------------------------------------------------------------------------------------------------------------------------------------------------------------
--------------------------------------------------------------------------------------------------------------------------------------------------------------------------------------------------------
--------------------------------------------------------------------------------------------------------------------------------------------------------------------------------------------------------
--------------------------------------------------------------------------------------------------------------------------------------------------------------------------------------------------------
--------------------------------------------------------------------------------------------------------------------------------------------------------------------------------------------------------
--------------------------------------------------------------------------------------------------------------------------------------------------------------------------------------------------------
--------------------------------------------------------------------------------------------------------------------------------------------------------------------------------------------------------
--------------------------------------------------------------------------------------------------------------------------------------------------------------------------------------------------------
------------------------------------------------------------------#---#------#---#------#---#-----------------------------------------tt----Tt----------------------------------------------------------
----------------------#---#-------------------------------------%%%---%%%---##---##---%%%---%%%%%%---%%%-------------------%%%%--%%%%-tt----tt---%%%%%%%%F%%%%%%%%%%%%%%%%%%%%%%%%%%%%%%%%%%%%%%%%%%%%%%
%%%%%%%%%%%%%%%---%%%%%---%%%----------%%%--%%%-------------%%%%|||---|||--###---###--|||---||||||---|||-------------------||||--||||-tt----tt---||||||||%||||||||||||||||||||||||||||||||||||||||||||||
|||||||||||||||---|||||---|||XXXX--XXXX|||--|||XXXXX---XXXXX|||||||---|||XXXXX---XXXXX|||---||||||---|||XX---XXXXXXX--XXXXX||||--||||XXXXXXXXXXXX|||||||||||||||||||||||||||||||||||||||||||||||||||||||
