HEIGHT=16;WIDTH=201;THEME=0;OVERRIDE=false
--------------------------------------------------------------------------------------------------------------------------------------------------------------------------------------------------------
--------------------------------------------------------------------------------------------------------------------------------------------------------------------------------------------------------
--------------------------------------------------------------------------------------------------------------------------------------------------------------------------------------------------------
--------------------------------------------------------------------------------------------------------------------------------------------------------------------------------------------------------
--------------------------------------------------------------------------------------------------------------------------------------------------------------------------------------------------------
--------------------------------------------------------------------------------------------------------------------------------------------------------------------------------------------------------
--------------------------------------------------------------------------------------------------------------------------------------------------------------------------------------------------------
--------------------------------------------------------------------------------------------------------------------------------------------------------------------------------------------------------
---------------------USCCSS-----------------------------------------------------------------------------------------------------------------------------------------------------------------------------
----------------------------------------------------------------------------------------------------------------------------------------S2SUS-----------------------------------------------------------
-----------------------------------------------------------------------%%%%%----tt----------------------------------------------------------------------------------------------------------------------
------------------------y--------------------------------------------r-|||||----tt----------------------------------------------------------------------------------------------------------------------
-------------#--#--%%%%%%%%%%%-----%%------------%%----------------%%%%%%%%%%%%%%%%%%%%%----------------------------------------------------k-----------------------------------------------------------
-----------%%%--%%%|||||||||||-----||%%%%%--%%%%%||--%%%%%%--------|||||||||||||||||||||-----------------------------------%%%%%--%%%%%%%%%%%%%%%%%%%%F%%%%%%%%%%%%%%%%%%%%%%%%%%%%%%%%%%%%%%%%%%%%%%%%%
%%%%%%%%%%%|||--||||||||||||||%%%%%|||||||--|||||||--|||g||--------|||||||||||||||||||||%%%%--%%%%%%%%---------------------|||||--||||||||||||||||||||%|||||||||||||||||||||||||||||||||||||||||||||||||
||||||||||||||--||||||||||||||||||||||||||--|||||||XXXXXXXXXXXXXXXX|||||||||||||||||||||||||--||||||||XXXX--XXXXXXXX---XXXX|||||--||||||||||||||||||||||||||||||||||||||||||||||||||||||||||||||||||||||
