HEIGHT=16;WIDTH=201;THEME=0;OVERRIDE=false
--------------------------------------------------------------------------------------------------------------------------------------------------------------------------------------------------------
--------------------------------------------------------------------------------------------------------------------------------------------------------------------------------------------------------
--------------------------------------------------------------------------------------------------------------------------------------------------------------------------------------------------------
--------------------------------------------------------------------------------------------------------------------------------------------------------------------------------------------------------
--------------------------------------------------------------------------------------------------------------------------------------------------------------------------------------------------------
--------------------------------------------------------------------------------------------------------------------------------------------------------------------------------------------------------
--------------------------------------------------------------------------------------------------------------------------------------------------------------------------------------------------------
--------------------------------------------------------------------------------------------------------------------------------------------------------------------------------------------------------
--------------------------------------------------------------------------------------------------------------------------------------------------------------------------------------------------------
--------------------------------------------------------------------------------------------------------------------------------------------------------------------------------------------------------
--------------------------------------------------------------------------------------------------------------------------------------------------------------------------------------------------------
-------------------------------------------------------------SSCCS--------------------------------------------------------------------------------------------------------------------------------------
----------------------------------%%%%%---%%%%%----------------------%%--%%%%--%%--------%%%------------------------------------------------------------------------------------------------------------
%%%%%%%%%%%%%%--%%---------%%---%%|||||---|||||----------------------||--||||--||--------|||--------------------------------------%%%--%%%%%%%%%%%F%%%%%%%%%%%%%%%%%%%%%%%%%%%%%%%%%%%%%%%%%%%%%%%%%%%%%
||||||||||||||--||--#---#--||---|||||||---|||||%%%%%--%%%%%----------||--||||--||--------|||---------------------------%%%%---%%%%|||--|||||||||||%|||||||||||||||||||||||||||||||||||||||||||||||||||||
||||||||||||||--||XXX---XXX||---|||||||---||||||||||--|||||XXXXXXXXXX||--||||--||XXXXXXXXXXXXXXXXX---XXXXX---XXXXXXXXXX||||---|||||||--|||||||||||||||||||||||||||||||||||||||||||||||||||||||||||||||||
