HEIGHT=16;WIDTH=201;THEME=0;OVERRIDE=false
--------------------------------------------------------------------------------------------------------------------------------------------------------------------------------------------------------
--------------------------------------------------------------------------------------------------------------------------------------------------------------------------------------------------------
--------------------------------------------------------------------------------------------------------------------------------------------------------------------------------------------------------
--------------------------------------------------------------------------------------------------------------------------------------------------------------------------------------------------------
--------------------------------------------------------------------------------------------------------------------------------------------------------------------------------------------------------
--------------------------------------------------------------------------------------------------------------------------------------------------------------------------------------------------------
--------------------------------------------------------------------------------------------------------------------------------------------------------------------------------------------------------
--------------------------------------------------------------------------------------------------------------------------------------------------------------------------------------------------------
--------------------------------------------------------------------------------------------------------------------------------------------------------------------------------------------------------
-------------------------------------------------------------------------------------SSSS----------------------------------Tt---------------------------------------------------------------------------
---------------------------------------------------------------------------------------------------------------------------tt---tt----------------------------------------------------------------------
------------------------------------------------------------------------------------------------------------------#--#-----tt---tt----------------------------------------------------------------------
%%%%%%%%%%%%%%%%%%%%--------%%%%%--%%%%%------%%%%%---%%%%%---------------%%%%%%%%-------g-----------------------##--##---%%%%%%%%%----------%%%%%%%%F%%%%%%%%%%%%%%%%%%%%%%%%%%%%%%%%%%%%%%%%%%%%%%%%%%
||||||||||||||||||||--#--#--|||||--|||||------|||||---|||||%%---%%--#--#--||||||||%%%%%%%%%%%%%%--%%%-----------###--###--|||||||||----------||||||||%||||||||||||||||||||||||||||||||||||||||||||||||||
||||||||||||||||||||%%%--%%%|||||--|||||------|||||---|||||||---||%%%--%%%||||||||||||||||||||||--|||%%%%%%%%%%%%%%--%%%%%|||||||||----------|||||||||||||||||||||||||||||||||||||||||||||||||||||||||||
|||||||||||||||||||||||--||||||||--|||||XX--XX|||||---|||||||---|||||--|||||||||||||||||||||||||--|||||||||||||||||--||||||||||||||XXXX--XXXX|||||||||||||||||||||||||||||||||||||||||||||||||||||||||||
