HEIGHT=16;WIDTH=201;THEME=0;OVERRIDE=false
--------------------------------------------------------------------------------------------------------------------------------------------------------------------------------------------------------
--------------------------------------------------------------------------------------------------------------------------------------------------------------------------------------------------------
--------------------------------------------------------------------------------------------------------------------------------------------------------------------------------------------------------
--------------------------------------------------------------------------------------------------------------------------------------------------------------------------------------------------------
--------------------------------------------------------------------------------------------------------------------------------------------------------------------------------------------------------
--------------------------------------------------------------------------------------------------------------------------------------------------------------------------------------------------------
----------------------------------------------------%%%-------------------------------------------------------------------------------------------------------------------------------------------------
----------------------------------------------------|||-------------------------------------------------------------------------------------------------------------------------------------------------
----------------------------------------------------|||-------------------------------------------------------------------------------------------------------------------------------------------------
----------------------------------------------------|||-gk------------------------------------------#--#------------------------------------------------------------------------------------------------
----------------------------------------------------||%%%%%----------------------------------------##--##-----Tt----------SSSSSS------------------------------------------------------------------------
----------------------------------------------------|||||||---------------------#---#-------------###--###----tt--------------------#--#----------------------------------------------------------------
%%%%%%%%%%%%%---%%%%%---%%%-------------------------|||||||--------------------##---##----------%%%%%--%%%%%--tt-%%--%%-----------%%%--%%%--------------------------------------------------------------
|||||||||||||---|||||---|||-----------%%%%%%-------G||||||r-----%%%%%--%%%%%--###---###--%%---%%|||||--|||||%%%%%||--||-----------|||--|||--------------------------------------------------------------
|||||||||||||---|||||---|||%%---%%----||||||-k----%%%%%%%%%%%---|||||--|||||%%%%%---%%%%%||---|||||||--||||||||||||--||%%%%%%%%%%%|||--|||--------------------------------------------------------------
|||||||||||||---|||||---|||||---||XXXX||||||XXXXXX|||||||||||XXX|||||--||||||||||---|||||||---|||||||--||||||||||||--||||||||||||||||--|||XXXXXXXXFXXXXXXXXXXXXXXXXXXXXXXXXXXXXXXXXXXXXXXXXXXXXXXXXXXXXX
