HEIGHT=16;WIDTH=201;THEME=0;OVERRIDE=false
--------------------------------------------------------------------------------------------------------------------------------------------------------------------------------------------------------
--------------------------------------------------------------------------------------------------------------------------------------------------------------------------------------------------------
--------------------------------------------------------------------------------------------------------------------------------------------------------------------------------------------------------
-------------------------------------------------------------------------------------SCSC---------------------------------------------------------------------------------------------------------------
--------------------------------------------------------------------------------------------------------------------------------------------------------------------------------------------------------
------------------------------------------------------------------------------------------------------------------------------------------------S-2S----------------------------------------------------
--------------------------------------------------------------------------------------kry---------------------------------------------------------------------------------------------------------------
------------------------------------------------------------------------------------%%%%%%-------------------------------------------------------%------------------------------------------------------
------------------------------------------------------------------------------------||||||-------------------------------------------------------|------------------------------------------------------
------------------------------------------------------------------------------------||||||------------------------------------------------------%%%%%%--------------------------------------------------
------------------------------------------------------------------------------------||||r|-----------------------------#---#--------------------||||||--------------------------------------------------
---------------------------------------------------#---#-----%%%%%%-----------------|%%%%%%%------------------#--#----##---##-------------------||||||--------------------------------------------------
%%%%%%%%%%%----------------------%%%%%%%%%--------##---##----||||||-----------------||||||||----------------%%%--%%%%%%%---%%%%%%---%%----------||||||--------------------------------------------------
|||||||||||--#---#---------------|||||||||-------###---###--%%%%%%%%%%%----Tt-------||||||||----------------|||--|||||||---||||||---||%%%%%%%%%%%%%%%%%%------------------------------------------------
|||||||||||%%%---%%%%%%%%---%%%%%|||||||||-----%%%%%---%%%%%|||||||||||----tt----%%%%%%%%%%%%%%%-----%%---%%|||--|||||||---||||||---||||||||||||||||||||------------------------------------------------
||||||||||||||---||||||||---||||||||||||||XXXXX|||||---||||||||||||||||XXXXXXXXXX|||||||||||||||XXXXX||---|||||--|||||||---||||||---||||||||||||||||||||XXXXXXXXFXXXXXXXXXXXXXXXXXXXXXXXXXXXXXXXXXXXXXXX
