HEIGHT=16;WIDTH=201;THEME=0;OVERRIDE=false
--------------------------------------------------------------------------------------------------------------------------------------------------------------------------------------------------------
--------------------------------------------------------------------------------------------------------------------------------------------------------------------------------------------------------
--------------------------------------------------------------------------------------------------------------------------------------------------------------------------------------------------------
--------------------------------------------------------------------------------------------------------------------------------------------------------------------------------------------------------
--------------------------------------------------------------------------------------------------------------------------------------------------------------------------------------------------------
--------------------------------------------------------------------------------------------------------------------------------------------------------------------------------------------------------
--------------------------------------------------------------------------------------------------------------------------------------------------------------------------------------------------------
--------------------------------------------------------------------------------------------------------------------------------------------------------------------------------------------------------
-----------------------------------CSSCSS------------------------------------------------------------------------2SSCC----------------------------------------------------------------------------------
--------------------------------------------------------------------------------------------------------tt----------------------------------------------------------------------------------------------
--------------%%%%%-------------------------------------------------------------------------------------tt------%---------------------------------------------------------------------------------------
--------------|||||-------------------------------------------------------------#---#-------------------tt------|--k------------------------------------------------------------------------------------
--------------|||||----%%%--%%%%%%%%%%%%%%---#---#-----------------------------##---##---%%%%%%--------%%%%%%%%%%%%%%%%%%%%-------------%%%%%%%%F%%%%%%%%%%%%%%%%%%%%%%%%%%%%%%%%%%%%%%%%%%%%%%%%%%%%%%%
--------------||y||gy--|||--||||||||||||||--##---##-----------#---#-----------###---###--||||||--------||||||||||||||||||||-------------||||||||%|||||||||||||||||||||||||||||||||||||||||||||||||||||||
-------------%%%%%%%%%%|||--||||||||||||||%%%%---%%%%%%--%%--##---##-----k--%%%%%---%%%%%||||||--#--#--||||||||||||||||||||%%%%%---%%%%%||||||||||||||||||||||||||||||||||||||||||||||||||||||||||||||||
XXXXXXXXXXXXX|||||||||||||--||||||||||||||||||---||||||--||XXXX---XXXXXXXXXX|||||---|||||||||||XXX--XXX|||||||||||||||||||||||||---|||||||||||||||||||||||||||||||||||||||||||||||||||||||||||||||||||||
