HEIGHT=16;WIDTH=201;THEME=0;OVERRIDE=false
--------------------------------------------------------------------------------------------------------------------------------------------------------------------------------------------------------
--------------------------------------------------------------------------------------------------------------------------------------------------------------------------------------------------------
--------------------------------------------------------------------------------------------------------------------------------------------------------------------------------------------------------
--------------------------------------------------------------------------------------------------------------------------------------------------------------------------------------------------------
--------------------------------------------------------------------------------------------------------------------------------------------------------------------------------------------------------
--------------------------------------------------------------------------------------------------------------------------------------------------------------------------------------------------------
--------------------------------------------------------------------------------------------------------------------------------------------------------------------------------------------------------
--------------------------------------------------------------------------------------------------------------------------------------------------------------------------------------------------------
--------------------------------------------------------------------------------------------------------------------------------------------------------------------------------------------------------
--------------------------------------------------------------------------------------------------------------------------------------------------------------------------------------------------------
-------------------------------------Tt-tt--------------------------------------------------------------------------------------------------------------------------------------------------------------
-------------------------------------tt-tt--------------------------------------------------------------------------------------------------------------------------------------------------------------
%%%%%%%%%%%%-Tt----tt----%%%---%%%%%%%%%%%%%%%%%%%--%%%%---------------%%%%---%%%%%%%%%--%%%%%------------------#--#--------------%%%--%%%--------------------------------------------------------------
||||||||||||-tt----tt----|||---|||||||||||||||||||--||||%%%---%%%%%--%%||||---|||||||||--|||||---------%%%%%%--##--##-------------|||--|||--------------------------------------------------------------
||||||||||||%%%%%%%%%%%%%|||---|||||||||||||||||||--|||||||---|||||--||||||---|||||||||--|||||---------||||||%%%%--%%%%-----------|||--|||--------------------------------------------------------------
||||||||||||||||||||||||||||---|||||||||||||||||||--|||||||---|||||--||||||---|||||||||--|||||XXX---XXX||||||||||--||||XXXX---XXXX|||--|||XXXXXXXXFXXXXXXXXXXXXXXXXXXXXXXXXXXXXXXXXXXXXXXXXXXXXXXXXXXXXX
