HEIGHT=16;WIDTH=201;THEME=0;OVERRIDE=false
--------------------------------------------------------------------------------------------------------------------------------------------------------------------------------------------------------
--------------------------------------------------------------------------------------------------------------------------------------------------------------------------------------------------------
--------------------------------------------------------------------------------------------------------------------------------------------------------------------------------------------------------
--------------------------------------------------------------------------------------------------------------------------------------------------------------------------------------------------------
--------------------------------------------------------------------------------------------------------------------------------------------------------------------------------------------------------
--------------------------------------------------------------------------------------------------------------------------------------------------------------------------------------------------------
--------------------------------------------------------------------------------------------------------------------------------------------------------------------------------------------------------
------------------------------------------------------------------------------------------------------------%%%%%%--------------------------------------------------------------------------------------
------------------------------------------------------------------------------------------------------------||||||--------------------------------------------------------------------------------------
------------------------------------SSCSSS------------------------------------------------------------------k|||||--------------------------------------------------------------------------------------
-------------------------------------------------------------------CCSS2--------------------------------%%%%%|||||-------%%%-------------g--------------------------------------------------------------
----------------------------------------------#---#-----------------------------------------------------||||||||||-------|||--Y---------%%%%%%----------------------------------------------------------
%%%%%%%%%%%%%%--------------------g--y------%%%---%%%---------------------------------------------------y|||||||||r-%%%%%%%%%%%%%%------||||||----------------------------------------------------------
||||||||||||||%%---%%%%%%%--%%%%%%%%%%%%%%%%|||---|||---#---#------------------------------------%%%%%%%%%%%%%%%%%%%||||||||||||||--k---||||||g---------------------------------------------------------
||||||||||||||||---|||||||--|||||||||||||||||||---|||--##---##--%%%%%%%%%%%%%%%%---%%%%%---------|||||||||||||||||||||||||||||||||%%%%%%%%%%%%%%--------------------------------------------------------
||||||||||||||||---|||||||--|||||||||||||||||||---|||XXXX---XXXX||||||||||||||||---|||||XXX---XXX|||||||||||||||||||||||||||||||||||||||||||||||XXXXXXXXFXXXXXXXXXXXXXXXXXXXXXXXXXXXXXXXXXXXXXXXXXXXXXXX
