HEIGHT=16;WIDTH=201;THEME=0;OVERRIDE=false
--------------------------------------------------------------------------------------------------------------------------------------------------------------------------------------------------------
--------------------------------------------------------------------------------------------------------------------------------------------------------------------------------------------------------
--------------------------------------------------------------------------------------------------------------------------------------------------------------------------------------------------------
--------------------------------------------------------------------------------------------------------------------------------------------------------------------------------------------------------
--------------------------------------------------------------------------------------------------------------------------------------------------------------------------------------------------------
--------------------------------------------------------------------------------------------------------------------------------------------------------------------------------------------------------
--------------------------------------------------------------------------------------------------------------------------------------------------------------------------------------------------------
--------------------------------------------------------------------------------------------------------------------------------------------------------------------------------------------------------
--------------------------------------------------------------------------------------------------------------------------------------------------------------------------------------------------------
------------------------tt-tt------------------------------------------------------------------------------------------CSCS-----------------------------------------------------------------------------
------------------------tt-tt--tt-----------------------------------------------------------------------------------------------------------------------------------------------------------------------
------------------------tt-tt--tt--------------#---#---------------------Tt-----------------------------------------------------------------------------------------------------------------------------
-------------%%%---%%%%%%%%%%%%%%%%%---------%%%---%%%-------------------tt------------------------------------------g---k----%%---%%-------------------------------------------------------------------
%%%%%%%%%%%%%|||---|||||||||||||||||---------|||---|||-----%%%%%---%%%%%%%%%%%---------------------%%%%--%%%%-------%%%%%%%%%%||---||%%%%%--------------------------------------------------------------
||||||||||||||||---|||||||||||||||||-------%%|||---|||%%%%%|||||---|||||||||||---------------------||||--||||-------||||||||||||---|||||||%%%%%%%%F%%%%%%%%%%%%%%%%%%%%%%%%%%%%%%%%%%%%%%%%%%%%%%%%%%%%%
||||||||||||||||---|||||||||||||||||XX---XX|||||---|||||||||||||---|||||||||||XXXX--XXXXXXXX---XXXX||||--||||XXXXXXX||||||||||||---|||||||||||||||X|||||||||||||||||||||||||||||||||||||||||||||||||||||
