HEIGHT=16;WIDTH=201;THEME=0;OVERRIDE=false
--------------------------------------------------------------------------------------------------------------------------------------------------------------------------------------------------------
--------------------------------------------------------------------------------------------------------------------------------------------------------------------------------------------------------
--------------------------------------------------------------------------------------------------------------------------------------------------------------------------------------------------------
--------------------------------------------------------------------------------------------------------------------------------------------------------------------------------------------------------
--------------------------------------------------------------------------------------------------------------------------------------------------------------------------------------------------------
------------------------------------------------------------------------------------------y-------------------------------------------------------------------------------------------------------------
-----------------------------------------------------------------------------------------%%%------------------------------------------------------------------------------------------------------------
-----------------------------------------------------------------------------------------|||------------------------------------------------------------------------------------------------------------
---------------------------------------------------------------------%%%%%---------------|||------------------------------------------------------------------------------------------------------------
---------------------------------------------------------------------|||||---------------|||--r---------------------------------------------------------------------------------------------------------
--------------------------#---#--------------------------------------|||||---------------|%%%%%%--------------------------------------------------------------------------------------------------------
-------------------------##---##-------------------------------------||||y------------G--||g|y||g-------------------------------------------------------------------------------------------------------
%%%%%%%%%%%%-----------%%%%---%%%%----%%%--%%%%%----Tt---------------||||%%%-----%%%%%%%%%%%%%%%%%%%%---------------------------------------------------------------------------------------------------
||||||||||||-----------||||---||||%%%%|||--|||||----tt---%%%%--%%%%--|||||||-----||||||||||||||||||||------------------#---#------#---#-----------------------------------------------------------------
||||||||||||%%%%---%%%%||||---|||||||||||--|||||----tt---||||--||||%%%%%%%%%%%%%%||||||||||||||||||||%%%%%%%%%--%%%%--##---##----##---##----------------------------------------------------------------
||||||||||||||||---||||||||---|||||||||||--|||||XXXXXXXXX||||--|||||||||||||||||||||||||||||||||||||||||||||||--||||XXXX---XXXXXXXX---XXXXXXXXXXXXFXXXXXXXXXXXXXXXXXXXXXXXXXXXXXXXXXXXXXXXXXXXXXXXXXXXXX
