HEIGHT=16;WIDTH=201;THEME=0;OVERRIDE=false
--------------------------------------------------------------------------------------------------------------------------------------------------------------------------------------------------------
--------------------------------------------------------------------------------------------------------------------------------------------------------------------------------------------------------
--------------------------------------------------------------------------------------------------------------------------------------------------------------------------------------------------------
--------------------------------------------------------------------------------------------------------------------------------------------------------------------------------------------------------
--------------------------------------------------------------------------------------------------------------------------------------------------------------------------------------------------------
--------------------------------------------------------------------------------------------------------------------------------------------------------------------------------------------------------
--------------------------------------------------------------------------------------------------------------------------------------------------------------------------------------------------------
--------------------------------------------------------------------------------------------------------------------------------------------------------------------------------------------------------
--------------------------------------------------------------------------------------------------------------------------------------------------------------------------------------------------------
--------------------------------------------------------------------------------------------------------------------------------------------------------------------------------------------------------
-----------------------------------------------k--------------------------------------------------------------------------------------------------------------------------------------------------------
----------------------------------------------%%%%%%%---------------------------------------------------------------------------------------------------------------------------------------------------
----------------------------------------------|||||||---%%%%---%%%%----------------------------------------------------------------------------%%%%%%%%F%%%%%%%%%%%%%%%%%%%%%%%%%%%%%%%%%%%%%%%%%%%%%%%%
%%%%%%%%%%%%%%--%%%%%%%%--%%%%----------------||||||yk--||||---||||----------------------%%%---%%%---#--#------------------------------#---#---||||||||%||||||||||||||||||||||||||||||||||||||||||||||||
||||||||||||||--||||||||--||||-------------%%%%%%%%%%%%%||||---||||-------------%%%---%%%|||---|||--##--##--------------------rg------##---##--|||||||||||||||||||||||||||||||||||||||||||||||||||||||||
||||||||||||||--||||||||--||||XXXXX---XXXXX|||||||||||||||||---||||XXXXX---XXXXX|||---||||||---|||XXXX--XXXXXXX--XXXXX---XXXXXXXXXXXXXXX---XXXX|||||||||||||||||||||||||||||||||||||||||||||||||||||||||
