HEIGHT=16;WIDTH=201;THEME=0;OVERRIDE=false
--------------------------------------------------------------------------------------------------------------------------------------------------------------------------------------------------------
--------------------------------------------------------------------------------------------------------------------------------------------------------------------------------------------------------
--------------------------------------------------------------------------------------------------------------------------------------------------------------------------------------------------------
--------------------------------------------------------------------------------------------------------------------------------------------------------------------------------------------------------
--------------------------------------------------------------------------------------------------------------------------------------------------------------------------------------------------------
--------------------------------------------------------------------------------------------------------------------------------------------------------------------------------------------------------
--------------------------------------------------------------------------------------------------------------------------------------------------------------------------------------------------------
--------------------------------------------------------------------------------------------------------------------------------------------------------------------------------------------------------
--------------------------------------------------------------------------------------------------------------------------------------------------------------------------------------------------------
-------------222-SCS------------------------------------------------------------------------------------------------------------------------------------------------------------------------------------
----------------------SCU------------------------------------------------------------------------#--#---------------------------------------------------------------------------------------------------
----------------%------------------------%%%%%%----------------tt-----Tt------------------------##--##----------------%%%-------------------------------------------------------------------------------
----------------|--r---------------------Y||gk|----------------tt-tt--tt----------------------%%%%--%%%%--------------|||-------------------%%%%%%%%F%%%%%%%%%%%%%%%%%%%%%%%%%%%%%%%%%%%%%%%%%%%%%%%%%%%
------------%%%%%%%%%-------------------%%%%%%%%%%-------------tt-tt--tt----------------------||||--||||--------------|||g--g----k----------||||||||%|||||||||||||||||||||||||||||||||||||||||||||||||||
------------|||||||||%%%%%%%%%%%%---%%%%||||||||||-----------%%%%%%%%%%%%%%%%%%--%%%%%--------||||--||||%%%%%--%%%%%%%%%%%%%%%%%%%%%%%%%--%%||||||||||||||||||||||||||||||||||||||||||||||||||||||||||||
XXXXXXXXXXXX|||||||||||||||||||||---||||||||||||||XXXX---XXXX||||||||||||||||||--|||||XXX--XXX||||--|||||||||--|||||||||||||||||||||||||--||||||||||||||||||||||||||||||||||||||||||||||||||||||||||||||
