HEIGHT=16;WIDTH=201;THEME=0;OVERRIDE=false
--------------------------------------------------------------------------------------------------------------------------------------------------------------------------------------------------------
--------------------------------------------------------------------------------------------------------------------------------------------------------------------------------------------------------
--------------------------------------------------------------------------------------------------------------------------------------------------------------------------------------------------------
--------------------------------------------------------------------------------------------------------------------------------------------------------------------------------------------------------
--------------------------------------------g-----------------------------------------------------------------------------------------------------------------------------------------------------------
------------------------------------------%%%%----------------------------------------------------------------------------------------------------------------------------------------------------------
------------------------------------------||||----------------------------------------------------------------------------------------------------------------------------------------------------------
------------------------------------------||||----------------------------------------------------------------------------------------------------------------------------------------------------------
-----------------------------------------yyy||----------------------------------------------------------------------------------------------------------------------------------------------------------
---------------------------------------%%%%%%|-------------------------------------------------------------------#---#----------------------------------------------------------------------------------
---------------------------------------|||||||------------------------------------------------------------------##---##------------------Tt-------------------------------------------------------------
---------------------------------------|||||||-------------------------------S2SSSSCSS-------------------------###---###------------tt---tt-------------------------------------------------------------
%%%%%%%%%%%%%%%%%%---%%%%--------------|||||||------------%%%%%------------------------%%%-----------#---#---%%%%%---%%%%%----------tt---tt-------------------------------------------------------------
||||||||||||||||||---||||%%%%---%%%%%%%%%%%%%%%%%%%-------|||||------------------------|||----------##---##--|||||---|||||--#--#--%%%%%%%%%%------------------------------------------------------------
||||||||||||||||||---||||||||---|||||||||||||||||||-------|||||---------------k--------|||%%%--%%%%%%%---%%%%|||||---|||||%%%--%%%||||||||||------------------------------------------------------------
||||||||||||||||||---||||||||---|||||||||||||||||||XX---XX|||||XXXXX---XXXXXXXXXXXXXXXX||||||--|||||||---|||||||||---||||||||--|||||||||||||XXXXXXXXFXXXXXXXXXXXXXXXXXXXXXXXXXXXXXXXXXXXXXXXXXXXXXXXXXXX
