HEIGHT=16;WIDTH=201;THEME=0;OVERRIDE=false
--------------------------------------------------------------------------------------------------------------------------------------------------------------------------------------------------------
--------------------------------------------------------------------------------------------------------------------------------------------------------------------------------------------------------
--------------------------------------------------------------------------------------------------------------------------------------------------------------------------------------------------------
--------------------------------------------------------------------------------------------------------------------------------------------------------------------------------------------------------
--------------------------------------------------------------------------------------------------------------------------------------------------------------------------------------------------------
--------------------------------------------------------------------------------------------------------------------------------------------------------------------------------------------------------
--------------------------------------------------------------------------------------------------------------------------------------------------------------------------------------------------------
--------------------------------------------------------------------------------------------------------------------------------------------------------------------------------------------------------
------------------------------------------------------------------------------------------------------------------------SSSUSS--------------------------------------------------------------------------
--------------------------------------------------------------------2SCSS22-----------------------#---#-------------------------------------------------------------------------------------------------
-------------------------------------------------------------------------------------------------##---##------------------------------------------------------------------------------------------------
--------------------------------------------#---#----------------------------SCC-2S-------------###---###-----------------------------------------------------------------------------------------------
%%%%%%%%%%%%-------------------------------##---##-----#---#--------k----------------%%%---%%%%%%%%---%%%%%------------%%%%%%%%-------------------------------------------------------------------------
||||||||||||%%%%%---#---#----------------%%%%---%%%%--##---##------%%%%%%%%%----%----|||---||||||||---|||||------------||||||||-----%%---%%-------------------------------------------------------------
|||||||||||||||||--##---##-----%%%%%%%%%%||||---||||%%%%---%%%%----|||||||||-g--|----|||---||||||||---|||||%%%%%--%%%%%||||||||-----||---||%%%%%%%%F%%%%%%%%%%%%%%%%%%%%%%%%%%%%%%%%%%%%%%%%%%%%%%%%%%%%
|||||||||||||||||XXXX---XXXXXXX||||||||||||||---||||||||---||||XXXX|||||||||XXXXXXXXX|||---||||||||---||||||||||--|||||||||||||XXXXX||---||||||||||X||||||||||||||||||||||||||||||||||||||||||||||||||||
