HEIGHT=16;WIDTH=201;THEME=0;OVERRIDE=false
--------------------------------------------------------------------------------------------------------------------------------------------------------------------------------------------------------
--------------------------------------------------------------------------------------------------------------------------------------------------------------------------------------------------------
--------------------------------------------------------------------------------------------------------------------------------------------------------------------------------------------------------
--------------------------------------------------------------------------------------------------------------------------------------------------------------------------------------------------------
--------------------------------------------------------------------------------------------------------------------------------------------------------------------------------------------------------
--------------------------------------------------------------------------------------------------------------------------------------------------------------------------------------------------------
--------------------------------------------------------------------------------------------------------------------------------------------------------------------------------------------------------
--------------------------------------------------------------------------------------------------------------------------------------------------------------------------------------------------------
-----------------------------------------------------------------------------------------------------------------------------------------SCSCU----------------------------------------------------------
--------------------------------------------------------------------------------------------------------------2CSS-S------------------------------------------------------------------------------------
---------------------------------------Tt---Tt-Tt-------------------------------------------------------------------------------------------------------------------------------------------------------
---------------------------------------tt---tt-tt------------------------------------------------------------%----%-------------------------------------------------------------------------------------
------------------------------------%%%%%%%%%%%%%%-----------------------------------------------------------|----|-----------%%%---%%%%%%%%%%%%%-------------------------------------------------------
-------------------------%%%%---%%%%||||||||||||||--------%%%-------------------#--#--%%%%%--%%%%%%%%-------%%%%%%%%%---------|||---|||||||||||||%%%%%%%%F%%%%%%%%%%%%%%%%%%%%%%%%%%%%%%%%%%%%%%%%%%%%%%
%%%%%%%%%%%%%------------||||---||||||||||||||||||%%%--%%%|||%%%%%---%%%%%----%%%--%%%|||||--||||||||-------|||||||||%%%---%%%|||---|||||||||||||||||||||%||||||||||||||||||||||||||||||||||||||||||||||
|||||||||||||XXXXX--XXXXX||||---|||||||||||||||||||||--|||||||||||---|||||XXXX|||--||||||||--||||||||XX---XX||||||||||||---||||||---||||||||||||||||||||||||||||||||||||||||||||||||||||||||||||||||||||
