HEIGHT=16;WIDTH=201;THEME=0;OVERRIDE=false
--------------------------------------------------------------------------------------------------------------------------------------------------------------------------------------------------------
--------------------------------------------------------------------------------------------------------------------------------------------------------------------------------------------------------
--------------------------------------------------------------------------------------------------------------------------------------------------------------------------------------------------------
--------------------------------------------------------------------------------------------------------------------------------------------------------------------------------------------------------
--------------------------------------------------------------------------------------------------------------------------------------------------------------------------------------------------------
--------------------------------------------------------------------------------------------------------------------------------------------------------------------------------------------------------
--------------------------------------------------------------------------------------------------------------------------------------------------------------------------------------------------------
--------------------------------------------------------------------------------------------------------------------------------------------------------------------------------------------------------
--------------------------------------------------------------------------------------------------------------------------------------------------------------------------------------------------------
--------------------------------------------------------C2SSS-------------------------------------------------------------------------------------------------------------------------------------------
------------------------#---#---------------------------------------------------------------r-----------------------------------SS22SS------------------------------------------------------------------
-----------------------##---##------#--#-------------------------------------%%%----------%%%%-------------------------#--#-----------------------------------------------------------------------------
---------------------%%%%---%%%%---##--##------------------k--------%%-------|||r---------||||-----------------------%%%--%%%---------------------------------------------------------------------------
%%%%%%%%%%%%%----y---||||---||||--###--###------------%%%%%%%%--%%%%||%%%%%%%%%%%%%%%%%%%-||||-----------------------|||--|||---------------------------------------------------------------------------
|||||||||||||%%%%%%%%||||---||||%%%%%--%%%%%----------||||||||--|||||||||||||||||||||||||-|||r----------%%%%%---%%%%%|||--|||%%%%%%%%%%%%%%%%%%%F%%%%%%%%%%%%%%%%%%%%%%%%%%%%%%%%%%%%%%%%%%%%%%%%%%%%%%%
|||||||||||||||||||||||||---|||||||||--|||||XXXX--XXXX||||||||XX|||||||||||||||||||||||||XXXXXXXXXXXXXXX|||||---||||||||--||||||||||||||||||||||X|||||||||||||||||||||||||||||||||||||||||||||||||||||||
