HEIGHT=16;WIDTH=201;THEME=0;OVERRIDE=false
--------------------------------------------------------------------------------------------------------------------------------------------------------------------------------------------------------
--------------------------------------------------------------------------------------------------------------------------------------------------------------------------------------------------------
--------------------------------------------------------------------------------------------------------------------------------------------------------------------------------------------------------
--------------------------------------------------------------------------------------------------------------------------------------------------------------------------------------------------------
--------------------------------------------------------------------------------------------------------------------------------------------------------------------------------------------------------
--------------------------------------------------------------------------------------------------------------------------------------------------------------------------------------------------------
--------------------------------------------------------------------------------------------------------------------------------------------------------------------------------------------------------
--------------------------------------------------------------------------------------------------------------------------------------------------------------------------------------------------------
---------------------------------------------------------------%%%%-------------------------------------------------------------------------------------------------------------------------------------
---------------------------------------------------------------||||-----g-r-----------------------------------------------------------------------------------------------------------------------------
---------------------------------------------------------------||||---%%%%%--------------------------------------------------#---#----------------------------------------------------------------------
---------------------------------------------------------------||||---|||||------SSCUSS-------------------------------------##---##---------------------------------------------------------------------
%%%%%%%%%%%%%---------%%%%%--%%%%%-----------------------------||||---|||||------------------------------------------------###---###--------------------------------------------------------------------
|||||||||||||--tt-Tt--|||||--|||||%%---%%%%%%%--%%%%%----------||||-G-|||||---------------------------#--#---------------%%%%%---%%%%%------------------------------------------------------------------
|||||||||||||--tt-tt--|||||--|||||||---|||||||--|||||%%%%%%%%%%%%%%%%%%%%%%%%-----------%%%%---%%%%--##--##--%%%%%--%%%%%|||||---|||||%%%%%%------------------------------------------------------------
|||||||||||||XXXXXXXXX|||||--|||||||---|||||||--|||||||||||||||||||||||||||||XXXXXXXXXXX||||---||||XXXX--XXXX|||||--||||||||||---|||||||||||XXXXXXXXFXXXXXXXXXXXXXXXXXXXXXXXXXXXXXXXXXXXXXXXXXXXXXXXXXXX
