HEIGHT=16;WIDTH=201;THEME=0;OVERRIDE=false
--------------------------------------------------------------------------------------------------------------------------------------------------------------------------------------------------------
--------------------------------------------------------------------------------------------------------------------------------------------------------------------------------------------------------
--------------------------------------------------------------------------------------------------------------------------------------------------------------------------------------------------------
--------------------------------------------------------------------------------------------------------------------------------------------------------------------------------------------------------
--------------------------------------------------------------------------------------------------------------------------------------------------------------------------------------------------------
--------------------------------------------------------------------------------------------------------------------------------------------------------------------------------------------------------
--------------------------------------------------------------------------------------------------------------------------------------------------------------------------------------------------------
--------------------------------------------------------------------------------------------------------------------------------------------------------------------------------------------------------
--------------------------------------------------------------------------------------------------------------------------------------------------------------------------------------------------------
-----------------------------------#---#----------------------------------------------------------------------------------------------------------------------------------------------------------------
----------------------------------##---##---------------------------------------------------------------------------------------------------------------------------------------------------------------
---------------------------------###---###--------------------------------------------------#---#-------------------------------------------------------------------------------------------------------
%%%%%%%%%%---------------------%%%%%---%%%%%%%%--%%%%%%---%%%------------------------------##---##-------------%%%%%---%%%%%---------#--#---------------------------------------------------------------
||||||||||---------------------|||||---||||||||--||||||---|||---------------------#--#----###---###------------|||||---|||||--------##--##--------------------------------------------------------------
||||||||||------------%%%%%----|||||---||||||||--||||||---|||%%--%%-------------%%%--%%%%%%%%---%%%%%%%%%--%%%%|||||---|||||------%%%%--%%%%------------------------------------------------------------
||||||||||XXXXX--XXXXX|||||XXXX|||||---||||||||--||||||---|||||--||XXXXX---XXXXX|||--||||||||---|||||||||--|||||||||---|||||XX--XX||||--||||XXXXXXXXFXXXXXXXXXXXXXXXXXXXXXXXXXXXXXXXXXXXXXXXXXXXXXXXXXXX
