HEIGHT=16;WIDTH=201;THEME=0;OVERRIDE=false
--------------------------------------------------------------------------------------------------------------------------------------------------------------------------------------------------------
--------------------------------------------------------------------------------------------------------------------------------------------------------------------------------------------------------
--------------------------------------------------------------------------------------------------------------------------------------------------------------------------------------------------------
--------------------------------------------------------------------------------------------------------------------------------------------------------------------------------------------------------
--------------------------------------------------------------------------------------------------------------------------------------------------------------------------------------------------------
--------------------------------------------------------------------------------------------------------------------------------------------------------------------------------------------------------
--------------------------------------------------------------------------------------------------------------------------------------------------------------------------------------------------------
--------------------------------------------------------------------------------------------------------------------------------------------------------------------------------------------------------
--------------------------------------------------------------------------------------------------------------------------------------------------------------------------------------------------------
-----------------------------------------------S-CS-----------------------------------------------------------------------------------------------------------------------------------------------------
-------------------------------------------------------------------CS2SCS-------------------------------------------------------------------------------------------------------------------------------
--------------------------#---#-----------------%-------------------------------------------------------------------------------------------------------------------------------------------------------
------------------------%%%---%%%------------yr-|--------------------------------------------------------------------------------------------%%%%%%%%F%%%%%%%%%%%%%%%%%%%%%%%%%%%%%%%%%%%%%%%%%%%%%%%%%%
%%%%%%%%%%%%%%%%%%%%--%%|||---|||%%%%--%%%%%%%%%%%%%------------------y----%%--%%----------%%%%%%%%---%%-------------------#---#---%%%%--%%%%||||||||%||||||||||||||||||||||||||||||||||||||||||||||||||
||||||||||||||||||||--|||||---|||||||--|||||||||||||--------%%%%%%%%%%%%%%%||--||----------||||||||---||%%--%%%%%%--%%%%--##---##--||||--|||||||||||||||||||||||||||||||||||||||||||||||||||||||||||||||
||||||||||||||||||||--|||||---|||||||--|||||||||||||XXX--XXX|||||||||||||||||--||XXXX--XXXX||||||||---||||--||||||--||||XXXX---XXXX||||--|||||||||||||||||||||||||||||||||||||||||||||||||||||||||||||||
