HEIGHT=16;WIDTH=201;THEME=0;OVERRIDE=false
--------------------------------------------------------------------------------------------------------------------------------------------------------------------------------------------------------
--------------------------------------------------------------------------------------------------------------------------------------------------------------------------------------------------------
--------------------------------------------------------------------------------------------------------------------------------------------------------------------------------------------------------
--------------------------------------------------------------------------------------------------------------------------------------------------------------------------------------------------------
--------------------------------------------------------------------------------------------------------------------------------------------------------------------------------------------------------
--------------------------------------------------------------------------------------------------------------------------------------------------------------------------------------------------------
-----------------------------------------S2S------------------------------------------------------------------------------------------------------------------------------------------------------------
--------------------------------------------------------------------------------------------------------------------------------------------------------------------------------------------------------
--------------------------------------------------------------------------------------------------------------------------------------------------------------------------------------------------------
-----------tt----tt----------------------yr---------------------------------------------Gy--------------------------------------------------------------------------------------------------------------
-----------tt----tt-------------#---#----%%%%%%---------------------------------------%%%%%-------------------------------------------------------------------------------------------------------------
-----------tt----tt------------##---##---||||||-----------------tt--------------------|||||------------------tt-------tt--------------------------------------------------------------------------------
----------%%%%%%%%%%%%%------%%%%---%%%%-||||||-----------------tt--------#---#-------|||||------------------tt----Tt-tt---------%%%--%%%---------------------------------------------------------------
%%%%%%%%%%|||||||||||||------||||---||||-k|||||-k--k---------%%%%%%%%%%--##---##--%%%%%%%%%%%%%--------------tt----tt-tt--y------|||--|||---------------------------------------------------------------
|||||||||||||||||||||||%%--%%||||---||||%%%%%%%%%%%%%--------||||||||||%%%%---%%%%|||||||||||||%%%%%--%%%%%%%%%%%%%%%%%%%%%%%%%%%|||--|||%%%%%%%%F%%%%%%%%%%%%%%%%%%%%%%%%%%%%%%%%%%%%%%%%%%%%%%%%%%%%%%
|||||||||||||||||||||||||--||||||---|||||||||||||||||XXX--XXX||||||||||||||---||||||||||||||||||||||--||||||||||||||||||||||||||||||--|||||||||||X||||||||||||||||||||||||||||||||||||||||||||||||||||||
