HEIGHT=16;WIDTH=201;THEME=0;OVERRIDE=false
--------------------------------------------------------------------------------------------------------------------------------------------------------------------------------------------------------
--------------------------------------------------------------------------------------------------------------------------------------------------------------------------------------------------------
--------------------------------------------------------------------------------------------------------------------------------------------------------------------------------------------------------
--------------------------------------------------------------------------------------------------------------------------------------------------------------------------------------------------------
--------------------------------------------------------------------------------------------------------------------------------------------------------------------------------------------------------
------------------------------------------------------------------------------------------------------------------------------SSSCS---------------------------------------------------------------------
--------------------------------------------------------------------------------------------------------------------------------------------------------------------------------------------------------
--------------------------------------------------------------------------------------------------------------------------------------------------------------------------------------------------------
-------------------------------------------------------------------------------------------------------------------%%%%------------y--------------------------------------------------------------------
-------------------------------------------------------------------------------------------------------------------||||-------%%%%%%--------------------------------------------------------------------
-------------------------------------------------------------------------------------------------------------------||||-------||||||--------------------------------------------------------------------
-----------------------UCUU------#--#------------------------------------------------------------------------------||||-------||||||--------------------------------------------------------------------
--------------------------------##--##-------------------------#--#--------------------------%%--%%%%%%---%%%%%%%%%%%%%%%--r--||||||--r-----------------------------------------------------------------
%%%%%%%%%%%--------------------###--###-----------------------##--##-------------------%%%%%%||--||||||---|||||||||||||||%%%%%%%%%%%%%%%%%%%------------------------------------------------------------
|||||||||||------------k-----%%%%%--%%%%%--------------------###--###--%%---%%--#---#--||||||||--||||||---||||||||||||||||||||||||||||||||||------------------------------------------------------------
|||||||||||XXXXXXXXXXXXXXXXXX|||||--|||||XXXX---XXXXXX---XXXXXXX--XXXXX||---||XXX---XXX||||||||--||||||---||||||||||||||||||||||||||||||||||XXXXXXXXFXXXXXXXXXXXXXXXXXXXXXXXXXXXXXXXXXXXXXXXXXXXXXXXXXXX
