HEIGHT=16;WIDTH=201;THEME=0;OVERRIDE=false
--------------------------------------------------------------------------------------------------------------------------------------------------------------------------------------------------------
--------------------------------------------------------------------------------------------------------------------------------------------------------------------------------------------------------
--------------------------------------------------------------------------------------------------------------------------------------------------------------------------------------------------------
--------------------------------------------------------------------------------------------------------------------------------------------------------------------------------------------------------
--------------------------------------------------------------------------------------------------------------------------------------------------------------------------------------------------------
--------------------------------------------------------------------------------------------------------------------------------------------------------------------------------------------------------
--------------------------------------------------------------------------------------------------------------------------------------------------------------------------------------------------------
-------------------------------r------------------------------------------------------------------------------------------------------------------------------------------------------------------------
-------------------------%%%%%%%-----------------SSCSC--------------U-SU----------------------------------SUSSS-----------------------------------------------------------------------------------------
-------------------------|||||||k-----------------------------------------------------------------------------------------------------------------------------------------------------------------------
---------------C2SCSS2---||||||%%%--------------------------SUCS---|-%----------------------------------------------------------------------------------------------------------------------------------
-------------------------|||||||||-----------------y---------------y-|-kg-------------------------------------------------------------------------------------------------------------------------------
%%%%%%%%%%%%%------------|||||||||------------%%%%%%%%%%%----------%%%%%%-------------------------------%%%%%%%%%%%%--%%%%%%%%--%%%%%%--%%--------------------------------------------------------------
|||||||||||||------------||||||g||------------|||||||||||----------||||||---------------------%%--------||||||||||||--||||||||--||||||--||%%%%%%%%F%%%%%%%%%%%%%%%%%%%%%%%%%%%%%%%%%%%%%%%%%%%%%%%%%%%%%
|||||||||||||%%%%%%%%%%%%%%%%%%%%%%%%---------|||||||||||%%%%%%%%--||||||---------------------||%%%--%%%||||||||||||--||||||||--||||||--||||||||||%|||||||||||||||||||||||||||||||||||||||||||||||||||||
|||||||||||||||||||||||||||||||||||||XXX---XXX|||||||||||||||||||XXXXXXXXXXXXX--XXXXXXX---XXXX|||||--|||||||||||||||--||||||||--||||||--||||||||||||||||||||||||||||||||||||||||||||||||||||||||||||||||
