HEIGHT=16;WIDTH=201;THEME=0;OVERRIDE=false
--------------------------------------------------------------------------------------------------------------------------------------------------------------------------------------------------------
--------------------------------------------------------------------------------------------------------------------------------------------------------------------------------------------------------
--------------------------------------------------------------------------------------------------------------------------------------------------------------------------------------------------------
--------------------------------------------------------------------------------------------------------------------------------------------------------------------------------------------------------
--------------------------------------------------------------------------------------------------------------------------------------------------------------------------------------------------------
--------------------------------------------------------------------------------------------------------------------------------------------------------------------------------------------------------
--------------------------------------------------------------------------------------------------------------------------------------------------------------------------------------------------------
--------------------------------------------------------------------------------------------------------------------------------------------------------------------------------------------------------
--------------------------------------------------------------------------------------------------------------------------------------------------------------------------------------------------------
----------------------------------------------------------------------#---#-----------------------------SSS---------------------------------------------------------------------------------------------
-------------------------------SSS-----------------------------------##---##----------------CSSC2U-------------------------------------Tt---------------------------------------------------------------
------------------#---#---------------------------------------------###---###------------------------------------------------------Tt--tt---------------------------------------------------------------
-----------------##---##----------|---%%--%%----------------------%%%%%---%%%%%------%%%%-------------k----------------------------tt--tt---------------------------------------------------------------
%%%%%%%%%%%%%%--###---###---------k---||--||----------------------|||||---|||||------||||-----k-----%%%%%%%%------------#---#---%%%%%%%%%%%%%%%%%%%%F%%%%%%%%%%%%%%%%%%%%%%%%%%%%%%%%%%%%%%%%%%%%%%%%%%%
||||||||||||||%%%%%---%%%%%%%%%%%%%%%%||--||---------%%%%%---%%%%%|||||---|||||%%--%%||||%%%%%%%%%%%||||||||-----------##---##--||||||||||||||||||||%|||||||||||||||||||||||||||||||||||||||||||||||||||
|||||||||||||||||||---||||||||||||||||||--||XXX---XXX|||||---||||||||||---|||||||--|||||||||||||||||||||||||XXX---XXXXXXX---XXXX||||||||||||||||||||||||||||||||||||||||||||||||||||||||||||||||||||||||
