HEIGHT=16;WIDTH=201;THEME=0;OVERRIDE=false
--------------------------------------------------------------------------------------------------------------------------------------------------------------------------------------------------------
--------------------------------------------------------------------------------------------------------------------------------------------------------------------------------------------------------
--------------------------------------------------------------------------------------------------------------------------------------------------------------------------------------------------------
--------------------------------------------------------------------------------------------------------------------------------------------------------------------------------------------------------
--------------------------------------------------------------------------------------------------------------------------------------------------------------------------------------------------------
--------------------------------------------------------------------------------------------------------------------------------------------------------------------------------------------------------
--------------------------------------------------------------------------------------------------------------------------------------------------------------------------------------------------------
--------------------------------------------------------------------------------------------------------------------------------------------------------------------------------------------------------
--------------------------------------------------------------------------------------------------------------------------------------------------------------------------------------------------------
--------------------------------------------------------------------------------------------------------------------------------------------------------------------------------------------------------
------------------------------------------------------------------------------USUU----------------------------------------------------------------------------------------------------------------------
-------------#---#------#--#---------------------------------Tt-----------------------------------------------------------------------------------------------------------------------------------------
-----------%%%---%%%---##--##-------------------%%%%--%%%%%%-tt---tt---tt----------------------------%%%%---%%%%%%%%%%%---------------------------------------------------------------------------------
%%%%%%%%%%%|||---|||--###--###------%%%%%--%%%%%||||--||||||-tt---tt---tt--y---------%%--%%----------||||---|||||||||||-------%%%----%%%%%%%%-----------------------------------------------------------
||||||||||||||---|||%%%%%--%%%%%----|||||--|||||||||--||||||%%%%%%%%%%%%%%%%%%%%%%%%%||--||%%%--%%%--||||---|||||||||||-------|||----||||||||%%%%%%%%F%%%%%%%%%%%%%%%%%%%%%%%%%%%%%%%%%%%%%%%%%%%%%%%%%%
||||||||||||||---||||||||--|||||XXXX|||||--|||||||||XX|||||||||||||||||||||||||||||||||--|||||--|||XX||||---|||||||||||XXXXXXXXXXXXXX||||||||||||||||X||||||||||||||||||||||||||||||||||||||||||||||||||
