HEIGHT=16;WIDTH=201;THEME=0;OVERRIDE=false
--------------------------------------------------------------------------------------------------------------------------------------------------------------------------------------------------------
--------------------------------------------------------------------------------------------------------------------------------------------------------------------------------------------------------
--------------------------------------------------------------------------------------------------------------------------------------------------------------------------------------------------------
--------------------------------------------------------------------------------------------------------------------------------------------------------------------------------------------------------
--------------------------------------------------------------------------------------------------------------------------------------------------------------------------------------------------------
--------------------------------------------------------------------------------------------------------------------------------------------------------------------------------------------------------
--------------------------------------------------------------------------------------------------------------------------------------------------------------------------------------------------------
--------------------------------------------------------------------------------------------------------------------------------------------------------------------------------------------------------
---------------------------------------------------------------------------------------------------------------g--g-k-----------------------------------------------------------------------------------
---------------SSU---------------------------------k----------------------------------------------------------%%%%%%%-----------------------------------------------------------------------------------
----------------------------------------------%%%%%%----------------------------------------------------------|||||||-----------------------------------------------------------------------------------
---------------------------y-gk---------------||||||-g---------------------------------------------------y----|y|||||-----------------------------------------------------------------------------------
--------------------------%%%%%%---#---#---%%%%%%%%%%%%-------------------------------------------------%%%%%%%%%%%%%%%%------%%%%%%----------%%%%%%%%F%%%%%%%%%%%%%%%%%%%%%%%%%%%%%%%%%%%%%%%%%%%%%%%%%
-------------%%%%%%%------||||||--##---##--||||||||||||%%%%%---%%%%%%%%%---%%%%------------%%%%%---%%%%%||||||||||||||||------||||||---#--#---||||||||%|||||||||||||||||||||||||||||||||||||||||||||||||
%%%%%%%%%%%%%|||||||%%%%%%||||||%%%%---%%%%|||||||||||||||||---|||||||||---||||%%%%%--%%%%%|||||---|||||||||||||||||||||------||||||--##--##--||||||||||||||||||||||||||||||||||||||||||||||||||||||||||
||||||||||||||||||||||||||||||||||||---|||||||||||||||||||||---|||||||||---|||||||||--||||||||||---|||||||||||||||||||||XX--XX||||||XXXX--XXXX||||||||||||||||||||||||||||||||||||||||||||||||||||||||||
