HEIGHT=16;WIDTH=201;THEME=0;OVERRIDE=false
--------------------------------------------------------------------------------------------------------------------------------------------------------------------------------------------------------
--------------------------------------------------------------------------------------------------------------------------------------------------------------------------------------------------------
--------------------------------------------------------------------------------------------------------------------------------------------------------------------------------------------------------
--------------------------------------------------------------------------------------------------------------------------------------------------------------------------------------------------------
--------------------------------------------------------------------------------------------------------------------------------------------------g-----------------------------------------------------
------------------------------------------------------------------------------------------------------------------------------------------------%%%%----------------------------------------------------
------------------------------------------------------------------------------------------------------------------------------------------------||||----------------------------------------------------
------------------------------------------------------------------------------------------------------------------------------------------------||||----------------------------------------------------
---------------%%%%%%-------------------------------------------------------------------------------------------------------------------------%%%%%|----------------------------------------------------
---------------||y|||--------------------------------------------------------------------------------------------#--#-------------------------||||||----------------------------------------------------
-------------%%%%%%||-------------------------------------------------------------------------------------------##--##------------------------||||||----------------------------------------------------
-------------||||||||--------------------#---#---y------------------------------------------tt-----------------###--###-----------------------|k||k|----------------------------------------------------
------------%%%%%%%%%%%%%%------%%---%%%%%---%%%-%%%%---------%%%%%---%%%%%%%--%%-----------tt---------------%%%%%--%%%%%%%%%%--%%%%%%%%%%%%%%%%%%%%%%%%------------------------------------------------
------------||||||||||||||------||---|||||---|||-||||---------|||||---|||||||--||%%---%%----tt------%%%%%%%%%|||||--||||||||||--||||||||||||||||||||||||%%%%%%%%F%%%%%%%%%%%%%%%%%%%%%%%%%%%%%%%%%%%%%%%
%%%%%%%%%%%%||||||||||||||%%--%%||---|||||---|||-||||------y--|||||---|||||||--||||---||%%%%%%%%%%--||||||||||||||--||||||||||--||||||||||||||||||||||||||||||||%|||||||||||||||||||||||||||||||||||||||
||||||||||||||||||||||||||||--||||---|||||---|||XXXXXXXXXXXXXX|||||---|||||||--||||---||||||||||||XX||||||||||||||--||||||||||--||||||||||||||||||||||||||||||||||||||||||||||||||||||||||||||||||||||||
