HEIGHT=16;WIDTH=201;THEME=0;OVERRIDE=false
--------------------------------------------------------------------------------------------------------------------------------------------------------------------------------------------------------
--------------------------------------------------------------------------------------------------------------------------------------------------------------------------------------------------------
--------------------------------------------------------------------------------------------------------------------------------------------------------------------------------------------------------
--------------------------------------------------------------------------------------------------------------------------------------------------------------------------------------------------------
--------------------------------------------------------------------------------------------------------------------------------------------------------------------------------------------------------
--------------------------------------------------------------------------------------------------------------------------------------------------------------------------------------------------------
--------------------------------------------------------------------------------------------------------------------------------------------------------------------------------------------------------
-----------------------------------------------------------------g--------------------------------------------------------------------------------------------------------------------------------------
-----------------------------------------------------------------%%%%%%---------------------------------------------------------------------------------------------------------------------------------
-----------------------------------------------------------------||||||--------------------SSSS--------%%%%%--------------------------------------------------------------------------------------------
-------------------------------------------r---k-----------------||||||--------------------------------|||||--------------------------------------------------------------------------------------------
-------------------------------------------%%%%%%----------------|||k||------------------------%-------|||||--------------------------------------------------------------------------------------------
-----------------%%%%%%--------------------||||||---r---------%%%%%%%%%%%%%%%%%---#---#----r---|-------|||||---%%---%%----------------#---#-------------------------------------------------------------
-----------------||||||-------------------%%%%%%%%%%%%%-------|||||||||||||||||--##---##--%%%%%%%%%%%%%%%%%%%%%||---||%%%%%--%%%%%---##---##---%%%%%%%%F%%%%%%%%%%%%%%%%%%%%%%%%%%%%%%%%%%%%%%%%%%%%%%%%
%%%%%%%%%%%------||||g|---%%%%%-----------|||||||||||||%%---%%|||||||||||||||||%%%%---%%%%|||||||||||||||||||||||---|||||||--|||||--###---###--||||||||%||||||||||||||||||||||||||||||||||||||||||||||||
|||||||||||XXXXXXXXXXXXXXX|||||XXXXXXXXXXX|||||||||||||||---|||||||||||||||||||||||---|||||||||||||||||||||||||||---|||||||--|||||XXXXX---XXXXX|||||||||||||||||||||||||||||||||||||||||||||||||||||||||
