HEIGHT=16;WIDTH=201;THEME=0;OVERRIDE=false
--------------------------------------------------------------------------------------------------------------------------------------------------------------------------------------------------------
--------------------------------------------------------------------------------------------------------------------------------------------------------------------------------------------------------
--------------------------------------------------------------------------------------------------------------------------------------------------------------------------------------------------------
--------------------------------------------------------------------------------------------------------------------------------------------------------------------------------------------------------
--------------------------------------------------------------------------------------------------------------------------------------------------------------------------------------------------------
--------------------------------------------------------------------------------------------------------------------------------------------------------------------------------------------------------
--------------------------------------------------------------------------------------------------------------------------------------------------------------------------------------------------------
--------------------------------------------------------------------------------------------------------------------------------------------------------------------------------------------------------
--------------------------------------------------------------------------------------------------------------------------------------------------------------------------------------------------------
--------------------------------------------------------------------tt----------------------------------------------------------------------------------------------------------------------------------
-----------------------------#--#-----------------------------------tt----------------------------------------------------------------------------------------------------------------------------------
----------------------------##--##----------------------------------tt----------------------------------#--#--------------------------------------------------------------------------------------------
---------------------------###--###-----%%%------------------------%%%%%---------------------#---#----%%%--%%%-------------------------%%%%%--%%%%%%%%%%%%%F%%%%%%%%%%%%%%%%%%%%%%%%%%%%%%%%%%%%%%%%%%%%
%%%%%%%%%%%%%%%%%%-------%%%%%--%%%%%%%%|||---------------r--------|||||--------------------##---##---|||--|||%%--%%-------------------|||||--|||||||||||||%||||||||||||||||||||||||||||||||||||||||||||
||||||||||||||||||%%---%%|||||--|||||||||||%%%%---%%%%%%%%%%%%%%%%%|||||%%%%%---%%%%%%%%%--###---###--|||--|||||--||%%%%%--%%%%%%%---%%|||||--||||||||||||||||||||||||||||||||||||||||||||||||||||||||||
||||||||||||||||||||---|||||||--|||||||||||||||---|||||||||||||||||||||||||||---|||||||||XXXXX---XXXXX|||--|||||--|||||||--|||||||---|||||||--||||||||||||||||||||||||||||||||||||||||||||||||||||||||||
