HEIGHT=16;WIDTH=201;THEME=0;OVERRIDE=false
--------------------------------------------------------------------------------------------------------------------------------------------------------------------------------------------------------
--------------------------------------------------------------------------------------------------------------------------------------------------------------------------------------------------------
--------------------------------------------------------------------------------------------------------------------------------------------------------------------------------------------------------
--------------------------------------------------------------------------------------------------------------------------------------------------------------------------------------------------------
--------------------------------------------------------------------------------------------------------------------------------------------------------------------------------------------------------
--------------------------------------------------------------------------------------------------------------------------------------------------------------------------------------------------------
--------------------------------------------------------------------------------------------------------------------------------------------------------------------------------------------------------
--------------------------------------------------------------------------------------------------------------------------------------------------------------------------------------------------------
--------------------------------------------------------------------------------------------------------------------------------------------------------------------------------------------------------
--------------------------------------------------------------------------------------------------------------------------------------------------------------------------------------------------------
-------------------------------------------------------------------------------------------------------------------%%%%---------------SSSS2-------------------------------------------------------------
---------------------------------------------#--#-------------------------------------------------------------y---g||||---------------------------------------------------------------------------------
--------------------------------------------##--##---%%%%%--%%%%%---------------------------------%%%-----%%%%%%%%%%%%%%%%%-----------------%%%%%%%%F%%%%%%%%%%%%%%%%%%%%%%%%%%%%%%%%%%%%%%%%%%%%%%%%%%%
------------------------%%%%%--%%%%%-------###--###--|||||--|||||%%%%-----------------------------|||---%%|||||||||||||||||----------kg-----||||||||%|||||||||||||||||||||||||||||||||||||||||||||||||||
------------------------|||||--|||||%%%%%%%%%%--%%%%%|||||--|||||||||---------------#--#-------r--|||-g-|||||||||||||||||||--------%%%%%%%%%||||||||||||||||||||||||||||||||||||||||||||||||||||||||||||
XXXXXXXXXXXXXXXX---XXXXX|||||--|||||||||||||||--||||||||||--|||||||||XXXXX---XXXXXXXX--XXXXXXXXXXXXXXXXX|||||||||||||||||||XXX--XXX|||||||||||||||||||||||||||||||||||||||||||||||||||||||||||||||||||||
