HEIGHT=16;WIDTH=201;THEME=0;OVERRIDE=false
--------------------------------------------------------------------------------------------------------------------------------------------------------------------------------------------------------
--------------------------------------------------------------------------------------------------------------------------------------------------------------------------------------------------------
--------------------------------------------------------------------------------------------------------------------------------------------------------------------------------------------------------
--------------------------------------------------------------------------------------------------------------------------------------------------------------------------------------------------------
--------------------------------------------------------------------------------------------------------------------------------------------------------------------------------------------------------
--------------------------------------------------------------------------------------------------------------------------------------------------------------------------------------------------------
--------------------------------------------------------------------------------------------------------------------------------------------------------------------------------------------------------
--------------------------------------------------------------------------------------------------------------------------------------------------------------------------------------------------------
--------------------------------------------------------------------------------------------------------------------------------------------------------------------------------------------------------
--------------------------------------------------------------------------------------------------------------------------------------------------------------------------------------------------------
-----------------------------------------------------------------------------------------------------#--#-----------------------------------------------------------------------------------------------
----------------------------------------------------------------------------------------#---#-------##--##----------------------------------------------------------------------------------------------
----------------Tt---tt-------------%%%%%%%%%%--%%%---------%%%%--%%%%%%--%%-----------##---##-----###--###---------------------------------------------------------------------------------------------
----------------tt---tt-------------||||||||||--|||%%--%%---||||--||||||--||----------###---###--%%%%%--%%%%%%%%%--%%%%-----------------%%%%%%%%F%%%%%%%%%%%%%%%%%%%%%%%%%%%%%%%%%%%%%%%%%%%%%%%%%%%%%%%
%%%%%%%%%%%%%%--tt---tt---%%%%--%%%%||||||||||--|||||--||---||||--||||||--||--#--#--%%%%%---%%%%%|||||--|||||||||--||||%%%%---%%%%%%%%%%||||||||%|||||||||||||||||||||||||||||||||||||||||||||||||||||||
||||||||||||||XXXXXXXXXXXX||||--||||||||||||||--|||||--||XXX||||--||||||--||XXX--XXX|||||---||||||||||--|||||||||--||||||||---||||||||||||||||||||||||||||||||||||||||||||||||||||||||||||||||||||||||||
