HEIGHT=16;WIDTH=201;THEME=0;OVERRIDE=false
--------------------------------------------------------------------------------------------------------------------------------------------------------------------------------------------------------
--------------------------------------------------------------------------------------------------------------------------------------------------------------------------------------------------------
--------------------------------------------------------------------------------------------------------------------------------------------------------------------------------------------------------
--------------------------------------------------------------------------------------------------------------------------------------------------------------------------------------------------------
--------------------------------------------------------------------------------------------------------------------------------------------------------------------------------------------------------
--------------------------------------------------------------------------------------------------------------------------------------------------------------------------------------------------------
--------------------------------------------------------------------------------------------------------------------------------------------------------------------------------------------------------
----------------------------------------------CUSC------------------------------------------------------------------------------------------------------------------------------------------------------
-----------------------------------------------------------------------------------------------------------------------------------%%%%%%%--------------------------------------------------------------
-----------------------------------------------------------------------------------------------------------------------------------|||||||--------------------------------------------------------------
---------------------------------------------y-------------------------------------------------------------------------------------|||||||--------------------------------------------------------------
--------------------------SSSSC--------------%%%%%%%-------------------------------------------------------------------------------||||g||---y----------------------------------------------------------
-------------%%%%---%%%%---------------------|||||||------------------------------------%%%%%---%%%%%-----------------------------%%%%%%%%%%%%%%--------------------------------------------------------
-------------||||---||||---------%%%%%------y|||||||------------------------------------|||||---|||||-----------------------------||||||||||||||--------------------------------------------------------
-------------||||---||||----k----|||||%%%%%%%%%%%%%%%%%---------------------%%%--%%%----|||||---|||||%%---%%%%%%%%%-------%%%--%%%||||||||||||||%%%%%%%%F%%%%%%%%%%%%%%%%%%%%%%%%%%%%%%%%%%%%%%%%%%%%%%%
XXXXXXXXXXXXX||||---||||XXXXXXXXX||||||||||||||||||||||XXXX--XXXXXXXX---XXXX|||--|||XXXX|||||---|||||||---|||||||||XX---XX|||--|||||||||||||||||||||||||X|||||||||||||||||||||||||||||||||||||||||||||||
