HEIGHT=16;WIDTH=201;THEME=0;OVERRIDE=false
--------------------------------------------------------------------------------------------------------------------------------------------------------------------------------------------------------
--------------------------------------------------------------------------------------------------------------------------------------------------------------------------------------------------------
--------------------------------------------------------------------------------------------------------------------------------------------------------------------------------------------------------
------------------------------------------------------SCCC----------------------------------------------------------------------------------------------------------------------------------------------
--------------------------------------------------------------------------------------------------------------------------------------------------------------------------------------------------------
--------------------------------------------------------------------------------------------------------------------------------------------------------------------------------------------------------
-------------------------------------------------------r----k-------------------------------------------------------------------------------------------------------------------------------------------
------------------------------------------------------%%%%%%%-------------------------------------------------------------------------------------------------------------------------------------------
------------------------------------------------------|||||||-----------------------------------------y-------SUSSS-------------------------------------------------------------------------------------
-------------------------------------%%%%%------------||||%%%%%--------------------------------------%%%%-----------------------------------------------------------------------------------------------
-------------------------------------|||||------------|||||||||--------------------------------------||||-----------------------------------------------------------------------------------------------
-------------------------------------|||||------------|||||||||--y--------------------Tt--tt---------||||-----------------------------------------------------------------------------------------------
------------------------%%%%%--%%%%%-|||||-----------%%%%%%%%%%%%%%%%%---%%%----------tt--tt-----%%%%%|||----%%%%%%%--tt---tt------%%%%---%%%%%%%%%%%%F%%%%%%%%%%%%%%%%%%%%%%%%%%%%%%%%%%%%%%%%%%%%%%%%%
------------------------|||||--|||||-|%%%|----%%---%%|||||||||||||||||---|||%%%%%%%%%%%%%%%%%%%%-|||y|r||-rr-|||||||--tt---tt------||||---||||||||||||%|||||||||||||||||||||||||||||||||||||||||||||||||
-------------%%%%---%%%%|||||--|||||-|||r|----||---|||||||||||||||||||---|||||||||||||||||||||||%%%%%%%%%%%%%|||||||%%%%%%%%%%%%%%%||||---||||||||||||||||||||||||||||||||||||||||||||||||||||||||||||||
XXXXXXXXXXXXX||||---|||||||||--|||||XXXXXXXXXX||---|||||||||||||||||||---||||||||||||||||||||||||||||||||||||||||||||||||||||||||||||||---||||||||||||||||||||||||||||||||||||||||||||||||||||||||||||||
