HEIGHT=16;WIDTH=201;THEME=0;OVERRIDE=false
--------------------------------------------------------------------------------------------------------------------------------------------------------------------------------------------------------
--------------------------------------------------------------------------------------------------------------------------------------------------------------------------------------------------------
--------------------------------------------------------------------------------------------------------------------------------------------------------------------------------------------------------
--------------------------------------------------------------------------------------------------------------------------------------------------------------------------------------------------------
--------------------------------------------------------------------------------------------------------------------------------------------------------------------------------------------------------
--------------------------------------------------------------------------------------------------------------%%%---------------------------------------------------------------------------------------
--------------------------------------------------------------------------------------------------------------|||---------------------------------------------------------------------------------------
--------------------------------------------------------------------------------------------------------------|||---------------------------------------------------------------------------------------
----------------------------------------------------------------------------------------------------------k-r-|||---------------------------------------------------------------------------------------
--------------------------------------------------------------------------------------------------------%%%%%%%||---------------------------------------------------------------------------------------
--------------------------------------------------------------------------------------Tt----------------|||||||||---------tt----------------------------------------------------------------------------
-----------------------------------------------------------------------------------Tt-tt---------2USSS--|||||||||------tt-tt----------------------------------------------------------------------------
-------------%%%---%%%-----------y--g-----#---#-------#--#---------------%%%%%%----tt-tt----------------||||k||||------tt-tt---------%%%--%%%-----------------------------------------------------------
%%%%%%%%%%%%%|||---|||---------%%%%%%%%--##---##-----##--##--------------||||||%%%%%%%%%%%%%%----------%%%%%%%%%%%%%%%%%%%%%%%----y--|||--|||%%%%%%%%F%%%%%%%%%%%%%%%%%%%%%%%%%%%%%%%%%%%%%%%%%%%%%%%%%%
||||||||||||||||---|||%%%---%%%||||||||%%%%---%%%%--###--###-------------||||||||||||||||||||---g------|||||||||||||||||||||||%%%%%%%|||--|||||||||||%||||||||||||||||||||||||||||||||||||||||||||||||||
||||||||||||||||---||||||---|||||||||||||||---||||XXXXX--XXXXXXXXX---XXXX||||||||||||||||||||XXXXXXXXXX|||||||||||||||||||||||||||||||||--||||||||||||||||||||||||||||||||||||||||||||||||||||||||||||||
