HEIGHT=16;WIDTH=201;THEME=0;OVERRIDE=false
--------------------------------------------------------------------------------------------------------------------------------------------------------------------------------------------------------
--------------------------------------------------------------------------------------------------------------------------------------------------------------------------------------------------------
--------------------------------------------------------------------------------------------------------------------------------------------------------------------------------------------------------
--------------------------------------------------------------------------------------------------------------------------------------------------------------------------------------------------------
--------------------------------------------------------------------------------------------------------------------------------------------------------------------------------------------------------
--------------------------------------------------------------------------------------------------------------------------------------------------------------------------------------------------------
--------------------------------------------------------------------------------------------------------------------------------------------------------------------------------------------------------
--------------------------------------------------------------------------------------------------------------------------------------------------------------------------------------------------------
------------------------------------------------------SSSSCCSS------------------------------------------------------------------------------------------------------------------------------------------
------------------------------------------------------------------------------#--#----------------------------------------------------------------------------------------------------------------------
-----------------------------------------------------------------------------##--##------------------------------------S-S------------------------------------------------------------------------------
--------------------%%%%%----------------------------y-----y-g--SCSSC2------###--###-----------------------#---#----------------------------------------------------------------------------------------
%%%%%%%%%%%%%%------|||||------%%%%%%%--------------%%%%%%%%%%%-----------%%%%%--%%%%%--------------------##---##-------%-|-----------------------------------------------------------------------------
||||||||||||||%%%%%%%%%%%%%%%%%|||||||-------%%---%%|||||||||||-----------|||||--|||||%%---%%-----------%%%%---%%%%-----|-y-r---------------------------------------------------------------------------
||||||||||||||||||||||||||||||||||||||%%---%%||---|||||||||||||---g---r---|||||--|||||||---||%%%%---%%%%||||---||||%%%%%%%%%%%%%%---%%%-----------------------------------------------------------------
||||||||||||||||||||||||||||||||||||||||---||||---|||||||||||||XXXXXXXXXXX|||||--|||||||---||||||---||||||||---||||||||||||||||||---|||XX---XXXXXXXXXXFXXXXXXXXXXXXXXXXXXXXXXXXXXXXXXXXXXXXXXXXXXXXXXXXX
