HEIGHT=16;WIDTH=201;THEME=0;OVERRIDE=false
--------------------------------------------------------------------------------------------------------------------------------------------------------------------------------------------------------
--------------------------------------------------------------------------------------------------------------------------------------------------------------------------------------------------------
--------------------------------------------------------------------------------------------------------------------------------------------------------------------------------------------------------
--------------------------------------------------------------------------------------------------------------------------------------------------------------------------------------------------------
--------------------------------------------------------------------------------------------------------------------------------------------------------------------------------------------------------
--------------------------------------------------------------------------------------------------------------------------------------------------------------------------------------------------------
---------------------------------------------------%%%%%%-----------------------------------------------------------------------------------------------------------------------------------------------
---------------------------------------------------||||||-----------------------------------------------------------------------------------------------------------------------------------------------
-------------------------------------CS2-----------||||||-----------------------------------------------------------------------------------------------------------------------------------------------
-------------------------------------------------%%%%%%||-----------------------------------------------------------------------------------------------------------------------------------------------
-------------------------#---#-------------------||||||||----------------------------------------------------------------------Y------------------------------------------------------------------------
------------------------##---##---r-y-r----------|||kg|||--------------------------------------------------------------------%%%%-----------------------------------------------------------------------
--------------%%%--%%%%%%%---%%%%%%%%%%%%%-----%%%%%%%%%%%%------------------------------------------------------------------||||-----------------------------------------------------------------------
--------------|||--|||||||---|||||||||||||%%%%%||||||||||||-----------------%%%%%%%%%%------------------%%%%%%%--------------||||--%%%--%%%%%%%%F%%%%%%%%%%%%%%%%%%%%%%%%%%%%%%%%%%%%%%%%%%%%%%%%%%%%%%%
%%%%%%%%%%%%%%|||--|||||||---||||||||||||||||||||||||||||||-------%%%%--%%%%||||||||||----------%%%--%%%|||||||--------------||||--||y--||||||||%|||||||||||||||||||||||||||||||||||||||||||||||||||||||
|||||||||||||||||--|||||||---||||||||||||||||||||||||||||||XX---XX||||--||||||||||||||XXXX--XXXX|||--||||||||||XXX--XXXXXXXXXXXXXXXXXXXX||||||||||||||||||||||||||||||||||||||||||||||||||||||||||||||||
