HEIGHT=16;WIDTH=201;THEME=0;OVERRIDE=false
--------------------------------------------------------------------------------------------------------------------------------------------------------------------------------------------------------
--------------------------------------------------------------------------------------------------------------------------------------------------------------------------------------------------------
--------------------------------------------------------------------------------------------------------------------------------------------------------------------------------------------------------
--------------------------------------------------------------------------------------------------------------------------------------------------------------------------------------------------------
--------------------------------------------------------------------------------------------------------------------------------------------------------------------------------------------------------
--------------------------------------------------------------------------------------------------------------------------------------------------------------------------------------------------------
--------------------------------------------------------------------------------------------------------------------------------------------------------------------------------------------------------
--------------------------------------------------------------------------------------------------------------------------------------------------------------------------------------------------------
-----------------------------------------------------------------------------------------k--------------------------------------------------------------------------------------------------------------
-------------------------------------2SC2S2SCS---------------------------------------%%%%%%%------------------------------------------------------------------------------------------------------------
-------------------------------------------------------------------------------------|||||||-----------------------y------------------------------------------------------------------------------------
-------------------------------------------------------------------------------------||||||g---------------------%%%%%----------------------------------------------------------------------------------
----------------------------------------------------------------------------------%%%%%%%%%%%%%%%%---%%%%--------|||||----------------------------------------------------------------------------------
%%%%%%%%%%%%---%%%%%%%---%%%%%------%%%%%%%%%%%-------------------%%%%--%%%%------||||||||||||||||---||||--------||%%%%%----%%%---%%%-------------------------------------------------------------------
||||||||||||---|||||||---|||||%%--%%|||||||||||%%--%%-------------||||--||||------||||||||||||||||---||||%%%%----||y||||----|||---|||-------------------------------------------------------------------
||||||||||||---|||||||---|||||||--|||||||||||||||--||XXXXX---XXXXX||||--||||XX--XX||||||||||||||||---||||||||XXXXXXXXXXXXXXX|||---|||XXXXXXXXXXXXXXFXXXXXXXXXXXXXXXXXXXXXXXXXXXXXXXXXXXXXXXXXXXXXXXXXXXX
