HEIGHT=16;WIDTH=201;THEME=0;OVERRIDE=false
--------------------------------------------------------------------------------------------------------------------------------------------------------------------------------------------------------
--------------------------------------------------------------------------------------------------------------------------------------------------------------------------------------------------------
--------------------------------------------------------------------------------------------------------------------------------------------------------------------------------------------------------
--------------------------------------------------------------------------------------------------------------------------------------------------------------------------------------------------------
--------------------------------------------------------------------------------------------------------------------------------------------------------------------------------------------------------
--------------------------------------------------------------------------------------------------------------------------------------------------------------------------------------------------------
--------------------------------------------------------------------------------------------------------------------------------------------------------------------------------------------------------
--------------------------------------------------------------------------------------------------------------------------------------------------------------------------------------------------------
---------------------------------------------------------------S2S2U------------------------------------------------------------------------------------------------------------------------------------
--------------------------------------------------------------------------------------------------------------------------------------------------------------------------------------------------------
---------------------------------------------tt---------------------%-----------------------------------------------------------------------------------------------------------------------------------
---------------------------------------Tt----tt---------------------|-----------------------------------------------------------------------------------------------------------------------------------
-----------------------------#--#------tt----tt---------------%%%%%%%%----------------------------------------------------------%%%---%%%---------------------------------------------------------------
----------------------r-r---##--##--%%%%%%%%%%%%%%------------||||||||----------------------------------------------------------|||---|||---------------------------------------------------------------
%%%%%%%%%%----------%%%%%%%%%%--%%%%||||||||||||||------%%--%%||||||||---------------%%%%%---%%%%%-------------%%--%%%%%%---%%%%|||---|||%%%%%%%%F%%%%%%%%%%%%%%%%%%%%%%%%%%%%%%%%%%%%%%%%%%%%%%%%%%%%%%
||||||||||XXXX--XXXX||||||||||--||||||||||||||||||XX--XX||--||||||||||XX--XXXXX---XXX|||||---|||||XX---XXXX--XX||--||||||---|||||||---|||||||||||X||||||||||||||||||||||||||||||||||||||||||||||||||||||
