HEIGHT=16;WIDTH=201;THEME=0;OVERRIDE=false
--------------------------------------------------------------------------------------------------------------------------------------------------------------------------------------------------------
--------------------------------------------------------------------------------------------------------------------------------------------------------------------------------------------------------
--------------------------------------------------------------------------------------------------------------------------------------------------------------------------------------------------------
--------------------------------------------------------------------------------------------------------------------------------------------------------------------------------------------------------
--------------------------------------------------------------------------------------------------------------------------------------------------------------------------------------------------------
--------------------------------------------------------------------------------------------------------------------------------------------------------------------------------------------------------
--------------------------------------------------------------------------------------------------------------------------------------------------------------------------------------------------------
--------------------------------------------------------------------------------------------------------------------------------------------------------------------------------------------------------
--------------------------------------------------------------------------------------------------------------------------------------------------------------------------------------------------------
--------------------------------------------------------------------------------------------------------------------------------------------------------------------------------------------------------
-------------------------------------------------------------------------------------------------------------------------------2USSS2C------------------------------------------------------------------
--------------------------------------------------------------------------------------------------------------------------------------------------------------------------------------------------------
%%%%%%%%%%------------------------------------#--#--%%%-------g------------------------%%%---%%%---------#--#-------------------------------------------------------------------------------------------
||||||||||%%%%--%%%%%%%%%---%%%%%%%%%%%%%%%%%%%--%%%|||-----%%%%%-----%%%%%---%%%%%----|||---|||-------%%%--%%%---------------r---------%%%%%%%%F%%%%%%%%%%%%%%%%%%%%%%%%%%%%%%%%%%%%%%%%%%%%%%%%%%%%%%%
||||||||||||||--|||||||||---|||||||||||||||||||--||||||-----|||||-----|||||---|||||%%%%|||---|||%%---%%|||--|||%%--%%--------%%%%%%%%%%%||||||||%|||||||||||||||||||||||||||||||||||||||||||||||||||||||
||||||||||||||--|||||||||---|||||||||||||||||||--||||||XXXXXXXXXXXXXXX|||||---||||||||||||---|||||---|||||--|||||--||XXX--XXX|||||||||||||||||||||||||||||||||||||||||||||||||||||||||||||||||||||||||||
