HEIGHT=16;WIDTH=201;THEME=0;OVERRIDE=false
--------------------------------------------------------------------------------------------------------------------------------------------------------------------------------------------------------
--------------------------------------------------------------------------------------------------------------------------------------------------------------------------------------------------------
--------------------------------------------------------------------------------------------------------------------------------------------------------------------------------------------------------
--------------------------------------------------------------------------------------------------------------------------------------------------------------------------------------------------------
--------------------------------------------------------------------------------------------------------------------------------------------------------------------------------------------------------
--------------------------------------------------------------------------------------------------------------------------------------------------------------------------------------------------------
--------------------------------------------------------------------------------------------------------------------------------------------------------------------------------------------------------
--------------------------------------------------------------------------------------------------------------------------------------------------------------------------------------------------------
--------------------------------------------------------------------------------------------------------------------------------------------------------------------------------------------------------
--------------------------------------------------%%%---------------------------------------------------------------------------------------------------------------------------------------------------
-------------Tt-----------------------------------|||---------------------------------------------------------------------------------------------------------------------------------------------------
-------------tt-----------------------------------|||---------------------------------------------------------------------------------------------------------------------------------------------------
------------%%%%%%%--------------------------%%%%%%%%%%%-----%%%-Tt-----------#---#---%%%%--%%%%-------------------------------------#---#--------------------------------------------------------------
%%%%%%%%%%%%|||||||%%%-----------------------|||||||||||%%%%%|||-tt--Tt------##---##--||||--||||---#---#---%%%%%---%%%%%%%%--------%%%---%%%------------------------------------------------------------
||||||||||||||||||||||-----------------------|||||||||||||||||||-tt--tt----%%%%---%%%%||||--||||--##---##--|||||---||||||||--------|||---|||%%%%%%%%F%%%%%%%%%%%%%%%%%%%%%%%%%%%%%%%%%%%%%%%%%%%%%%%%%%%
||||||||||||||||||||||XXXXX--XXXXXXXXXXXXXXXX|||||||||||||||||||XXXXXXXXXXX||||---||||||||--||||XXXX---XXXX|||||---||||||||XXX--XXX|||---|||||||||||X|||||||||||||||||||||||||||||||||||||||||||||||||||
