HEIGHT=16;WIDTH=201;THEME=0;OVERRIDE=false
--------------------------------------------------------------------------------------------------------------------------------------------------------------------------------------------------------
--------------------------------------------------------------------------------------------------------------------------------------------------------------------------------------------------------
--------------------------------------------------------------------------------------------------------------------------------------------------------------------------------------------------------
--------------------------------------------------------------------------------------------------------------------------------------------------------------------------------------------------------
--------------------------------------------------------------------------------------------------------------------------------------------------------------------------------------------------------
--------------------------------------------------------------------------------------------------------------------------------------------------------------------------------------------------------
--------------------------------------------------------------------------------------------------------------------------------------------------------------------------------------------------------
--------------------------------------------------------------------------------------------------------------------------------------------------------------------------------------------------------
---------------------------USCS2------------------------------------SC2SC-------------------------------------------------------------------------------------------------------------------------------
--------------------------------------------------------------------------------------------------------------------------------------------------------------------------------------------------------
------------------------------------------tt----S2CSSSS----------------------------------r--------------------------------------------------------------------------------------------------------------
------------------------------------------tt----------------------------------------%%%%%%--------------------------------------------------------------------------------------------------------------
%%%%%%%%%%%%%-----------%%%%%%%%%-------%%%%%%%-----------#---#--%%%%%%%%%%%%%%%%%%-||||||----------------------------------tt-tt------Tt---------------------------------------------------------------
|||||||||||||-----------|||||||||-------|||||||---------%%%---%%%||||||||||||||||||-|||r||---------------------#---#-----Tt-tt-tt------tt----%%%%%%%%F%%%%%%%%%%%%%%%%%%%%%%%%%%%%%%%%%%%%%%%%%%%%%%%%%%
|||||||||||||-----------|||||||||-------|||||||%%%%%%%%%|||---|||||||||||||||||||||%%%%%%%%%%%%%%%%%%---%%%%%%%%---%%%---tt-tt-tt------tt----||||||||%||||||||||||||||||||||||||||||||||||||||||||||||||
|||||||||||||XXXX---XXXX|||||||||XX---XX|||||||||||||||||||---|||||||||||||||||||||||||||||||||||||||---||||||||---|||XXXXXXXXXXXXXXXXXXXXXXX|||||||||||||||||||||||||||||||||||||||||||||||||||||||||||
