HEIGHT=16;WIDTH=201;THEME=0;OVERRIDE=false
--------------------------------------------------------------------------------------------------------------------------------------------------------------------------------------------------------
--------------------------------------------------------------------------------------------------------------------------------------------------------------------------------------------------------
--------------------------------------------------------------------------------------------------------------------------------------------------------------------------------------------------------
--------------------------------------------------------------------------------------------------------------------------------------------------------------------------------------------------------
--------------------------------------------------------------------------------------------------------------------------------------------------------------------------------------------------------
--------------------------------------------------------------------------------------------------------------------------------------------------------------------------------------------------------
--------------------------------------------------------------------------------------------------------------------------------------------------------------------------------------------------------
--------------------------------------------------------------------------------------------------------------------------------------------------------------------------------------------------------
--------------------------------------------------------------------------------------------------------------------------------------------------------------------------------------------------------
--------------------------------------------------------------------------------------------------------------------------------------------------------------------------------------------------------
-----------------------------------------------------------------------------------------------------------------------------USUS-----------------------------------------------------------------------
------------------------------------------------------------------------------------------------------------tt------tt----------------------------------------------------------------------------------
---------------------------------------------------%%---%%----------------%%%%%--%%%%%----------------------tt------tt-------------%%%%%---%%%%%%%%%%%%%F%%%%%%%%%%%%%%%%%%%%%%%%%%%%%%%%%%%%%%%%%%%%%%%
%%%%%%%%%%%%%%%%--%%-------------------------------||---||%%%--%%%%%%--%%%|||||--|||||-------------%%%%--%%%%%%%%%%%%%%%%%-k-------|||||---|||||||||||||%|||||||||||||||||||||||||||||||||||||||||||||||
||||||||||||||||--||%%%%---%%%%%%%%--%%%%----------||---|||||--||||||--||||||||--|||||%%%%%---%%%%%||||--|||||||||||||||||%%%%%%%%%|||||---|||||||||||||||||||||||||||||||||||||||||||||||||||||||||||||
||||||||||||||||--||||||---||||||||--||||XXXX--XXXX||---|||||--||||||--||||||||--||||||||||---|||||||||--|||||||||||||||||||||||||||||||---|||||||||||||||||||||||||||||||||||||||||||||||||||||||||||||
