HEIGHT=16;WIDTH=201;THEME=0;OVERRIDE=false
--------------------------------------------------------------------------------------------------------------------------------------------------------------------------------------------------------
--------------------------------------------------------------------------------------------------------------------------------------------------------------------------------------------------------
--------------------------------------------------------------------------------------------------------------------------------------------------------------------------------------------------------
--------------------------------------------------------------------------------------------------------------------------------------------------------------------------------------------------------
--------------------------------------------------------------------------------------------------------------------------------------------------------------------------------------------------------
--------------------------------------------------------------------------------------------------------------------------------------------------------------------------------------------------------
--------------------------------------------------------------------------------------------------------------------------------------------------------------------------------------------------------
--------------------------------------------------------------------------------------------------------------------------------------------------------------------------------------------------------
--------------------------------------------------------------------------------------------------------------------------------------------------------------------------------------------------------
--------------------------------------------------------------------------------------------------------------------------------------2S2---------------------------------------------------------------
-----------------------------------------------#---#----------------------------------------------------------------------------------------------------------------------------------------------------
-------------------------------------#--#-----##---##---------------------------------------------------------------------------------------------------------------------------------------------------
------------------g----------------%%%--%%%--###---###------Tt-----%%-----------G-----------------%%%---%%%------------%%%%-----------------------------------------------------------------------------
%%%%%%%%%%%%%-%%%%%----------------|||--|||%%%%%---%%%%%----tt-Tt--||--------%%%%-----------------|||---|||------------||g|----------%%%%%%%%-----------------------------------------------------------
|||||||||||||-|||||----%%%%%--%%%%%|||--||||||||---|||||----tt-tt--||---y----||||k--%%%%%%%---%%%%|||---|||--------%%%%%%%%%%%%%--%%%||||||||%%%%%%%%F%%%%%%%%%%%%%%%%%%%%%%%%%%%%%%%%%%%%%%%%%%%%%%%%%%
|||||||||||||XXXXXXXXXX|||||--||||||||--||||||||---|||||XXXXXXXXXXX||XXXXXXXXXXXXXXX|||||||---|||||||---|||XXXXXXXX|||||||||||||--|||||||||||||||||||X||||||||||||||||||||||||||||||||||||||||||||||||||
