HEIGHT=16;WIDTH=201;THEME=0;OVERRIDE=false
--------------------------------------------------------------------------------------------------------------------------------------------------------------------------------------------------------
--------------------------------------------------------------------------------------------------------------------------------------------------------------------------------------------------------
--------------------------------------------------------------------------------------------------------------------------------------------------------------------------------------------------------
--------------------------------------------------------------------------------------------------------------------------------------------------------------------------------------------------------
--------------------------------------------------------------------------------------------------------------------------------------------------------------------------------------------------------
--------------------------------------------------------------------------------------------------------------------------------------------------------------------------------------------------------
--------------------------------------------------------------------------------------------------------------------------------------------------------------------------------------------------------
--------------------------------------------------------------------------------------------------------------------------------------------------------------------------------------------------------
--------------------------------------------------------------------------------------------------------------------------------------------------------------------------------------------------------
-----------------------------------------------------tt-------------------------------------------------------------------------------------------------------------------------------------------------
-----------------------------------------------------tt----Tt-------------------------------------Tt------------------------------SCUS------------------------------------------------------------------
-----------------------------------------------------tt----tt-------#--#--------------------------tt----------------------------------------------------------------------------------------------------
%%%%%%%%%%%%%%%%%%--%%%%---------------------------%%%%%%%%%%%%%%--##--##--%%--%%%%---%%----------tt--------------------%%%--%%%------------------------------------------------------------------------
||||||||||||||||||--||||-----------------%%%%--%%%%||||||||||||||%%%%--%%%%||--||||---||%%%--%%%%%%%%%%%%%------tt------|||--|||--------------------%%%%%%%%F%%%%%%%%%%%%%%%%%%%%%%%%%%%%%%%%%%%%%%%%%%%
||||||||||||||||||--||||%%%%%---%%%%---%%||||--||||||||||||||||||||||--||||||--||||---|||||--|||||||||||||------tt------|||--|||%%%%%%%-------------||||||||%|||||||||||||||||||||||||||||||||||||||||||
||||||||||||||||||--|||||||||---||||---||||||--||||||||||||||||||||||--||||||--||||---|||||--|||||||||||||XXXXXXXXXXXXXX|||--||||||||||XXXXX---XXXXX||||||||||||||||||||||||||||||||||||||||||||||||||||
