HEIGHT=16;WIDTH=201;THEME=0;OVERRIDE=false
--------------------------------------------------------------------------------------------------------------------------------------------------------------------------------------------------------
--------------------------------------------------------------------------------------------------------------------------------------------------------------------------------------------------------
--------------------------------------------------------------------------------------------------------------------------------------------------------------------------------------------------------
--------------------------------------------------------------------------------------------------------------------------------------------------------------------------------------------------------
--------------------------------------------------------------------------------------------------------------------------------------------------------------------------------------------------------
--------------------------------------------------------------------------------------------------------------------------------------------------------------------------------------------------------
--------------------------------------------------------------------------------------------------------------------------------------------------------------------------------------------------------
--------------------------------------------------------------------------------------------------------------------------------------------------------------------------------------------------------
---------------------------------UUCCCSS----------------------------------------------------------------------------------------------------------------------------------------------------------------
---------------------------------------------------------------------------CCSSS------------------------------------------------------------------------------------------------------------------------
--------------------------------------------------------------------------------------------------------------------------------------------------------------------------------------------------------
------------------------------------k--r----------------------------------------------------------------------------------------------------------------------------------------------------------------
------------------------------%%%%%%%%%%%-tt----Tt------------------------k-yr---------%%%%---%%%%-------------------------------%%%%%---%%%%%----------------------------------------------------------
------------------------------|||||||||||-tt----tt----#---#---%%%%---%%%%%%%%%%%%------||||---||||-----------%%%--%%%------------|||||---|||||%%%%%%%%F%%%%%%%%%%%%%%%%%%%%%%%%%%%%%%%%%%%%%%%%%%%%%%%%%
%%%%%%%%%%%------%%%%%---%%%%%|||||||||||%%%%%%%%%%--##---##--||||---||||||||||||%%%%%%||||---||||-----------|||--|||%%--%%%%%%%%|||||---|||||||||||||%|||||||||||||||||||||||||||||||||||||||||||||||||
|||||||||||XX--XX|||||---||||||||||||||||||||||||||XXXX---XXXX||||---||||||||||||||||||||||---||||XXXX---XXXX|||--|||||--|||||||||||||---|||||||||||||||||||||||||||||||||||||||||||||||||||||||||||||||
