HEIGHT=16;WIDTH=201;THEME=0;OVERRIDE=false
--------------------------------------------------------------------------------------------------------------------------------------------------------------------------------------------------------
--------------------------------------------------------------------------------------------------------------------------------------------------------------------------------------------------------
--------------------------------------------------------------------------------------------------------------------------------------------------------------------------------------------------------
--------------------------------------------------------------------------------------------------------------------------------------------------------------------------------------------------------
--------------------------------------------------------------------------------------------------------------------------------------------------------------------------------------------------------
--------------------------------------------------------------------------------------------------------------------------------------------------------------------------------------------------------
--------------------------------------------------------------------------------------------------------------------------------------------------------------------------------------------------------
--------------------------------------------------------------------------------------------------------------------------------------------------------------------------------------------------------
---------------------2C22----------------------------------------------------------------------------------------------------------------CSS-S----------------------------------------------------------
--------------------------------------------------------------------------------------------------------------------------------------------------------------------------------------------------------
-------------------------------------------------------------------------------tt-tt---tt-------------------------------------SCSSUCC---%---%-----------------------------------------------------------
--------------------------------------------------------------tt---------------tt-tt---tt-----------------------------------------------|g-k|-y---------------------------------------------------------
----------%%%--%%%%%%%%%%%----------------------------#--#----tt---Tt----------tt-tt---tt------------------#---#-----------------------%%%%%%%%%%%%%%%%%%%F%%%%%%%%%%%%%%%%%%%%%%%%%%%%%%%%%%%%%%%%%%%%%
----------|||--|||||||||||---------------------------##--##---tt---tt---%%%%%%%%%%%%%%%%%%%-----%%%---%%%%%%---%%%%%%%--%%%%-y----k----|||||||||||||||||||%|||||||||||||||||||||||||||||||||||||||||||||
%%%%%%%%%%|||--|||||||||||%%%%%--%%%%%%%%%%--------%%%%--%%%%%%%%%%%%%%%|||||||||||||||||||%%%%%|||---||||||---|||||||--||||%%%%%%%%%%%|||||||||||||||||||||||||||||||||||||||||||||||||||||||||||||||||
|||||||||||||--||||||||||||||||--||||||||||XXX--XXX||||--||||||||||||||||||||||||||||||||||||||||||---||||||---|||||||--||||||||||||||||||||||||||||||||||||||||||||||||||||||||||||||||||||||||||||||||
