HEIGHT=16;WIDTH=201;THEME=0;OVERRIDE=false
--------------------------------------------------------------------------------------------------------------------------------------------------------------------------------------------------------
--------------------------------------------------------------------------------------------------------------------------------------------------------------------------------------------------------
--------------------------------------------------------------------------------------------------------------------------------------------------------------------------------------------------------
--------------------------------------------------------------------------------------------------------------------------------------------------------------------------------------------------------
--------------------------------------------------------------------------------------------------------------------------------------------------------------------------------------------------------
--------------------------------------------------------------------------------------------------------------------------------------------------------------------------------------------------------
--------------------------------------------------------------------------------------------------------------------------------------------------------------------------------------------------------
--------------------------------------------------------------------------------------------------------------------------------------------------------------------------------------------------------
--------------------------------------------------------------------------------------------------------------------------------------------------------------------------------------------------------
---------------------------------------------k----------------------------------------------------------------------------------------------------------------------------------------------------------
------------------------------------------%%%%-------------------------------------------------------------------------------------------CCSS2SC--------------------------------------------------------
------------------------------------------||||------------------------------------------g---------------------------------------------------------------------------------------------------------------
----------------------------%%%--%%%-----y||r|k--------%%%%%--%%%%%------------%%---%%--%%%%%%%---------%%%%%%%%%%%-----------%%%---%%%-----------%%%%%%%%F%%%%%%%%%%%%%%%%%%%%%%%%%%%%%%%%%%%%%%%%%%%%%
--------------------%%%--%%%|||--|||%%%%%%%%%%%%%%%%%%%|||||--|||||%%%%%--%%%%%||---||--|||||||---------|||||||||||%%%%---%%%%|||---|||-----------||||||||%|||||||||||||||||||||||||||||||||||||||||||||
%%%%%%%%%%%%%%%%----|||--||||||--|||||||||||||||||||||||||||--||||||||||--|||||||---||-k||g||||---------|||||||||||||||---|||||||---|||%%%%%%%%%%%||||||||||||||||||||||||||||||||||||||||||||||||||||||
||||||||||||||||XXXX|||--||||||--|||||||||||||||||||||||||||--||||||||||--|||||||---||XXXXXXXXXXXXXXXXXX|||||||||||||||---|||||||---||||||||||||||||||||||||||||||||||||||||||||||||||||||||||||||||||||
