HEIGHT=16;WIDTH=201;THEME=0;OVERRIDE=false
--------------------------------------------------------------------------------------------------------------------------------------------------------------------------------------------------------
--------------------------------------------------------------------------------------------------------------------------------------------------------------------------------------------------------
--------------------------------------------------------------------------------------------------------------------------------------------------------------------------------------------------------
--------------------------------------------------------------------------------------------------------------------------------------------------------------------------------------------------------
--------------------------------------------------------------------------------------------------------------------------------------------------------------------------------------------------------
--------------------------------------------------------------------------------------------------------------------------------------------------------------------------------------------------------
--------------------------------------------------------------------------------------------------------------------------------------------------------------------------------------------------------
---------------------------------------------------------------------------------------------------------------%%%--------------------------------------------------------------------------------------
--------------------CSS--k-------------------------------------------------------------------------------------|||----------------CSSCCC----------------------------------------------------------------
-------------------------%%%%%%%-------------------------------------------------------------------------------|||--------------------------------------------------------------------------------------
-------------------------|||||||-------------------------------------------------------------------#--#-------yg||--------------------------------------------------------------------------------------
--------------------g----|k|||||------------------------------------------------------------------##--##-----%%%%%%%---------------y-g------------------------------------------------------------------
-----------------%%%%%%%%%%%%%%%%%%%%%-------------------------#--#-------------------%%%%--%%%%%%%%--%%%%---|||||||------------%%%%%%%%%%%%%%%%%%F%%%%%%%%%%%%%%%%%%%%%%%%%%%%%%%%%%%%%%%%%%%%%%%%%%%%%
-----------------|||||||||||||||||||||%%%%%---%%%%%-----------##--##------------------||||--||||||||--||||---g||||||------------||||||||||||||||||%|||||||||||||||||||||||||||||||||||||||||||||||||||||
%%%%%%%%%%-------||||||||||||||||||||||||||---|||||%%%%------###--###--%%%--%%%%%---%%||||--||||||||--||||%%%%%%%%%%%%%---------||||||||||||||||||||||||||||||||||||||||||||||||||||||||||||||||||||||||
||||||||||XX---XX||||||||||||||||||||||||||---|||||||||XXXXXXXXX--XXXXX|||--|||||---||||||--||||||||--|||||||||||||||||XXX---XXX||||||||||||||||||||||||||||||||||||||||||||||||||||||||||||||||||||||||
