HEIGHT=16;WIDTH=201;THEME=0;OVERRIDE=false
--------------------------------------------------------------------------------------------------------------------------------------------------------------------------------------------------------
--------------------------------------------------------------------------------------------------------------------------------------------------------------------------------------------------------
--------------------------------------------------------------------------------------------------------------------------------------------------------------------------------------------------------
--------------------------------------------------------------------------------------------------------------------------------------------------------------------------------------------------------
--------------------------------------------------------------------------------------------------------------------------------------------------------------------------------------------------------
--------------------------------------------------------------------------------------------------------------------------------------------------------------------------------------------------------
--------------------------------------------------------------------------------------------------------------------------------------------------------------------------------------------------------
--------------------------------------------------------------------------------------------------------------------------------------------------------------------------------------------------------
------------------------------------------------------------------------2CSSS---------------------------------------------------------------------------------------------------------------------------
-------------------------------------------------------------------------------2SSCS-----2CCSS----------------------------------------------------------------------------------------------------------
--------------------------------------------------------------------------------------------------------------------------------------------------------------------------------------------------------
-------------------------------#---#----------------------------------g---r----------------------------------y------------------------------------------------------------------------------------------
------------#---#----#---#----##---##-------------------%%%---------%%%%%%%%%%----------y-------y-------%%%%%%%%---------------#---#--------------------------------------------------------------------
----------%%%---%%%%%%---%%%%%%%---%%%%---#---#---%%--%%|||---------||||||||||%%%%%%%%%%%%%%%%%%%%------||||||||--------------##---##-------------------------------------------------------------------
%%%%%%%%%%|||---||||||---|||||||---||||--##---##--||--|||||---------||||||||||||||||||||||||||||||%%--%%||||||||%%%%---%%%%--###---###--%%%%%%%%F%%%%%%%%%%%%%%%%%%%%%%%%%%%%%%%%%%%%%%%%%%%%%%%%%%%%%%%
|||||||||||||---||||||---|||||||---||||XXXX---XXXX||--|||||XXX---XXX||||||||||||||||||||||||||||||||--||||||||||||||---||||XXXXX---XXXXX||||||||X|||||||||||||||||||||||||||||||||||||||||||||||||||||||
