HEIGHT=16;WIDTH=201;THEME=0;OVERRIDE=false
--------------------------------------------------------------------------------------------------------------------------------------------------------------------------------------------------------
--------------------------------------------------------------------------------------------------------------------------------------------------------------------------------------------------------
--------------------------------------------------------------------------------------------------------------------------------------------------------------------------------------------------------
--------------------------------------------------------------------------------------------------------------------------------------------------------------------------------------------------------
--------------------------------------------------------------------------------------------------------------------------------------------------------------------------------------------------------
--------------------------------------------------------------------------------------------------------------------------------------------------------------------------------------------------------
--------------------------------------------------------------------------------------------------------------------------------------------------------------------------------------------------------
--------------------------------------------------------------------------------------------------------------------------------------------------------------------------------------------------------
-------------------------------------------------22C----------------------------------------------------------------------------------------------------------------------------------------------------
----------------------------------------------------------------------------------------SCSSU-----------------------------------------------------------------------------------------------------------
-----------------------------------------------------------------------------------------------------------------------------------------%%%%%%%--------------------------------------------------------
-----------------------------2U2S-S2----------------k-----------------------------------------------#--#---------------------------------|||||||--------------------------------------------------------
-----------------------------------------------%%%%%%%%-----------------#---#----------------------##--##-------------------%%%%---%%%%--|||||||----%%%%%%%%F%%%%%%%%%%%%%%%%%%%%%%%%%%%%%%%%%%%%%%%%%%%
%%%%%%%%%%%%%%%%%%%%---%%%%%-----%-----%%%--%%%||||||||-k----%%%--%%%--##---##--%%---%%%%%%%%%%%--###--###--%%---%%%%%---%%%||||---||||--|||y|||----||||||||%|||||||||||||||||||||||||||||||||||||||||||
||||||||||||||||||||---|||||-----|-----|||--|||||||||||%%%%%%|||--|||%%%%---%%%%||---|||||||||||%%%%%--%%%%%||---|||||---|||||||---||||%%%%%%%%%%%%%||||||||||||||||||||||||||||||||||||||||||||||||||||
||||||||||||||||||||---|||||XXXXXXXXXXX|||--||||||||||||||||||||--|||||||---||||||---||||||||||||||||--|||||||---|||||---|||||||---|||||||||||||||||||||||||||||||||||||||||||||||||||||||||||||||||||||
