HEIGHT=16;WIDTH=201;THEME=0;OVERRIDE=false
--------------------------------------------------------------------------------------------------------------------------------------------------------------------------------------------------------
--------------------------------------------------------------------------------------------------------------------------------------------------------------------------------------------------------
--------------------------------------------------------------------------------------------------------------------------------------------------------------------------------------------------------
--------------------------------------------------------------------------------------------------------------------------------------------------------------------------------------------------------
--------------------------------------------------------------------------------------------------------------------------------------------------------------------------------------------------------
--------------------------------------------------------------------------------------------------------------------------------------------------------------------------------------------------------
--------------------------------------------------------------------------------------------------------------------------------------------------------------------------------------------------------
----------------------------------------------------------%%%%------------------------------------------------------------------------------------------------------------------------------------------
----------------------------------------------------------||||-----------CSSSS--------------------------------------------------------------------------------------------------------------------------
------------------------------C-S2-----SSU2----------%%%%%%%||------------------------------------------------------------------------------------------------------------------------------------------
-----------------------------------------------------|||||||||----------------------#--#----------------------------------------------------------------------------------------------------------------
-----------------------------%-%---------------------|||||||||---------------------##--##---------------------------------------------------------------------------------------------------------------
-------------------%%%---%%%-|-|----y-----g----------|||||||||---------%%%%%%%%%%%%%%--%%%%-------------%%---------------%%%%%--%%%%%-------------------------------------------------------------------
%%%%%%%%%%%%%---%%%|||---|||%%%%%%%%%%%%%%%%%%------%%%%%%%%%%%%%%%%%%%||||||||||||||--||||-------------||---------------|||||--|||||-------------------------------------------------------------------
|||||||||||||---||||||---|||||||||||||||||||||%%--%%|||||||||||||||||||||||||||||||||--||||-------------||%%---%%%%%--%%%|||||--|||||---------%%%%%%%%F%%%%%%%%%%%%%%%%%%%%%%%%%%%%%%%%%%%%%%%%%%%%%%%%%
|||||||||||||---||||||---|||||||||||||||||||||||--|||||||||||||||||||||||||||||||||||--||||XXXXX---XXXXX||||---|||||--||||||||--|||||XXX---XXX||||||||X|||||||||||||||||||||||||||||||||||||||||||||||||
