HEIGHT=16;WIDTH=201;THEME=0;OVERRIDE=false
--------------------------------------------------------------------------------------------------------------------------------------------------------------------------------------------------------
--------------------------------------------------------------------------------------------------------------------------------------------------------------------------------------------------------
--------------------------------------------------------------------------------------------------------------------------------------------------------------------------------------------------------
--------------------------------------------------------------------------------------------------------------------------------------------------------------------------------------------------------
--------------------------------------------------------------------------------------------------------------------------------------------------------------------------------------------------------
--------------------------------------------------------------------------------------------------------------------------------------------------------------------------------------------------------
---------------SSS2U2-----------------------------------------------------------------------------------------------------------------------------------------------------------------------------------
--------------------------------------------------------------------------------------------------------------------------------------------------------------------------------------------------------
--------------------------------------------------------------------------------------------------------------------------------------------------------------------------------------------------------
--------------------------------------------------------------------------------------------------------------------------------------------------------------------------------------------------------
---------------%%%%%%%------------------------------------------------------------g---------------------------------------#--#--------------------------------------------------------------------------
---------------|||||||------------------------------------------------------------%%%------------------------------------##--##-----#--#----------------------------------------------------------------
---------------||k||r|--------------------------------------#--#------%%%%---%%%%-|||-------%%--%%---------------------%%%%--%%%%--##--##---------------------------------------------------------------
--------------%%%%%%%%%%---#--#----------%%--%%%%%%--%%%%--##--##-----||||---||||-|||-------||--||---------------------||||--||||%%%%--%%%%-------------------------------------------------------------
%%%%%%%%%%%%%%||||||||||--##--##---------||--||||||--||||%%%%--%%%%%%%||||---||||%%%%%%%%%%%||--||%%%%%--%%%%%---------||||--||||||||--||||%%%%%%%%F%%%%%%%%%%%%%%%%%%%%%%%%%%%%%%%%%%%%%%%%%%%%%%%%%%%%
||||||||||||||||||||||||XXXX--XXXXXXXXXXX||--||||||--||||||||--|||||||||||---|||||||||||||||||--|||||||--|||||XXX---XXX||||--||||||||--||||||||||||X||||||||||||||||||||||||||||||||||||||||||||||||||||
