HEIGHT=16;WIDTH=201;THEME=0;OVERRIDE=false
--------------------------------------------------------------------------------------------------------------------------------------------------------------------------------------------------------
--------------------------------------------------------------------------------------------------------------------------------------------------------------------------------------------------------
--------------------------------------------------------------------------------------------------------------------------------------------------------------------------------------------------------
--------------------------------------------------------------------------------------------------------------------------------------------------------------------------------------------------------
--------------------------------------------------------------------------------------------------------------------------------------------------------------------------------------------------------
--------------------------------------------------------------------------------------------------------------------------------------------------------------------------------------------------------
--------------------------------------------------------------------------------------------------------------------------------------------------------------------------------------------------------
--------------------------------------------------------------------------------------------------------------------------------------------------------------------------------------------------------
----------------------------------------------------------------------------------------------------------------SSS2CCUS--------------------------------------------------------------------------------
---------------------------------------------------------------------------------------------------S2UUSC-----------------------------------------------------------------------------------------------
--------------------------------------------------------------#---#--------------------------------------------%----------------------------------------------------------------------------------------
-------------------------------------------------------------##---##-------------------------------------------|----------------------------------------------------------------------------------------
------------------------------------%%---%%----------%%--%%%%%%---%%%%----------------------%%%%%-----k--g--%%%%%%%%%%%%%%%-----------%%---%%%%%%%%%%F%%%%%%%%%%%%%%%%%%%%%%%%%%%%%%%%%%%%%%%%%%%%%%%%%%
--------------------------%%%%--%%%%||---||----------||--||||||---||||----------%%%%%--%%%%%|||||%%%%%%%%%%%|||||||||||||||---#---#---||---||||||||||%||||||||||||||||||||||||||||||||||||||||||||||||||
--------------------------||||--||||||---||%%%%--%%%%||--||||||---||||%%%%--%%%%|||||--||||||||||||||||||||||||||||||||||||--##---##--||---|||||||||||||||||||||||||||||||||||||||||||||||||||||||||||||
XXXXXXXXXXXXXXXX---XXXXXXX||||--||||||---||||||--||||||--||||||---||||||||--|||||||||--||||||||||||||||||||||||||||||||||||XXXX---XXXX||---|||||||||||||||||||||||||||||||||||||||||||||||||||||||||||||
