HEIGHT=16;WIDTH=201;THEME=0;OVERRIDE=false
--------------------------------------------------------------------------------------------------------------------------------------------------------------------------------------------------------
--------------------------------------------------------------------------------------------------------------------------------------------------------------------------------------------------------
--------------------------------------------------------------------------------------------------------------------------------------------------------------------------------------------------------
--------------------------------------------------------------------------------------------------------------------------------------------------------------------------------------------------------
--------------------------------------------------------------------------------------------------------------------------------------------------------------------------------------------------------
--------------------------------------------------------------------------------------------------------------------------------------------------------------------------------------------------------
--------------------------------------------------------------------------------------------------------------------------------------------------------------------------------------------------------
----------------------------------------------------------------------------------------------------------------------------------------CS22------------------------------------------------------------
--------------------------------------------------------------------------------------------------------------------------------------------------------------------------------------------------------
-------------------------tt---Tt------------------------------------------------------------------------------------------------------------------------------------------------------------------------
-------------------------tt---tt------------------------------------------------------------------------------------------------------------------------------------------------------------------------
-------------------------tt---tt-------------------------------------------------------------------------------------------------------%%%%%%-----------------------------------------------------------
----------------------%%%%%%%%%%%%%%%%%%---%%%%%-----------------------------------------%%%%---%%%%-----------------------------------||||||--%%%%%%%%F%%%%%%%%%%%%%%%%%%%%%%%%%%%%%%%%%%%%%%%%%%%%%%%%
%%%%%%%%%%%-----------||||||||||||||||||---|||||-----------------------------------------||||---||||%%%------------------------------%%%%||||--||||||||%||||||||||||||||||||||||||||||||||||||||||||||||
|||||||||||-----------||||||||||||||||||---|||||%%--%%--#---#--%%--%%%%--%%%%---%%%%---%%||||---|||||||----------------%%%%--%%%%----||y|||||--|||||||||||||||||||||||||||||||||||||||||||||||||||||||||
|||||||||||XXXX---XXXX||||||||||||||||||---|||||||--||XXX---XXX||--||||--||||---||||---||||||---|||||||XX--XXXXXXXXXXXX||||--||||XXXXXXXXXXXXXX|||||||||||||||||||||||||||||||||||||||||||||||||||||||||
