HEIGHT=16;WIDTH=201;THEME=0;OVERRIDE=false
--------------------------------------------------------------------------------------------------------------------------------------------------------------------------------------------------------
--------------------------------------------------------------------------------------------------------------------------------------------------------------------------------------------------------
--------------------------------------------------------------------------------------------------------------------------------------------------------------------------------------------------------
--------------------------------------------------------------------------------------------------------------------------------------------------------------------------------------------------------
--------------------------------------------------------------------------------------------------------------------------------------------------------------------------------------------------------
--------------------------------------------------------------------------------------------------------------------------------------------------------------------------------------------------------
--------------------------------------------------------------------------------------------------------------------------------------------------------------------------------------------------------
--------------------------------------------------------------------------------------------------------------------------------------------------------------------------------------------------------
--------------------------------------------------------------------------------------------------------------------------------------------------------------------------------------------------------
--------------------------------------------------------------------------------------------------------------------------------------------------------------------------------------------------------
------------------------------------------%%%%-------------------------------------------------------------------------------------g--------------------------------------------------------------------
--------------------Tt--------------------||||-----------------------------------------------#---#------------------------------%%%%%%------------------------------------------------------------------
%%%%%%%%%%%%%-Tt----tt-------------r------||||---------------------------------------%%%%%--##---##--%%%%%--%%%%%---------------||||||------------------------------------------------------------------
|||||||||||||-tt----tt-----%%---%%%%%%%%%%%%%%%%%%%%%---%%%------------------tt--tt--|||||%%%%---%%%%|||||--|||||---------------||||||---%%%%%%%%F%%%%%%%%%%%%%%%%%%%%%%%%%%%%%%%%%%%%%%%%%%%%%%%%%%%%%%
|||||||||||||%%%%%%%%%%%%%%||---|||||||||||||||||||||---|||----------%%%%----tt--tt--|||||||||---|||||||||--|||||%%%%--%%%%---g-||||||---||||||||%||||||||||||||||||||||||||||||||||||||||||||||||||||||
|||||||||||||||||||||||||||||---|||||||||||||||||||||---|||XXXX--XXXX||||XXXXXXXXXXXX|||||||||---|||||||||--|||||||||--||||XXXXXXXXXXXXXX|||||||||||||||||||||||||||||||||||||||||||||||||||||||||||||||
