HEIGHT=16;WIDTH=201;THEME=0;OVERRIDE=false
--------------------------------------------------------------------------------------------------------------------------------------------------------------------------------------------------------
--------------------------------------------------------------------------------------------------------------------------------------------------------------------------------------------------------
--------------------------------------------------------------------------------------------------------------------------------------------------------------------------------------------------------
--------------------------------------------------------------------------------------------------------------------------------------------------------------------------------------------------------
--------------------------------------------------CUC2--------------------------------------------------------------------------------------------------------------------------------------------------
--------------------------------------------------------------------------------------------------------------------------------------------------------------------------------------------------------
--------------------------------------------------------------------------------------------------------------------------------------------------------------------------------------------------------
--------------------------------------------------r--k--------------------------------------------------------------------------------------------------------------------------------------------------
---------------------------------------SS2CS-----%%%%%--------------------------------------------------------------------------------------------------------------------------------------------------
-------------------------------------------------|||||-------------------------------------------------g---------------------------------%%%%%----------------------------------------------------------
---------------------#---#-----------------------|||||------------------------------r--g-----------%%%%%%%-------------------------------|||||----------------------------------------------------------
--------------------##---##----------------------||||r----------------------------%%%%%%-----------|||||||-------------------------------|||||--%%%%%%--------------------------------------------------
%%%%%%%%%%%%%-----%%%%---%%%%---------%%%%%%%%%%%%%%%%%%--------------------------||||||-----------|||||||----------------------#--#----g|||||--||||||-g------------------------------------------------
|||||||||||||%%%%%||||---||||%%%---%%%||||||||||||||||||--------------------------||||||-----------|y|||||y-------%%%%%%------%%%--%%%%%%%%%%%%%%%%%%%%%%-----------------------------------------------
||||||||||||||||||||||---|||||||---|||||||||||||||||||||---------------%%%---%%%-r||||||---%%%%%%%%%%%%%%%%%----y-||||||------|||--||||||||||||||||||||||-----------------------------------------------
||||||||||||||||||||||---|||||||---|||||||||||||||||||||XXXXXXXXX--XXXX|||---|||XXXXXXXXXXX|||||||||||||||||XXXXXX||||||XX--XX|||--||||||||||||||||||||||XXXXXXXXFXXXXXXXXXXXXXXXXXXXXXXXXXXXXXXXXXXXXXX
