HEIGHT=16;WIDTH=201;THEME=0;OVERRIDE=false
--------------------------------------------------------------------------------------------------------------------------------------------------------------------------------------------------------
--------------------------------------------------------------------------------------------------------------------------------------------------------------------------------------------------------
--------------------------------------------------------------------------------------------------------------------------------------------------------------------------------------------------------
--------------------------------------------------------------------------------------------------------------------------------------------------------------------------------------------------------
--------------------------------------------------------------------------------------------------------------------------------------------------------------------------------------------------------
--------------------------------------------------------------------------------------------------------------------------------------------------------------------------------------------------------
--------------------------------------------------------------------------------------------------------------------------------------------------------------------------------------------------------
--------------------------------------------------------------------------------------------------------------------------------------------------------------------------------------------------------
--------------------------------------------------------------------------------------------------------------------------------------------------------------------------------------------------------
--------------------------------------------------------------------Tt----------------------------------------------------------------SSCCSCUSS---------------------------------------------------------
--------------------------------------------------------------Tt----tt----------------------------------------------------------------------------------------------------------------------------------
--------------------------------------------------------------tt----tt----------------------------------------------------------------------------------------------------------------------------------
------------Tt---tt-%%%%---%%%%---------------------------%%%%%%%%%%%%%-----------%%---%%---------------------------------------------------------------------------------------------------------------
------------tt---tt-||||---||||%%---%%%%%%%--%%%%%--------|||||||||||||-----------||---||---------------------------------%%%%%%%%%%%%%%%%%%%%%%--------------------------------------------------------
%%%%%%%%%%%%%%%%%%%%||||---||||||---|||||||--|||||--------|||||||||||||%%%%---%%%%||---||%%---%%%%%%%---%%%%%%%%%%---%%%%%||||||||||||||||||||||--------------------------------------------------------
||||||||||||||||||||||||---||||||---|||||||--|||||XXX--XXX|||||||||||||||||---||||||---||||---|||||||---||||||||||---|||||||||||||||||||||||||||XXXXXXXXFXXXXXXXXXXXXXXXXXXXXXXXXXXXXXXXXXXXXXXXXXXXXXXX
