HEIGHT=16;WIDTH=201;THEME=0;OVERRIDE=false
--------------------------------------------------------------------------------------------------------------------------------------------------------------------------------------------------------
--------------------------------------------------------------------------------------------------------------------------------------------------------------------------------------------------------
--------------------------------------------------------------------------------------------------------------------------------------------------------------------------------------------------------
--------------------------------------------------------------------------------------------------------------------------------------------------------------------------------------------------------
--------------------------------------------------------------------------------------------------------------------------------------------------------------------------------------------------------
--------------------------------------------------------------------------------------------------------------------------------------------------------------------------------------------------------
--------------------------------------------------------------------------------------------------------------------------------------------------------------------------------------------------------
--------------------------------------------------------------------------------------------------------------------------------------------------------------------------------------------------------
-------------------------------------------------------------------------------------------------------------------------------------SSS----------------------------------------------------------------
----------------------------------------------------------------------------#---#-----------------------------------------------------------------------------------------------------------------------
---------------------------------------------------------------------------##---##----------------------------------------------------------------------------------------------------------------------
-----------------------------------------------CS2USU----------SSSUUSSS---###---###------------------------------------------#---#------k---------------------------------------------------------------
%%%%%%%%%%%--------------%%%%%%%%%---#---#------------------------------%%%%%---%%%%%--------------------------------------%%%---%%%%%%%%%%-------------------------------------------------------------
|||||||||||--------------|||||||||--##---##------------%%--%%-----------|||||---|||||%%%%%---%%%%%%%%%%--------------------|||---||||||||||%%%%%%%%F%%%%%%%%%%%%%%%%%%%%%%%%%%%%%%%%%%%%%%%%%%%%%%%%%%%%
|||||||||||%%%%%%%-------|||||||||%%%%---%%%%-----g----||--||-----r--gk-|||||---||||||||||---||||||||||--------------------|||---||||||||||||||||||%||||||||||||||||||||||||||||||||||||||||||||||||||||
||||||||||||||||||XXXXXXX|||||||||||||---||||XXXXXXXXXX||--||XXXXXXXXXXX|||||---||||||||||---||||||||||XXXX--XXXXXXXX--XXXX|||---|||||||||||||||||||||||||||||||||||||||||||||||||||||||||||||||||||||||
