HEIGHT=16;WIDTH=201;THEME=0;OVERRIDE=false
--------------------------------------------------------------------------------------------------------------------------------------------------------------------------------------------------------
--------------------------------------------------------------------------------------------------------------------------------------------------------------------------------------------------------
--------------------------------------------------------------------------------------------------------------------------------------------------------------------------------------------------------
--------------------------------------------------------------------------------------------------------------------------------------------------------------------------------------------------------
--------------------------------------------------------------------------------------------------------------------------------------------------------------------------------------------------------
--------------------------------------------------------------------------------------------------------------------------------------------------------------------------------------------------------
--------------------------------------------------------------------------------------------------------------------------------------------------------------------------------------------------------
-----------------------------------------------------------ky-------------------------------------------------------------------------------------------------------------------------------------------
-----------------------------------------------------------%%%------------------------------------------------------------------------------------------------------------------------------------------
-----------------------------------------------------------|||------------------------------------------------------------------------------------------------------------------------------------------
---------------------------------g--------------------y----|||--------------------------2SSUCSS----%%%--------------------------------------------------------------------------------------------------
-------------------------------%%%%%%---------------%%%----|||-------------------------------------|||--------------------------------------------------------------------------------------------------
%%%%%%%%%%%%%-------%%%--%%%---|||||k---------------||r----|||-Y-------%%%-------------------------|||--------------------------------------------------------------------------------------------------
|||||||||||||-------|||--|||%%%%%%%%%%%%%%%%%--%%%%%%%%%%%%%%%%%%%-----|||-----------------k-y-----|||---k---g------------------------------------------------------------------------------------------
|||||||||||||-------|||--||||||||||||||||||||--|||||||||||||||||||%%%%%%%%%%%%%--#--#--%%%%%%%%%%%%%%%%%%%%%%%%%------------%%%%--%%%%%%--%%%%%%%%%%F%%%%%%%%%%%%%%%%%%%%%%%%%%%%%%%%%%%%%%%%%%%%%%%%%%%
|||||||||||||XX---XX|||--||||||||||||||||||||--||||||||||||||||||||||||||||||||XXX--XXX|||||||||||||||||||||||||XXXXX--XXXXX||||--||||||--||||||||||X|||||||||||||||||||||||||||||||||||||||||||||||||||
