HEIGHT=16;WIDTH=201;THEME=0;OVERRIDE=false
--------------------------------------------------------------------------------------------------------------------------------------------------------------------------------------------------------
--------------------------------------------------------------------------------------------------------------------------------------------------------------------------------------------------------
--------------------------------------------------------------------------------------------------------------------------------------------------------------------------------------------------------
--------------------------------------------------------------------------------------------------------------------------------------------------------------------------------------------------------
--------------------------------------------------------------------------------------------------------------------------------------------------------------------------------------------------------
--------------------------------------------------------------------------------------------------------------------------------------------------------------------------------------------------------
--------------------------------------------------------------------------------------------------------------------------------------------------------------------------------------------------------
--------------------------------------------------------------------------------------------------------------------------------------------------------------------------------------------------------
---------------------------------------------------------------------------------------------------------------%%%%-------------------------------------------------------------------------------------
---------------------------------------------------------SC2-UUC------#--#-------------------------------g-----||||-------------------------------------------------------------------------------------
---------------------------------------------------------------------##--##------------------------------%%%---||||-------------------------------------------------------------------------------------
--------------y--------------------------------k------------%-------###--###-----------------------------|||---||||-------------------------------------------------------------------------------------
-------------%%%%%%-------------------------%%%%%--%%%%-----|-----%%%%%--%%%%%-----------%%%%------------|||---||||-------------------------------------------------------------------------------------
----------%%%||||||------------------------k|||||--||||%%%%%%%%%%%|||||--|||||%%%%---%%%%||||------------||g---||||---%%%%%---%%%%%--Tt-----------------------------------------------------------------
----------|||||||||%%---%%%%%%%%%%%---%%%%%%%%%%%%%||||||||||||||||||||--|||||||||---||||||||%%%%--%%%%%%%%%%%%%%%%%%%|||||---|||||--tt-----------------------------------------------------------------
XXXXXXXXXX|||||||||||---|||||||||||---|||||||||||||||||||||||||||||||||--|||||||||---||||||||||||--||||||||||||||||||||||||---|||||XXXXXXXXXXXXXFXXXXXXXXXXXXXXXXXXXXXXXXXXXXXXXXXXXXXXXXXXXXXXXXXXXXXXX
