HEIGHT=16;WIDTH=201;THEME=0;OVERRIDE=false
--------------------------------------------------------------------------------------------------------------------------------------------------------------------------------------------------------
--------------------------------------------------------------------------------------------------------------------------------------------------------------------------------------------------------
--------------------------------------------------------------------------------------------------------------------------------------------------------------------------------------------------------
--------------------------------------------------------------------------------------------------------------------------------------------------------------------------------------------------------
--------------------------------------------------------------------------------------------------------------------------------------------------------------------------------------------------------
--------------------------------------------------------------------------------------------------------------------------------------------------------------------------------------------------------
--------------------------------------------------------------------------------------------------------------------------------------------------------------------------------------------------------
--------------------------------------------------------------------------------------------------------------------------------------------------------------------------------------------------------
--------------------------------------------------------------------------------------------------------------------------------------------------------------------------------------------------------
--------------------------------------------------------------------------------------------------------------------------------------------------------------------------------------------------------
----------------------------------------------------#--#-----------------------------------#---#------------SCCS-C--------------------------------------------------------------------------------------
---------------------------------------------------##--##---------------------------------##---##----------------------------------------------tt-------------------------------------------------------
%%%%%%%%%%%%%%%%%--%%%%--------------------------%%%%--%%%%------------------------------###---###--%%%%%%%-----%----%%%--%%%%%%%--%%%%--tt-tt-tt-------------------------------------------------------
|||||||||||||||||--||||%%%%%---%%%%%%%%%---------||||--||||--------------#--#----------%%%%%---%%%%%|||||||-----|r---|||--|||||||--||||--tt-tt-tt-%%%%%%%%F%%%%%%%%%%%%%%%%%%%%%%%%%%%%%%%%%%%%%%%%%%%%%
|||||||||||||||||--|||||||||---|||||||||%%%%%%%%%||||--||||------------%%%--%%%--#--#--|||||---||||||||||||%%%%%%%%%%|||--|||||||--||||%%%%%%%%%%%||||||||%|||||||||||||||||||||||||||||||||||||||||||||
|||||||||||||||||--|||||||||---||||||||||||||||||||||--||||XXXXX--XXXXX|||--|||XXX--XXX|||||---|||||||||||||||||||||||||--|||||||--|||||||||||||||||||||||||||||||||||||||||||||||||||||||||||||||||||||
