HEIGHT=16;WIDTH=201;THEME=0;OVERRIDE=false
--------------------------------------------------------------------------------------------------------------------------------------------------------------------------------------------------------
--------------------------------------------------------------------------------------------------------------------------------------------------------------------------------------------------------
--------------------------------------------------------------------------------------------------------------------------------------------------------------------------------------------------------
--------------------------------------------------------------------------------------------------------------------------------------------------------------------------------------------------------
--------------------------------------------------------------------------------------------------------------------------------------------------------------------------------------------------------
--------------------------------------------------------------------------------------------------------------------------------------------------------------------------------------------------------
--------------------------------------------------------------------------------------------------------------------------------------------------------------------------------------------------------
--------------------------------------------------------------------------------------------------------------------------------------------------------------------------------------------------------
--------------------------------------------------------------------------------------------------------------------------------------------------------------------------------------------------------
---------------kr---------------------------------------------------------------------------------------------------------------------------------------------------------------------------------------
---------------%%%%%-------------------------------------------------------------------------------------------------------------Tt---------------------------------------------------------------------
---------------|||||------------------------------------------------------------------------------#--#-----------------------tt--tt---------------------------------------------------------------------
---------------||||k-----------------------------#---#-------------------------------------------##--##----------------------tt--tt---------------------------------------------------------------------
------------%%%%%%%%%%%%%%%--%%%%--%%-----------##---##--%%%%%%%--------------------------------###--###--%%--%%--------%%%%%%%%%%%%%%%--%%%------------------------------------------------------------
%%%%%%%%%%%%|||||||||||||||--||||--||%%%---%%%%%%%---%%%%|||||||%%---%%%%%%%%%%%%%------------%%%%%--%%%%%||--||--#--#--|||||||||||||||--|||------------------------------------------------------------
|||||||||||||||||||||||||||--||||--|||||---|||||||---|||||||||||||---|||||||||||||XXXXX--XXXXX|||||--|||||||--||XXX--XXX|||||||||||||||--|||XXXXXXXXFXXXXXXXXXXXXXXXXXXXXXXXXXXXXXXXXXXXXXXXXXXXXXXXXXXX
