HEIGHT=16;WIDTH=201;THEME=0;OVERRIDE=false
--------------------------------------------------------------------------------------------------------------------------------------------------------------------------------------------------------
--------------------------------------------------------------------------------------------------------------------------------------------------------------------------------------------------------
--------------------------------------------------------------------------------------------------------------------------------------------------------------------------------------------------------
--------------------------------------------------------------------------------------------------------------------------------------------------------------------------------------------------------
--------------------------------------------------------------------------------------------------------------------------------------------------------------------------------------------------------
--------------------------------------------------------------------------------------------------------------------------------------------------------------------------------------------------------
--------------------------------------------------------------------------------------------------------------------------------------------------------------------------------------------------------
--------------------------------------------------------------------------------------------------------------------------------------------------------------------------------------------------------
-----------------------SSS------------------------------------------------------------------------------------------------------------------------------------------------------------------------------
--------------------------------------------------------#---#----------------------------------------------#--#-----------------------------------------------------------------------------------------
-------------------------------#--#--------------------##---##----------------r---------------------------##--##----------------------------------------------------------------------------------------
------------------------------##--##-------#---#------###---###-------------%%%%%%-----------------------###--###----------------yg---------------------------------------------------------------------
%%%%%%%%%%%%%%------%%%%%%%--###--###-----##---##---%%%%%---%%%%%--#---#---kr||||gk----------%%%%--%%%%%%%%%--%%%%%---------%%%%%%%----------%%%%%%%%F%%%%%%%%%%%%%%%%%%%%%%%%%%%%%%%%%%%%%%%%%%%%%%%%%%
||||||||||||||------|||||||%%%%%--%%%%%--###---###--|||||---|||||%%%---%%%%%%%%%%%%%%%%------||||--|||||||||--|||||------%%-y|||||y----------||||||||%||||||||||||||||||||||||||||||||||||||||||||||||||
||||||||||||||%%--%%||||||||||||--|||||%%%%%---%%%%%|||||---||||||||---||||||||||||||||------||||--|||||||||--|||||%%--%%||%%%%%%%%%%--%%--%%|||||||||||||||||||||||||||||||||||||||||||||||||||||||||||
||||||||||||||||--||||||||||||||--||||||||||---||||||||||---||||||||---||||||||||||||||XX--XX||||--|||||||||--|||||||--||||||||||||||XX||--|||||||||||||||||||||||||||||||||||||||||||||||||||||||||||||
