HEIGHT=16;WIDTH=201;THEME=0;OVERRIDE=false
--------------------------------------------------------------------------------------------------------------------------------------------------------------------------------------------------------
--------------------------------------------------------------------------------------------------------------------------------------------------------------------------------------------------------
--------------------------------------------------------------------------------------------------------------------------------------------------------------------------------------------------------
--------------------------------------------------------------------------------------------------------------------------------------------------------------------------------------------------------
--------------------------------------------------------------------------------------------------------------------------------------------------------------------------------------------------------
--------------------------------------------------------------------------------------------------------------------------------------------------------------------------------------------------------
--------------------------------------------------------------------------------------------------------------------------------------------------------------------------------------------------------
--------------------------------------------------------------------------------------------------------------------------g-----------------------------------------------------------------------------
--------------------------------------------------------------------UCC------------------------------------------------%%%%%%%--------------------------------------------------------------------------
-----------------------------------------------------------------------------------------------------------------------|||||||--------------------------------------------------------------------------
-----------------------------------------------------------------------------------------------------------------------|||||||--------------------------------------------------------------------------
--------------------------------------------------------Tt---------------------------------tt--------------------------|||%%%%%%------------------------------------------------------------------------
%%%%%%%%%%%%--------------%%%%%%%%---%%%%%%%%%---%%%%---tt------%%%%%%%%%%%%---%%%-tt-tt---tt--------------------------|||||||||------------------------------------------------------------------------
||||||||||||--------------||||||||---|||||||||---||||%%%%%%%%%%%||||||||||||---|||-tt-tt---tt--------------%%%%---%%%%-|||||||||------------------------------------------------------------------------
||||||||||||--------------||||||||---|||||||||---|||||||||||||||||||||||||||---|||%%%%%%%%%%%%%%%%%%---%%%%||||---||||-||k|g||||------------------------------------------------------------------------
||||||||||||XX---XXXXXXXXX||||||||---|||||||||---|||||||||||||||||||||||||||---|||||||||||||||||||||---||||||||---||||XXXXXXXXXXXXXXXXXXXXXX---XXXXXXXXXXXXXFXXXXXXXXXXXXXXXXXXXXXXXXXXXXXXXXXXXXXXXXXXX
