HEIGHT=16;WIDTH=201;THEME=0;OVERRIDE=false
--------------------------------------------------------------------------------------------------------------------------------------------------------------------------------------------------------
--------------------------------------------------------------------------------------------------------------------------------------------------------------------------------------------------------
--------------------------------------------------------------------------------------------------------------------------------------------------------------------------------------------------------
--------------------------------------------------------------------------------------------------------------------------------------------------------------------------------------------------------
--------------------------------------------------------------------------------------------------------------------------------------------------------------------------------------------------------
--------------------------------------------------------------------------------------------------------------------------------------------------------------------------------------------------------
------------------------%%%-----------------------------------------------------------------------------------------------------------------------------------------------------------------------------
------------------------|||-----------------------------------------------------------------------------------------------------------------------------------------------------------------------------
------------------------|||-----------------------------------------------------------------------------------------------------------------------------------------------------------------------------
------------------------|||--------------------------------------------------------------------------k--------------------------------------------------------------------------------------------------
-----------------%%%----|||------------------------------------------------------------------------%%%%-------------------------------------------------------------------------------------------------
-----------------|||--r-|||------------------------------------------------------------------------||g|-------tt---tt-------------#---#-----------------------------------------------------------------
%%%%%%%%%%%%%%%%%%%%%%%%%%%%%%%---%%--------%%%%--%%%%%%%%%--%%%%%---------%%---%%---------%%%%%%%%%%%%%%-----tt---tt--%%%---%%%%%%---%%%%%%%%%%%F%%%%%%%%%%%%%%%%%%%%%%%%%%%%%%%%%%%%%%%%%%%%%%%%%%%%%%
|||||||||||||||||||||||||||||||---||--------||||--|||||||||--|||||---------||---||---------||||||||||||||%%%%%%%%%%%%%%|||---||||||---|||||||||||%||||||||||||||||||||||||||||||||||||||||||||||||||||||
|||||||||||||||||||||||||||||||---||--------||||--|||||||||--|||||---------||---||%%%---%%%|||||||||||||||||||||||||||||||---||||||---||||||||||||||||||||||||||||||||||||||||||||||||||||||||||||||||||
|||||||||||||||||||||||||||||||---||XXXXXXXX||||--|||||||||--|||||XXX---XXX||---|||||---||||||||||||||||||||||||||||||||||---||||||---||||||||||||||||||||||||||||||||||||||||||||||||||||||||||||||||||
