HEIGHT=16;WIDTH=201;THEME=0;OVERRIDE=false
--------------------------------------------------------------------------------------------------------------------------------------------------------------------------------------------------------
--------------------------------------------------------------------------------------------------------------------------------------------------------------------------------------------------------
--------------------------------------------------------------------------------------------------------------------------------------------------------------------------------------------------------
--------------------------------------------------------------------------------------------------------------------------------------------------------------------------------------------------------
--------------------------------------------------------------------------------------------------------------------------------------------------------------------------------------------------------
--------------------------------------------------------------------------------------------------------------------------------------------------------------------------------------------------------
----------------------------------------------k---------------------------------------------------------------------------------------------------------------------------------------------------------
----------------------------------------------%%%%------------------------------------------------------------------------------------------------------------------------------------------------------
----------------------------------------------||||-------------------------------------------------------------------------------------------%%%%%%-----------------------------------------------------
----------------------------------------------|||g-------------------------------------------------------------------------------------------||||||-----------------------------------------------------
----------------------------------------------|%%%%%-----------------------CSS-----#---#-----------------------------------------------------||||||-----------------------------------------------------
----------------------------------------------||||||------------------------------##---##----------------------------------------------------||||y|-----------------------------------------------------
------------------#---#-----------------------||||||---%%%--%%%-----------------%%%%---%%%%--#--#------------------------------#---#--%%%%%%%%%%%%%%%---------------------------------------------------
%%%%%%%%%%%%%%---##---##----------------------||||||---|||--|||%%---%%%%%-------||||---||||%%%--%%%%%%%%--%%%%%%%%---%%%%%%%%%%%---%%%|||||||||||||||---------------------------------------------------
||||||||||||||--###---###----#---#---------%%%%%%%%%%%%|||--|||||---|||||%%%%%%%||||---|||||||--||||||||--||||||||---|||||||||||---||||||||||||||||||%%%%%%%%F%%%%%%%%%%%%%%%%%%%%%%%%%%%%%%%%%%%%%%%%%%
||||||||||||||XXXXX---XXXXXXXX---XXXXX---XX|||||||||||||||--|||||---||||||||||||||||---|||||||--||||||||--||||||||---|||||||||||---||||||||||||||||||||||||||X||||||||||||||||||||||||||||||||||||||||||
