HEIGHT=16;WIDTH=201;THEME=0;OVERRIDE=false
--------------------------------------------------------------------------------------------------------------------------------------------------------------------------------------------------------
--------------------------------------------------------------------------------------------------------------------------------------------------------------------------------------------------------
--------------------------------------------------------------------------------------------------------------------------------------------------------------------------------------------------------
--------------------------------------------------------------------------------------------------------------------------------------------------------------------------------------------------------
--------------------------------------------------------------------------------------------------------------------------------------------------------------------------------------------------------
--------------------------------------------------------------------------------------------------------------------------------------------------------------------------------------------------------
--------------------------------------------------------------------------------------------------------------------------------------------------------------------------------------------------------
--------------------------------------------------------------------------------------------------------------------------------------------------------------------------------------------------------
--------------------------------------------------------------------------------------------------------------------------------------------------------------------------------------------------------
-------------------------------------------------------------------------------------------------r------------------------------------------------------------------------------------------------------
---------------------------------------------------------------------SCS-------------#--#-------%%%-----------------------------------------------------------------------------------------------------
------------------------------------------------------------------------------------##--##------|||-----------------------------------------------------------------------------------------------------
-------------%%--%%%%%---%%%----------------------------------------%--------------###--###-----|||--g----------------k-----%%%%%--%%%%%----------------------------------------------------------------
-------------||--|||||---|||--#---#-----------------%%--%%%%%---%%%-|---k-%%---%%%%%%%--%%%%%%%%%%%%%%%%%%%%%------%%%%%%%%%|||||--|||||----------------------------------------------------------------
-------------||--|||||---|||%%%---%%%%%%------------||--|||||---|||%%%%%%%||---|||||||--|||||||||||||||||||||------||||||||||||||--|||||%%%%%%%%F%%%%%%%%%%%%%%%%%%%%%%%%%%%%%%%%%%%%%%%%%%%%%%%%%%%%%%%
XXXXXXXXXXXXX||--|||||---||||||---||||||XXXXX--XXXXX||--|||||---||||||||||||---|||||||--|||||||||||||||||||||XX--XX||||||||||||||--|||||||||||||X|||||||||||||||||||||||||||||||||||||||||||||||||||||||
