HEIGHT=16;WIDTH=201;THEME=0;OVERRIDE=false
--------------------------------------------------------------------------------------------------------------------------------------------------------------------------------------------------------
--------------------------------------------------------------------------------------------------------------------------------------------------------------------------------------------------------
----------------------------------------------------------------------------CCUCS-----------------------------------------------------------------------------------------------------------------------
--------------------------------------------------------------------------------------------------------------------------------------------------------------------------------------------------------
--------------------------------------------------------------------------------------------------------------------------------------------------------------------------------------------------------
--------------------------------------------------------------------------------------------------------------------------------------------------------------------------------------------------------
---------------------------------------------------------------------------%%%%%%-----------------------------------------------------------------------------------------------------------------------
---------------------------------------------------------------------------||||||-----------------------------------------------------------------------------------------------------------------------
---------------------------------------------------------------------------||||||----------2-SUU2SS-----------------------------------------------------------------------------------------------------
---------------------------------------------------------------------------||||||-----------------------------------------22SS--------------------------------------------------------------------------
---------------------------------------------------------------------------|%%%||----tt-----%-----------------------------------------------------------------------------------------------------------
---------------------------------------------------------------------------||||||----tt-----|-----------------------------------------------------------------------------------------------------------
------------%%%%--%%%%---%%%%%%%---------------------%%%%---%%%%-----------||||||--%%%%%%%%%%%%%%%%%%%%-----------------r--y----------------------------------------------------------------------------
------------||||--||||---|||||||---------------------||||---||||----y-k----||||||--||||||||||||||||||||----------------%%%%%%%%%------------------------------------------------------------------------
%%%%%%%%%%%%||||--||||---|||||||---------%%%%%--%%%%%||||---||||%%%%%%%%%%%%%%%%%%%||||||||||||||||||||%%%%%---%%%-----|||||||||----------%%%%%%%%F%%%%%%%%%%%%%%%%%%%%%%%%%%%%%%%%%%%%%%%%%%%%%%%%%%%%%
||||||||||||||||--||||XXXXXXXXXXXXXXXXXXX|||||--|||||||||---||||||||||||||||||||||||||||||||||||||||||||||||---|||XXXXX|||||||||XXXXX---XX||||||||X|||||||||||||||||||||||||||||||||||||||||||||||||||||
