HEIGHT=16;WIDTH=201;THEME=0;OVERRIDE=false
--------------------------------------------------------------------------------------------------------------------------------------------------------------------------------------------------------
--------------------------------------------------------------------------------------------------------------------------------------------------------------------------------------------------------
--------------------------------------------------------------------------------------------------------------------------------------------------------------------------------------------------------
--------------------------------------------------------------------------------------------------------------------------------------------------------------------------------------------------------
--------------------------------------------------------------------------------------------------------------------------------------------------------------------------------------------------------
--------------------------------------------------------------------------------------------------------------------------------------------------------------------------------------------------------
----------------------------------------------------------------g---------------------------------------------------------------------------------------------------------------------------------------
----------------------------------------------------------------%%%%%-------------------------y---------------------------------------------------------------------------------------------------------
----------------------------------------------------------------|||||------------------------%%%--------------------------------------------------------------------------------------------------------
----------------------Tt----------------------------------------||||%%%%%%-------------------|||------------------------SCCC----------------------------------------------------------------------------
------------------tt--tt----------------------------------------||||||||||-------------------|||--------------------------------------------------------------------------------------------------------
------------------tt--tt----------------------------------------||||||||||-------------------|||g-------------------------------------------------------------------------------------------------------
--------------%%%%%%%%%%%%-----------------%%%%%-------------%%%%%%%%%%%%%%%%%------------%%%%%%%%%%%-------------%%%-----------------------------------------------------------------------------------
%%%%%%%%%%%%%%||||||||||||%%--%%-----------|||||-------------|||||||||||||||||------------|||||||||||-------------|||%%%%%%%%%%%------------------------------------------------------------------------
||||||||||||||||||||||||||||--||----#---#--|||||%%%%--%%%%---|||||||||||||||||------------|||||||||||-------------||||||||||||||%%%%%--%%%%%------------------------------------------------------------
||||||||||||||||||||||||||||--||XXXXX---XXX|||||||||--||||XXX|||||||||||||||||XXXXX--XXXXX|||||||||||XXXXX---XXXXX|||||||||||||||||||--|||||XXXXXXXXFXXXXXXXXXXXXXXXXXXXXXXXXXXXXXXXXXXXXXXXXXXXXXXXXXXX
