HEIGHT=16;WIDTH=201;THEME=0;OVERRIDE=false
--------------------------------------------------------------------------------------------------------------------------------------------------------------------------------------------------------
--------------------------------------------------------------------------------------------------------------------------------------------------------------------------------------------------------
--------------------------------------------------------------------------------------------------------------------------------------------------------------------------------------------------------
--------------------------------------------------------------------------------------------------------------------------------------------------------------------------------------------------------
--------------------------------------------------------------------------------------------------------------------------------------------------------------------------------------------------------
--------------------------------------------------------------------------------------------------------------------------------------------------------------------------------------------------------
--------------------------------------------------------------------------------------------------------------------------------------------------------------------------------------------------------
-----------------------------------------------------------r--------------------------------------------------------------------------------------------------------------------------------------------
----------------------------------------------------------%%%%%%%-----------------------------------------------------------------------------------%%%-------------------------------------------------
----------------------------------------------------------|||||||-----------------------------------------------------------------------------------|||-------------------------------------------------
----------------------------------------------------------|||||%%%%%%%------------------------------------------------------------------------------|||-------------------------------------------------
----------------------Tt----tt--------------------------y-||||k||||y||------------------#--#-----------------------------------------------------y--|||-------------------------------------------------
----------------------tt----tt-----------------#--#---%%%%%%%%%%%%%%%%%%%--------------##--##-------------%%%%%--%%%%%--------#---#----%%%%%%%%%%%%%%%%%%-----------------------------------------------
%%%%%%%%%%%%%%-------%%%%%%%%%%%%%%%---%%%%%--##--##--|||||||||||||||||||--------Yk--%%%%--%%%%%%%%---%%%%|||||--|||||%%%%---##---##---||||||||||||||||||%%%%%%%%F%%%%%%%%%%%%%%%%%%%%%%%%%%%%%%%%%%%%%%
||||||||||||||%%---%%|||||||||||||||---|||||%%%%--%%%%|||||||||||||||||||%%--%%%%%%%%||||--||||||||---|||||||||--|||||||||--###---###--||||||||||||||||||||||||||%||||||||||||||||||||||||||||||||||||||
||||||||||||||||---|||||||||||||||||---|||||||||--|||||||||||||||||||||||||--||||||||||||--||||||||---|||||||||--|||||||||XXXXX---XXXXX|||||||||||||||||||||||||||||||||||||||||||||||||||||||||||||||||
