HEIGHT=16;WIDTH=201;THEME=0;OVERRIDE=false
--------------------------------------------------------------------------------------------------------------------------------------------------------------------------------------------------------
--------------------------------------------------------------------------------------------------------------------------------------------------------------------------------------------------------
--------------------------------------------------------------------------------------------------------------------------------------------------------------------------------------------------------
--------------------------------------------------------------------------------------------------------------------------------------------------------------------------------------------------------
--------------------------------------------------------------------------------------------------------------------------------------------------------------------------------------------------------
--------------------------------------------------------------------------------------------------------------------------------------------------------------------------------------------------------
--------------------------------------------------------------------------------------------------------------------------------------------------------------------------------------------------------
--------------------------------------------------------------------------------------------------------------------------------------------------------------------------------------------------------
------------------------------------------------k-------------------------------------------------------------------------------------------------------------------------------------------------------
---------------------------------------------%%%%%%-----------------------------------------------------------------------------------------------------------------------------------------------------
---------------------------------------------||||||---------------------------------------#---#--------------------------------#--#---------------------------------------------------------------------
---------------------------------------------||||k|-------------------------------r------##---##------------------------------##--##--------------------------------------------------------------------
----------%%%%%%%%%%---%%%%%--%%---r------%%%%%%%%%%%%------------------------%%%%%%%%--###---###----------------------------###--###-------------------------------------------------------------------
----------||||||||||---|||||--||%%%%%%----||||||||||||------%%%%--------------||||||||%%%%%---%%%%%------------------------%%%%%--%%%%%%%%%%%%%%%%%%%%F%%%%%%%%%%%%%%%%%%%%%%%%%%%%%%%%%%%%%%%%%%%%%%%%%
%%%%%%%%%%||||||||||---|||||--||||||||----||||||||||||------||||--------------|||||||||||||---|||||------------------------|||||--||||||||||||||||||||%|||||||||||||||||||||||||||||||||||||||||||||||||
||||||||||||||||||||---|||||--||||||||XXXX||||||||||||XX--XX||||XXXXX--XXXXXXX|||||||||||||---|||||XXXXX--XXXXXXXXXX--XXXXX|||||--||||||||||||||||||||||||||||||||||||||||||||||||||||||||||||||||||||||
