HEIGHT=16;WIDTH=201;THEME=0;OVERRIDE=false
--------------------------------------------------------------------------------------------------------------------------------------------------------------------------------------------------------
--------------------------------------------------------------------------------------------------------------------------------------------------------------------------------------------------------
--------------------------------------------------------------------------------------------------------------------------------------------------------------------------------------------------------
--------------------------------------------------------------------------------------------------------------------------------------------------------------------------------------------------------
--------------------------------------------------------------------------------------------------------------------------------------------------------------------------------------------------------
--------------------------------------------------------------------------------------------------------------------------------------------------------------------------------------------------------
--------------------------------------------------------------------------------------------------------------------------------------------------------------------------------------------------------
--------------------------------------------------------------------------------------------------------------------------------------------------------------------------------------------------------
---------------------------------------------------------------------------------------------------------S2S2-------------------------------------------------------------------------------------------
--------------------------------------------------------------------------------------------------------------------------------------------------------------------------------------------------------
--------------------------------------------------------------------------------------------------------------------------------------------------------------------------------------------------------
----------------------------------------------------------------------------------------------------------Y-r-------------CSSC--------------------------------------------------------------------------
----------------------------------------------------------------------------------------%%%%%%%%%-------%%%%%%%--------------------------%%%%%%%%F%%%%%%%%%%%%%%%%%%%%%%%%%%%%%%%%%%%%%%%%%%%%%%%%%%%%%%
--------------------------Tt-----#---#---------%%%---%%%--------------------------------|||||||||-------||||||yr-------------------------||||||||%||||||||||||||||||||||||||||||||||||||||||||||||||||||
-------------%%%%%--%%%%%-tt----##---##--------|||---|||%%%%%--%%%%%%%---%%%%%%%%%--%%%%|||||||||------%%%%%%%%%%%%%%%%-ky---------------|||||||||||||||||||||||||||||||||||||||||||||||||||||||||||||||
XXXXXXXXXXXXX|||||--|||||XXXXXXXXX---XXXXXX--XX|||---||||||||--|||||||---|||||||||--|||||||||||||XX--XX||||||||||||||||XXXXXXXXXXXXX--XXX|||||||||||||||||||||||||||||||||||||||||||||||||||||||||||||||
