HEIGHT=16;WIDTH=201;THEME=0;OVERRIDE=false
--------------------------------------------------------------------------------------------------------------------------------------------------------------------------------------------------------
--------------------------------------------------------------------------------------------------------------------------------------------------------------------------------------------------------
--------------------------------------------------------------------------------------------------------------------------------------------------------------------------------------------------------
--------------------------------------------------------------------------------------------------------------------------------------------------------------------------------------------------------
--------------------------------------------------------------------------------------------------------------------------------------------------------------------------------------------------------
--------------------------------------------------------------------------------------------------------------------------------------------------------------------------------------------------------
--------------------------------------------------------------------------------------------------------------------------------------------------------------------------------------------------------
--------------------------------------------------------------------------------------------------------------------------------------------------------------------------------------------------------
--------------------------------------------------------------------------------------------------------------------------------------------------------------------------------------------------------
-----------------------------------------------------------------------------------------------------------tt-------------------------------------------------------------------------------------------
-----------------------------------------------------------------------------#--#--------------------------tt-------------------------------------------------------------------------------------------
--------------------#--#----------------------------------------------------##--##-------------------------tt------------------ky-----------------------------------------------------------------------
------------------%%%--%%%--------------%%---%%------y--------------------%%%%--%%%%%%%%%--%%%%%-----%%%%%%%%%%%%%%%---%%%----%%%%%%------------%%%%%%%%F%%%%%%%%%%%%%%%%%%%%%%%%%%%%%%%%%%%%%%%%%%%%%%%
%%%%%%%%%%%%%%%%%%|||--|||---#--#-------||---||----%%%%%------------------||||--|||||||||--|||||%%%%%|||||||||||||||---|||----||||||------------||||||||%|||||||||||||||||||||||||||||||||||||||||||||||
|||||||||||||||||||||--|||--##--##------||---||----|g|||--k--K---%%%---%%%||||--|||||||||--|||||||||||||||||||||||||---|||%%%%%%%%%%%%%%%%--%%%%||||||||||||||||||||||||||||||||||||||||||||||||||||||||
|||||||||||||||||||||--|||XXXX--XXXXXXXX||---||XXXXXXXXXXXXXXXXXX|||---|||||||--|||||||||--|||||||||||||||||||||||||---|||||||||||||||||||--||||||||||||||||||||||||||||||||||||||||||||||||||||||||||||
