HEIGHT=16;WIDTH=201;THEME=0;OVERRIDE=false
--------------------------------------------------------------------------------------------------------------------------------------------------------------------------------------------------------
--------------------------------------------------------------------------------------------------------------------------------------------------------------------------------------------------------
--------------------------------------------------------------------------------------------------------------------------------------------------------------------------------------------------------
--------------------------------------------------------------------------------------------------------------------------------------------------------------------------------------------------------
--------------------------------------------------------------------------------------------------------------------------------------------------------------------------------------------------------
--------------------------------------------------------------------------------------------------------------------------------------------------------------------------------------------------------
--------------------------------------------------------------------------------------------------------------------------------------------------------------------------------------------------------
--------------------------------------------------------------------------------------------------------------------------------------------------------------------------------------------------------
-----------------------------SCS------------------------------------------------------------------------------------------------------------------------------------------------------------------------
--------------------------------------------------------------------------------------------------------------------------------------------------------------------------------------------------------
--------------------------------------------------------------------------------------------------------------------------------------------------------------------------------------------------------
------------------------------gy----------#---#-----------------------------------------------------------------------------#---#-----------------------------------------------------------------------
%%%%%%%%%%----------------%%%%%%---------##---##-------------%%%%%---%%%%%-------%%%%%---%%%%%--------------#--#----------%%%---%%%%%%%%--%%%%%---------------------------------------------------------
||||||||||%%---%%%%%%%%---||||||-------%%%%---%%%%-tt---tt---|||||---|||||%%---%%|||||---|||||-----%%%%%---##--##---------|||---||||||||--|||||---------------------------------------------------------
||||||||||||---||||||||---|||r||-------||||---||||-tt---tt---|||||---|||||||---|||||||---|||||%%%%%|||||--###--###--%%%%%%|||---||||||||--|||||---------------------------------------------------------
||||||||||||---||||||||XXXXXXXXXXXXXXXX||||---||||XXXXXXXXXXX|||||---|||||||---|||||||---|||||||||||||||XXXXX--XXXXX|||||||||---||||||||--|||||XXXXXXXXFXXXXXXXXXXXXXXXXXXXXXXXXXXXXXXXXXXXXXXXXXXXXXXXX
