HEIGHT=16;WIDTH=201;THEME=0;OVERRIDE=false
--------------------------------------------------------------------------------------------------------------------------------------------------------------------------------------------------------
--------------------------------------------------------------------------------------------------------------------------------------------------------------------------------------------------------
--------------------------------------------------------------------------------------------------------------------------------------------------------------------------------------------------------
--------------------------------------------------------------------------------------------------------------------------------------------------------------------------------------------------------
--------------------------------------------------------------------------------------------------------------------------------------------------------------------------------------------------------
--------------------------------------------------------------------------------------------------------------------------------------------------------------------------------------------------------
--------------------------------------------------------------------------------------------------------------------------------------------------------------------------------------------------------
----------------------------------------------------------------------------%%%%%%----------------------------------------------------------------------------------------------------------------------
----------------------------------------------------------------------------||||||---------------------CS22CC-------------------------------------------------------------------------------------------
----------------------------------------------------------------------------||||||----------------------------------------------------------------------------------------------------------------------
----------------------------------------------------------------------------|||%%%%%---------------------------------------------------Tt---------------------------------------------------------------
---------------------------------------------------------------------------y||||||||-----------2SSS------g--k------#---#------------Tt-tt-tt------------------------------------------------------------
-----------------------------------------%%%--%%%---------------%%%%--%%%%%%%%%%%%%%%%---------------%%%%%%%%%%---##---##-----------tt-tt-tt------------------------------------------------------------
-----------------------------------------|||--|||-------%%%--%%%||||--||||||||||||||||---------------||||||||||--###---###--%%%%%%%%%%%%%%%%%%%%%%%%%%F%%%%%%%%%%%%%%%%%%%%%%%%%%%%%%%%%%%%%%%%%%%%%%%%%
-----------%%%%%---%%%%%-----------------|||--|||-------|||--|||||||--||||||||||||||||-------------k-||||||||||%%%%%---%%%%%||||||||||||||||||||||||||%|||||||||||||||||||||||||||||||||||||||||||||||||
XXXXXXXXXXX|||||---|||||XXX--XXXXXX---XXX|||--|||XX---XX|||--|||||||--||||||||||||||||XX---XXXXXXXXXX|||||||||||||||---|||||||||||||||||||||||||||||||||||||||||||||||||||||||||||||||||||||||||||||||||
