HEIGHT=16;WIDTH=201;THEME=0;OVERRIDE=false
--------------------------------------------------------------------------------------------------------------------------------------------------------------------------------------------------------
--------------------------------------------------------------------------------------------------------------------------------------------------------------------------------------------------------
--------------------------------------------------------------------------------------------------------------------------------------------------------------------------------------------------------
--------------------------------------------------------------------------------------------------------------------------------------------------------------------------------------------------------
--------------------------------------------------------------------------------------------------------------------------------------------------------------------------------------------------------
--------------------------------------------------------------------------------------------------------------------------------------------------------------------------------------------------------
-------------------k-g----------------------------------------------------------------------------------------------------------------------------------------------------------------------------------
-------------------%%%%---------------------------------------------------------------------------------------------------------------------------------------------------------------------------------
-------------------||||---------------------------------------------------------------------------------------------------------------------------------------------------------------------------------
-------------------|r||------------------------------------------------------2SS------------------------------------------------------------------------------------------------------------------------
---------------%%%%%%%|---------------------------------------------------------------------------------------------------------------------------------------------------------------------------------
---------------||||||||-------------------------------%%%%%%%-----------------------------------#--#----------------------------------------------------------------------------------------------------
---------------|||k||||---------------------------%%%-|g|||||------#--#-----g------------------##--##-----------------#--#------------------------------------------------------------------------------
%%%%%%%%%%%%%%%%%%%%%%%%%%%%--%%---%%--%%---------|||%%%%%%%%%%%--##--##--%%%%%%%%%%--#---#--%%%%--%%%%%%%%---%%%%---##--##----------------%%%%%%%%F%%%%%%%%%%%%%%%%%%%%%%%%%%%%%%%%%%%%%%%%%%%%%%%%%%%%
||||||||||||||||||||||||||||--||%%%||--||%%%---%%%||||||||||||||%%%%--%%%%||||||||||%%%---%%%||||--||||||||---||||--###--###---------------||||||||%||||||||||||||||||||||||||||||||||||||||||||||||||||
||||||||||||||||||||||||||||--|||||||--|||||---|||||||||||||||||||||--|||||||||||||||||---|||||||--||||||||---||||XXXXX--XXXXXXXXXX---XXXXX|||||||||||||||||||||||||||||||||||||||||||||||||||||||||||||
