HEIGHT=16;WIDTH=201;THEME=0;OVERRIDE=false
--------------------------------------------------------------------------------------------------------------------------------------------------------------------------------------------------------
--------------------------------------------------------------------------------------------------------------------------------------------------------------------------------------------------------
--------------------------------------------------------------------------------------------------------------------------------------------------------------------------------------------------------
--------------------------------------------------------------------------------------------------------------------------------------------------------------------------------------------------------
--------------------------------------------------------------------------------------------------------------------------------------------------------------------------------------------------------
-------------------------------------------------------------------------------------------------------------%%%%%--------------------------------------------------------------------------------------
-------------------------------------------------------------------------------------------------------------|||||--------------------------------------------------------------------------------------
-------------------------------------------------------------------------------------------------------------|||||--------------------------------------------------------------------------------------
----------------------------------------------------------------------------------------------------------K--|||||--------------------------------------------------------------------------------------
------------------------------------------------------------------------------%%%%------------------------%%%%%%||--------------------------------------------------------------------------------------
------------------------------------------------------------------------------||||------------------------||||||||--------------------------------------------------------------------------------------
-----------------------------------------------------#--#---------------------||%%%%----%%%%%-------------||||||||--------------------------------------------------------------------------------------
%%%%%%%%%%%%%---------------------------------------##--##--------------------||||||r---|||||-------------||||||||---------------#---#------------------------------------------------------------------
|||||||||||||-------%%%%---------%%--%%------------###--###-----------------%%%%%%%%%%%-|||||-y--------%%%%%%%%%%%%%%%%%--%%%%--##---##-----------------------------------------------------------------
|||||||||||||-------||||%%%---%%%||--||----------%%%%%--%%%%%-----------%%%%|||||||||||%%%%%%%%%%%%%%%%|||||||||||||||||--||||%%%%---%%%%---------------------------------------------------------------
|||||||||||||XX---XX|||||||---|||||--||XXXX--XXXX|||||--|||||XXXX---XXXX||||||||||||||||||||||||||||||||||||||||||||||||--||||||||---||||XXXXXXXXFXXXXXXXXXXXXXXXXXXXXXXXXXXXXXXXXXXXXXXXXXXXXXXXXXXXXXX
