HEIGHT=16;WIDTH=201;THEME=0;OVERRIDE=false
--------------------------------------------------------------------------------------------------------------------------------------------------------------------------------------------------------
--------------------------------------------------------------------------------------------------------------------------------------------------------------------------------------------------------
--------------------------------------------------------------------------------------------------------------------------------------------------------------------------------------------------------
--------------------------------------------------------------------------------------------------------------------------------------------------------------------------------------------------------
--------------------------------------------------------------------------------------------------------------------------------------------------------------------------------------------------------
--------------------------------------------------------------------------------------------------------------------------------------------------------------------------------------------------------
---------------------------------------------------------------------------------------------2SSSS------------------------------------------------------------------------------------------------------
--------------------------------------------------------------------------------------------------------------------------------------------------------------------------------------------------------
--------------------------------------------------------------------------------------------------------------------------------------------------------------------------------------------------------
---------------------------------------------------------------------------------tt--------K-yg---------------------------------------------------------------------------------------------------------
---------------------------------------------------------------------------------tt---tt---%%%%%%%-------------tt-tt------------------------------------------------------------------------------------
----------------------------------------------SSS2-------------------------------tt---tt---|||||||-------------tt-tt------------------------------------------------------------------------------------
-----------%%--%%%%%%%---%%%%%%%%--%%%-------------------------#--#----------%%%%%%%%%%%%%-|||||||-------------tt-tt-%%%%--%%%%-----------%%%%%%%%F%%%%%%%%%%%%%%%%%%%%%%%%%%%%%%%%%%%%%%%%%%%%%%%%%%%%%
-----------||--|||||||---||||||||--|||-----------------------%%%--%%%--------|||||||||||||-||||||g-----------%%%%%%%%||||--||||-----------||||||||%|||||||||||||||||||||||||||||||||||||||||||||||||||||
-----------||--|||||||---||||||||--|||----------------#---#--|||--|||--------|||||||||||||%%%%%%%%%%%%%---%%%||||||||||||--||||%%%%---%%%%||||||||||||||||||||||||||||||||||||||||||||||||||||||||||||||
XXXXXXXXXXX||--|||||||---||||||||--|||XX---XXXXXXXXXXXX---XXX|||--|||XXXXXXXX||||||||||||||||||||||||||---|||||||||||||||--||||||||---||||||||||||||||||||||||||||||||||||||||||||||||||||||||||||||||||
