HEIGHT=16;WIDTH=201;THEME=0;OVERRIDE=false
--------------------------------------------------------------------------------------------------------------------------------------------------------------------------------------------------------
--------------------------------------------------------------------------------------------------------------------------------------------------------------------------------------------------------
--------------------------------------------------------------------------------------------------------------------------------------------------------------------------------------------------------
--------------------------------------------------------------------------------------------------------------------------------------------------------------------------------------------------------
--------------------------------------------------------------------------------------------------------------------------------------------------------------------------------------------------------
--------------------------------------------------------------------------------------------------------------------------------------------------------------------------------------------------------
--------------------------------------------------------------------------------------------------------------------------------------------------------------------------------------------------------
--------------------------------------------------------------------------------------------------------------------------------------------------------------------------------------------------------
--------------------------------------------------------------------------------------------------------------------------------------------------------------------------------------------------------
-----------------------------------------------------------------------------------------------SSSC-------y---------------------------------------------------------------------------------------------
-------------------------------------------------------------------------------------------------------%%%%%%-------------------------------------------------------------------------------------------
--------------tt----------------------------CSSSSS-----------------------------------------------------|r||yk-------------------------------------------------------------------------------------------
%%%%%%%%%%%%%-tt---tt-------------%%%%--%%------------------------------------------------------k-----%%%%%%%%%%%%-------------------------%%%%%%%%F%%%%%%%%%%%%%%%%%%%%%%%%%%%%%%%%%%%%%%%%%%%%%%%%%%%%
|||||||||||||-tt---tt-------------||||--||--------------------------------%%%%%%%--%%%%--%%%%%%%%%%%%%||||||||||||-----------%%%%----------||||||||%||||||||||||||||||||||||||||||||||||||||||||||||||||
|||||||||||||%%%%%%%%%------------||||--||----k---------------------------||y||||--||||--|||||||||||||||||||||||||%%%%---%%%%||||%%%%--%%%%|||||||||||||||||||||||||||||||||||||||||||||||||||||||||||||
||||||||||||||||||||||XXXXX--XXXXX||||--||XXXXXXXXXXXXXX--XXXXXXXXX--XXXXXXXXXXXXXX||||--|||||||||||||||||||||||||||||---||||||||||||--|||||||||||||||||||||||||||||||||||||||||||||||||||||||||||||||||
