HEIGHT=16;WIDTH=201;THEME=0;OVERRIDE=false
--------------------------------------------------------------------------------------------------------------------------------------------------------------------------------------------------------
--------------------------------------------------------------------------------------------------------------------------------------------------------------------------------------------------------
--------------------------------------------------------------------------------------------------------------------------------------------------------------------------------------------------------
--------------------------------------------------------------------------------------------------------------------------------------------------------------------------------------------------------
--------------------------------------------------------------------------------------------------------------------------------------------------------------------------------------------------------
--------------------------------------------------------------------------------------------------------------------------------------------------------------------------------------------------------
--------------------------------------------------------------------------------------------------------------------------------------------------------------------------------------------------------
--------------------------------------------------------------------------------------------------------------------------------------------------------------------------------------------------------
-------------------------------------------------------------------------------------------------------------------------------------SUSSS--------------------------------------------------------------
--------------------------------------------------------------------------------------------------------------------------------------------------------------------------------------------------------
--------------------------------------------------------------------------------------------------------------------------------------------------------------------------------------------------------
--------------------------------------------------------------------------------------------------------------------------------------------------------------------------------------------------------
%%%%%%%%%%%%---#---#------------------------%%%%%%%%%%%%-----------------------------------------------------------%%%%---%%%%%%--%%%%%%%%%%%-----------------------------------------------------------
||||||||||||--##---##---------%%%%%---------||||||||||||------------------------------------%%---------%%--%%------||||---||||||--|||||||||||-----------------------------------------------------------
||||||||||||%%%%---%%%%%%---%%|||||---------||||||||||||-------------%%%%---%%%%%%%%%--%%%%%||---------||--||%%%%%%||||---||||||--|||||||||||-----------------------------------------------------------
||||||||||||||||---||||||---|||||||XXX---XXX||||||||||||XXXXX---XXXXX||||---|||||||||--|||||||XXX---XXX||--||||||||||||---||||||--|||||||||||XXXXXXXXFXXXXXXXXXXXXXXXXXXXXXXXXXXXXXXXXXXXXXXXXXXXXXXXXXX
