HEIGHT=16;WIDTH=201;THEME=0;OVERRIDE=false
--------------------------------------------------------------------------------------------------------------------------------------------------------------------------------------------------------
--------------------------------------------------------------------------------------------------------------------------------------------------------------------------------------------------------
--------------------------------------------------------------------------------------------------------------------------------------------------------------------------------------------------------
--------------------------------------------------------------------------------------------------------------------------------------------------------------------------------------------------------
--------------------------------------------------------------------------------------------------------------------------------------------------------------------------------------------------------
--------------------------------------------------------------------------------------------------------------------------------------------------------------------------------------------------------
---------------------------------------------------------------------------------------------------------------------------%%%%-------------------------------------------------------------------------
---------------------------------------------------------------------------------------------------------------------------||||-------------------------------------------------------------------------
------------------------------------------------------------------------------------------------------------------------%%%%%%|-------------------------------------------------------------------------
-----------------------------------------------SCC2SSS------------------------------------------------------------------|||||||-------------------------------------------------------------------------
------------------------------------------------------------------------------------------------------------------------|||||||-------------------------------------------------------------------------
--------------------g---------------------------------------rg----------------------------------------------------------|||||||---%%%%%-----------------------------------------------------------------
-----------------%%%%----------#---#---------------y-----%%%%%%%%----------------------%%%%%%%%%%---------------#--#----||||k||---|||||-----------------------------------------------------------------
-----------------||||---------##---##---------%%%%%%%%%%%||||||||--#---#--%%%%%---%%%%%||||||||||--------------##--##--%%%%%%%%%%%%%%%%%%%--------------------------------------------------------------
%%%%%%%%%%%%%%%%%%%%%%%%%%%--###---###--------|||||||||||||||||||%%%---%%%|||||---|||||||||||||||------------%%%%--%%%%|||||||||||||||||||--------------------------------------------------------------
|||||||||||||||||||||||||||XXXXX---XXXXXXX--XX||||||||||||||||||||||---||||||||---|||||||||||||||XXXXX--XXXXX||||--|||||||||||||||||||||||XXXXXXXXFXXXXXXXXXXXXXXXXXXXXXXXXXXXXXXXXXXXXXXXXXXXXXXXXXXXXX
