HEIGHT=16;WIDTH=201;THEME=0;OVERRIDE=false
--------------------------------------------------------------------------------------------------------------------------------------------------------------------------------------------------------
--------------------------------------------------------------------------------------------------------------------------------------------------------------------------------------------------------
--------------------------------------------------------------------------------------------------------------------------------------------------------------------------------------------------------
--------------------------------------------------------------------------------------------------------------------------------------------------------------------------------------------------------
--------------------------------------------------------------------------------------------------------------------------------------------------------------------------------------------------------
--------------------------------------------------------------------------------------------------------------------------------------------------------------------------------------------------------
--------------------------------------------------------------------------------------------------------------------------------------------------------------------------------------------------------
--------------------------------------------------------------------------------------------------------------------------------------------------------------------------------------------------------
--------------------------------------------------------------------------------------------------------------------------------------------------------------------------------------------------------
--------------------------------------------------------------------------------------------------------------------------------------------------------------------------------------------------------
-----------------------------------------------------------------Tt---------S2C-------------------------------------------------------------------------------------------------------------------------
-----------------------------------------------------------------tt--tt-----------------------------------------------------SCCS2S----------------------------------------------------------------------
%%%%%%%%%%%%-----------------------------------------------------tt--tt-------------------------------------------------------------%%%%%---------------------------------------------------------------
||||||||||||%%%%--%%%%-------------------%%--%%%%%---%%%--------%%%%%%%%-----g------------------------------------------------------|||||---------------------------------------------------------------
||||||||||||||||--||||-------------------||--|||||---|||--------||||||||%%%%%%%%%%%%%--%%%-------------------%%%%%---%%%%%-r--------|||||%%%%%%%%F%%%%%%%%%%%%%%%%%%%%%%%%%%%%%%%%%%%%%%%%%%%%%%%%%%%%%%
||||||||||||||||--||||XX--XXXXXXX---XXXXX||--|||||---|||XXX--XXX|||||||||||||||||||||--|||XXXX--XXXXXXX---XXX|||||---|||||XXXXXXXXXX|||||||||||||X||||||||||||||||||||||||||||||||||||||||||||||||||||||
