HEIGHT=16;WIDTH=201;THEME=0;OVERRIDE=false
--------------------------------------------------------------------------------------------------------------------------------------------------------------------------------------------------------
--------------------------------------------------------------------------------------------------------------------------------------------------------------------------------------------------------
--------------------------------------------------------------------------------------------------------------------------------------------------------------------------------------------------------
--------------------------------------------------------------------------------------------------------------------------------------------------------------------------------------------------------
--------------------------------------------------------------------------------------------------------------------------------------------------------------------------------------------------------
--------------------------------------------------------------------------------------------------------------------------------------------------------------------------------------------------------
--------------------------------------------------------------------------------------------------------------------------------------------------------------------------------------------------------
--------------------------------------------------------------------------------------------------------------------------------------------------------------------------------------------------------
--------------------------------------------------------------------------------------------------------------------------------------------------------------------------------------------------------
-----------------------------------------------------------------------------------------------------------#---#----------------------------------------------------------------------------------------
-------------UCC------------------------------------------------------------------------------------------##---##---------------------------------------------------------------------------------------
---------------------------------------------------------------------------------------------------------###---###------------------k-------------------------------------------------------------------
-------------------------------%%%%%--%%%%%%%--%%%%--%%-------------%%---%%--------------------%%%--%%%%%%%%---%%%%%------------%%%%%%------------------------------------------------------------------
-------------------------------|||||--|||||||--||||--||%%%%%---%%%%%||---||--------%%%%%--%%%%%|||--||||||||---|||||------------||||||--%%%%%%%%F%%%%%%%%%%%%%%%%%%%%%%%%%%%%%%%%%%%%%%%%%%%%%%%%%%%%%%%
----------%%%%%%%%%%-----------|||||--|||||||--||||--|||||||---|||||||---||--------|||||--||||||||--||||||||---|||||%%%--%%%---r||g|||r-||||||||%|||||||||||||||||||||||||||||||||||||||||||||||||||||||
XXXXXXXXXX||||||||||XXXX---XXXX|||||--|||||||--||||--|||||||---|||||||---||XXX--XXX|||||--||||||||--||||||||---||||||||--|||XXXXXXXXXXXX||||||||||||||||||||||||||||||||||||||||||||||||||||||||||||||||
