HEIGHT=16;WIDTH=201;THEME=0;OVERRIDE=false
--------------------------------------------------------------------------------------------------------------------------------------------------------------------------------------------------------
--------------------------------------------------------------------------------------------------------------------------------------------------------------------------------------------------------
--------------------------------------------------------------------------------------------------------------------------------------------------------------------------------------------------------
--------------------------------------------------------------------------------------------------------------------------------------------------------------------------------------------------------
-------------------------------------------------------------------------------------------------SS2SC--------------------------------------------------------------------------------------------------
--------------------------------------------------------------------------------------------------------------------------------------------------------------------------------------------------------
--------------------------------------------------------------------------------------------------------------------------------------------------------------------------------------------------------
-------------------------------------------------------------------------------------------------g------------------------------------------------------------------------------------------------------
-------------------------------------------------------------------------------------------------%%%%%%-------------------------------------------------------------------------------------------------
------------------------------------------------------------------------------------------r------||||||-------------------------------------------------------------------------------------------------
----------------------------------------------------------------------------------------%%%------||||||-------------------------------------------------------------------------------------------------
---------------------------------------------------------#---#--------------------------|g|------||||||----------------------%%%%-----------------------------------------------------------------------
-----------%%%--%%%-------------------------------------##---##---------------%%%%%%%%%%%%%%%%%%%%%%%%%%%%%%%%%--------------||||-----------------------------------------------------------------------
-----------|||--|||-------------%%---%%----------------###---###--------------|||||||||||||||||||||||||||||||||--------------||||--%%---%%--------------------------------------------------------------
-----------|||--|||-------------||---||%%--%%%%%--%%%%%%%%---%%%%%%%%%%--%%%%%|||||||||||||||||||||||||||||||||-------------r||gk--||---||%%%%%%%%F%%%%%%%%%%%%%%%%%%%%%%%%%%%%%%%%%%%%%%%%%%%%%%%%%%%%%
XXXXXXXXXXX|||--|||XXXXX---XXXXX||---||||--|||||--||||||||---||||||||||--||||||||||||||||||||||||||||||||||||||XXXX--XXXXXXXXXXXXXX||---||||||||||X|||||||||||||||||||||||||||||||||||||||||||||||||||||
