HEIGHT=16;WIDTH=201;THEME=0;OVERRIDE=false
--------------------------------------------------------------------------------------------------------------------------------------------------------------------------------------------------------
--------------------------------------------------------------------------------------------------------------------------------------------------------------------------------------------------------
--------------------------------------------------------------------------------------------------------------------------------------------------------------------------------------------------------
--------------------------------------------------------------------------------------------------------------------------------------------------------------------------------------------------------
--------------------------------------------------------------------------------------------------------------------------------------------------------------------------------------------------------
---------------------------------------------------------------------------------------------------------------------r---r------------------------------------------------------------------------------
---------------------------------------------------------------------------------------------------------y-----------%%%%%%-----------------------------------------------------------------------------
--------------------------------------------------------------------------------------------------------%%%----------|||||gr----------------------------------------------------------------------------
-------------------------------------------UC2-S--------------------------------------------------------|||----------|||||%%%%%-------------------------------------------------------------------------
-----------------------------------------------------------------------------------%%%%%----------------|||--r-------||||||||||-------------------------------------------------------------------------
----------------------------------------------%---------------CSS------------------|||||----USCSCC------||%%%%%---%%%%%||||||||-------------------------------------------------------------------------
-------------------------------------------k--|--K---------------------------------|||||----------------|||||||---|||||||||||||-------------------------------------------------------------------------
-------------------------#---#-----------%%%%%%%%%%%-------------------------g-----|||||-------------%%%%%%%%%%%%-g||||||||y|||-------------------------------------------------------------------------
-----------------------%%%---%%%---------|||||||||||%%--%%--------------%%%%%%%%%%%%%%%%%%----k------||||||||||||%%%%%%%%%%%%%%%%%----------------------------------------------------------------------
%%%%%%%%%%%%%%%%%--%%%%|||---|||--#---#--|||||||||||||--||%%%%%%%%%%----||||||||||||||||||%%%%%%%%%%%|||||||||||||||||||||||||||||----------------------------------------------------------------------
|||||||||||||||||--|||||||---|||XXX---XXX|||||||||||||--||||||||||||XXXX||||||||||||||||||||||||||||||||||||||||||||||||||||||||||XX---XXXXXXXXXXFXXXXXXXXXXXXXXXXXXXXXXXXXXXXXXXXXXXXXXXXXXXXXXXXXXXXXX
