HEIGHT=16;WIDTH=201;THEME=0;OVERRIDE=false
--------------------------------------------------------------------------------------------------------------------------------------------------------------------------------------------------------
--------------------------------------------------------------------------------------------------------------------------------------------------------------------------------------------------------
--------------------------------------------------------------------------------------------------------------------------------------------------------------------------------------------------------
--------------------------------------------------------------------------------------------------------------------------------------------------------------------------------------------------------
--------------------------------------------------------------------------------------------------------------------------------------------------------------------------------------------------------
--------------------------------------------------------------------------------------------------------------------------------------------------------------------------------------------------------
--------------------------------------------------------------------------------------------------------------------------------------------------------------------------------------------------------
--------------------------------------------------------------------------------------------------------------------------------------------------------------------------------------------------------
----------------------------------------------------------------------------------------------------------------------------2SCC2-----------------------------------------------------------------------
--------------------------------------------------------------------------------------------------------------------------------------------------------------------------------------------------------
--------------------------------------------------------------------------------------------------------------------------------------------------------------------------------------------------------
------------------------------------------------------------------------------------------#--#------------------tt---tt---------------#--#--------------------------------------------------------------
-----------%%%---%%%----#--#----%%%%--%%%%--------------%%%%--%%%%%%%%%---------#--#-----##--##-----------------tt---tt-%%%%%%%%%%---##--##---%%%%%%%%F%%%%%%%%%%%%%%%%%%%%%%%%%%%%%%%%%%%%%%%%%%%%%%%%%
-----------|||---|||---##--##---||||--||||-------#---#--||||--|||||||||--------##--##--%%%%--%%%%%%%%---%%%%%%%%%%%%%%%%||||||||||--###--###--||||||||%|||||||||||||||||||||||||||||||||||||||||||||||||
%%%%%%%%%%%|||---|||--###--###--||||--||||-----%%%---%%%||||--|||||||||%%--%%%%%%--%%%%||||--||||||||---||||||||||||||||||||||||||%%%%%--%%%%%||||||||||||||||||||||||||||||||||||||||||||||||||||||||||
||||||||||||||---|||XXXXX--XXXXX||||--||||XXXXX|||---|||||||--|||||||||||--||||||--||||||||--||||||||---|||||||||||||||||||||||||||||||--|||||||||||||||||||||||||||||||||||||||||||||||||||||||||||||||
