HEIGHT=16;WIDTH=201;THEME=0;OVERRIDE=false
--------------------------------------------------------------------------------------------------------------------------------------------------------------------------------------------------------
--------------------------------------------------------------------------------------------------------------------------------------------------------------------------------------------------------
--------------------------------------------------------------------------------------------------------------------------------------------------------------------------------------------------------
--------------------------------------------------------------------------------------------------------------------------------------------------------------------------------------------------------
--------------------------------------------------------------------------------------------------------------------------------------------------------------------------------------------------------
--------------------------------------------------------------------------------------------------------------------------------------------------------------------------------------------------------
--------------------------------------------------------------------------------------------------------------------------------------------------------------------------------------------------------
--------------------------------------------------------------------------------------------------------------------------------------------------------------------------------------------------------
--------------------------------------------------------------------------------------------------------------------------------------------------------------------------------------------------------
-----------------------------------------------------------------------------------------------------------------------tt-------------------------------------------------------------------------------
--------------SCSSS----------------------------------------------------------------------------------------------------tt-------------------------------------------------------------------------------
---------------------------Tt----Tt-----------SSSCSCU------------------------------------------------------r-----------tt-------------------------------------------------------------------------------
---------------------%%----tt----tt---#---#------------------------------------------------#--#--------%%%%%%%%%---%%%%%%%%%%------#---#----------------------------------------------------------------
---------------------||----tt----tt-%%%---%%%----------------#--#---------%%%%%---%%%%%%%%%%--%%%%%%%%%|||||||||%%%||||||||||%%---##---##---------------------------------------------------------------
------------%%%%%%%%%||%%%%%%%%%%%%%|||---|||-----y---r----%%%--%%%%%---%%|||||---||||||||||--|||||||||||||||||||||||||||||||||--###---###--%%%%%%%%F%%%%%%%%%%%%%%%%%%%%%%%%%%%%%%%%%%%%%%%%%%%%%%%%%%%
XXXXXXXXXXXX|||||||||||||||||||||||||||---|||XXXXXXXXXXXXXX|||--|||||---|||||||---||||||||||--|||||||||||||||||||||||||||||||||XXXXX---XXXXX||||||||X|||||||||||||||||||||||||||||||||||||||||||||||||||
