HEIGHT=16;WIDTH=201;THEME=0;OVERRIDE=false
--------------------------------------------------------------------------------------------------------------------------------------------------------------------------------------------------------
--------------------------------------------------------------------------------------------------------------------------------------------------------------------------------------------------------
--------------------------------------------------------------------------------------------------------------------------------------------------------------------------------------------------------
--------------------------------------------------------------------------------------------------------------------------------------------------------------------------------------------------------
--------------------------------------------------------------------------------------------------------------------------------------------------------------------------------------------------------
--------------------------------------------------------------------------------------------------------------------------------------------------------------------------------------------------------
--------------------------------------------------------------------------------------------------------------------------------------------------------------------------------------------------------
--------------------------------------------------------------------------------------------------------------------------------------------------------------------------------------------------------
--------------------------------------------------------------------------------------------------------------------------------------------------------------------------------------------------------
-------------------------------------------------------------------------------UUC2---------------------------------------------------------------------------------------------------------------------
--------------------------------------------SUS2S--------------Tt-------------------------------------------------#--#----------------------------------------------------------------------------------
---------------------------------------------------------------tt------------------------------------------------##--##---------------------------------------------------------------------------------
-------------------------------------------------------------%%%%%---------------------------------------------%%%%--%%%%-------------------------------------------------------------------------------
---------------------------%%%%%--%%%-------------%%%%---%%%%|||||-----------%%%%%%%%-------------%%%%%---%%%%%||||--||||%%---%%-----------%%%%%%%%F%%%%%%%%%%%%%%%%%%%%%%%%%%%%%%%%%%%%%%%%%%%%%%%%%%%%
--------------%%%%%---%%%%%|||||--|||------%%%%%%%||||---|||||||||-----------||||||||-------------|||||---|||||||||--||||||---||-----------||||||||%||||||||||||||||||||||||||||||||||||||||||||||||||||
XXXXXXXXXXXXXX|||||---||||||||||--|||XX--XX|||||||||||---|||||||||XXXX---XXXX||||||||XXXXX---XXXXX|||||---|||||||||--||||||---||XXXXXX---XX|||||||||||||||||||||||||||||||||||||||||||||||||||||||||||||
