HEIGHT=16;WIDTH=201;THEME=0;OVERRIDE=false
--------------------------------------------------------------------------------------------------------------------------------------------------------------------------------------------------------
--------------------------------------------------------------------------------------------------------------------------------------------------------------------------------------------------------
--------------------------------------------------------------------------------------------------------------------------------------------------------------------------------------------------------
--------------------------------------------------------------------------------------------------------------------------------------------------------------------------------------------------------
--------------------------------------------------------------------------------------------------------------------------------------------------------------------------------------------------------
-----------------------------------------------------------------------------------------%%%------------------------------------------------------------------------------------------------------------
-----------------------------------------------------------------------------------------|||------------------------------------------------------------------------------------------------------------
-----------------------------------------------------------------------------------------|||------------------------------------------------------------------------------------------------------------
-----------------------------------------------------------------SSSSS2SU----------------||%%%%---------------------------------------------------------------------------------------------------------
-----------------------------------------------------------------------------------------||||||---------------------------------------------------------------------------------------------------------
-----------------------------------------------------------------------------------------||||||----------------------------2SCSCCS----------------------------------------------------------------------
-------------------------tt--------------------------------------------------------------||||||----------------------------------------Tt---------------------------------------------------------------
%%%%%%%%%%%%%%-----------tt-------------------------------------%%%%%%%%%%%------------%%%%%%%%%%----tt------------%%---%%-------------tt---------------------------------------------------------------
||||||||||||||%%%--%%%---tt-------------------------------%%--%%|||||||||||------------||||||||||----tt-----#--#---||---||------r--%%%%%%%%%%%%%%%%%%%%F%%%%%%%%%%%%%%%%%%%%%%%%%%%%%%%%%%%%%%%%%%%%%%%%
|||||||||||||||||--|||%%%%%%-------------%%%%%--%%%%%-----||--|||||||||||||%%%%%--%%%%%||||||||||----tt----##--##--||---||%%%%%%%%%||||||||||||||||||||%||||||||||||||||||||||||||||||||||||||||||||||||
|||||||||||||||||--|||||||||XXXXX---XXXXX|||||--|||||XXXXX||--||||||||||||||||||--|||||||||||||||XXXXXXXXXXXX--XXXX||---||||||||||||||||||||||||||||||||||||||||||||||||||||||||||||||||||||||||||||||||
