HEIGHT=16;WIDTH=201;THEME=0;OVERRIDE=false
--------------------------------------------------------------------------------------------------------------------------------------------------------------------------------------------------------
--------------------------------------------------------------------------------------------------------------------------------------------------------------------------------------------------------
--------------------------------------------------------------------------------------------------------------------------------------------------------------------------------------------------------
--------------------------------------------------------------------------------------------------------------------------------------------------------------------------------------------------------
--------------------------------------------------------------------------------------------------------------------------------------------------------------------------------------------------------
--------------------------------------------------------------------------------------------------------------------------------------------------------------------------------------------------------
--------------------------------------------------------------------------------------------------------------------------------------------------------------------------------------------------------
--------------------------------------------------------------------------------------------------------------------------------------------------------------------------------------------------------
--------------------------------------------------------------------------------------------------------------------------------------------------------------------------------------------------------
--------------------------------------------------------------------------------------------------------------------------------------------------------------------------------------------------------
-----------------------------------------------------------------------#---#----------------------------------------------------------------------------------------------------------------------------
----------------------------------------------------------------------##---##---------------------------------------------------------#---#-------------------------------------------------------------
-----------------------------------------------------#--#-----------%%%%---%%%%-----#---#-------------%%%--%%%-----------------------##---##--%%%%%%%%F%%%%%%%%%%%%%%%%%%%%%%%%%%%%%%%%%%%%%%%%%%%%%%%%%
----------------------------------------------------##--##---%%---%%||||---||||----##---##---%%%%%----|||--|||---------%%%%%--%%%%%%%%%---%%%%||||||||%|||||||||||||||||||||||||||||||||||||||||||||||||
-------------%%%%---%%%%--#--#---------------------###--###--||---||||||---||||--%%%%---%%%%-|||||----|||--|||---------|||||--|||||||||---||||||||||||||||||||||||||||||||||||||||||||||||||||||||||||||
XXXXXXXXXXXXX||||---||||XXX--XXXXXXX---XXXXXXXXXXXXXXX--XXXXX||---||||||---||||XX||||---||||XXXXXXXXXX|||--|||XXX---XXX|||||--|||||||||---||||||||||||||||||||||||||||||||||||||||||||||||||||||||||||||
