HEIGHT=16;WIDTH=201;THEME=0;OVERRIDE=false
--------------------------------------------------------------------------------------------------------------------------------------------------------------------------------------------------------
--------------------------------------------------------------------------------------------------------------------------------------------------------------------------------------------------------
--------------------------------------------------------------------------------------------------------------------------------------------------------------------------------------------------------
--------------------------------------------------------------------------------------------------------------------------------------------------------------------------------------------------------
--------------------------------------------------------------------------------------------------------------------------------------------------------------------------------------------------------
--------------------------------------------------------------------------------------------------------------------------------------------------------------------------------------------------------
---------------------------------------------------------------------------------------------------------------------g----------------------------------------------------------------------------------
---------------------------------------------------------------------------------------------------------------------%%%%%------------------------------------------------------------------------------
---------------------------------------------------------------------------------------------------------------------|||||------------------------------------------------------------------------------
---------------------------------------------------------------------------------------------------------------------|||||--------------r---------------------------------------------------------------
--------------------------------------------------------------------------------------Tt--tt-----------------------r-|||||-------------%%%%%%%----------------------------------------------------------
-----------------------------#--#-----------------------------------------------------tt--tt--------tt------------%%%%%|||-------------g|y||||r---------------------------------------------------------
%%%%%%%%%%%%%%-------------%%%--%%%---------------------------------%%%%%%------------tt--tt--------tt-Tt--Tt-----||||||||---------%%%%%%%%%%%%%--------------------------------------------------------
||||||||||||||-------------|||--|||--Tt------------%%%%---%%%%%%--%%||||||--------%%%%%%%%%%%%%%----tt-tt--tt--k--||||||||---------|||||||||||||%%%%%%%%F%%%%%%%%%%%%%%%%%%%%%%%%%%%%%%%%%%%%%%%%%%%%%%%
||||||||||||||-------------|||--|||--tt---%%%---%%%||||---||||||--||||||||--#--#--||||||||||||||%%%%%%%%%%%%%%%%%%%%%%%%%%%%%%%%%%%|||||||||||||||||||||%|||||||||||||||||||||||||||||||||||||||||||||||
||||||||||||||XXXXX---XXXXX|||--|||XXXXXXX|||---|||||||---||||||--||||||||XXX--XXX||||||||||||||||||||||||||||||||||||||||||||||||||||||||||||||||||||||||||||||||||||||||||||||||||||||||||||||||||||||
