HEIGHT=16;WIDTH=201;THEME=0;OVERRIDE=false
--------------------------------------------------------------------------------------------------------------------------------------------------------------------------------------------------------
--------------------------------------------------------------------------------------------------------------------------------------------------------------------------------------------------------
--------------------------------------------------------------------------------------------------------------------------------------------------------------------------------------------------------
--------------------------------------------------------------------------------------------------------------------------------------------------------------------------------------------------------
--------------------------------------------------------------------------------------------------------------------------------------------------------------------------------------------------------
--------------------------------------------------------------------------------------------------------------------------------------------------------------------------------------------------------
--------------------------------------------------------------------------------------------------------------------------------------------------------------------------------------------------------
--------------------------------------------------------------------------------------------------------------------------------------------------------------------------------------------------------
--------------------------------------------------------------------------------------------------------------------------------------------------------------------------------------------------------
--------------------------------------------------------------------------------------------------------------------------------------------------------------------------------------------------------
--------------------------------------------------------------------------------------------------------------------------------------------------------------------------------------------------------
-----------------------------------------------------------#---#----------------------------------------------------------------------------------------------------------------------------------------
---------------------%%%%%%----------------------Y-------%%%---%%%-------------%%%--------%%---%%----------------------------------%%-------------------------------------------------------------------
%%%%%%%%%%%----------||||||------------%%---%%---%%%%%---|||---|||-------------|||--#--#--||---||----------------------------------||--#---#------------------------------------------------------------
|||||||||||%%%%%%%%%%||||||------------||---||---|||r|---|||---|||%%--%%%%%%%%%|||%%%--%%%||---||---------%%--%%%%%%%%%------------||%%%---%%%----------------------------------------------------------
|||||||||||||||||||||||||||XXXXX--XXXXX||---||XXXXXXXXXXX|||---|||||--|||||||||||||||--|||||---||XXX---XXX||--|||||||||XXXXX--XXXXX|||||---|||XXXXXXXXFXXXXXXXXXXXXXXXXXXXXXXXXXXXXXXXXXXXXXXXXXXXXXXXXX
