HEIGHT=16;WIDTH=201;THEME=0;OVERRIDE=false
--------------------------------------------------------------------------------------------------------------------------------------------------------------------------------------------------------
--------------------------------------------------------------------------------------------------------------------------------------------------------------------------------------------------------
--------------------------------------------------------------------------------------------------------------------------------------------------------------------------------------------------------
--------------------------------------------------------------------------------------------------------------------------------------------------------------------------------------------------------
--------------------------------------------------------------------------------------------------------------------------------------------------------------------------------------------------------
--------------------------------------------------------------------------------------------------------------------------------------------------------------------------------------------------------
--------------------------------------------------------------------------------------------------------------------------------------------------------------------------------------------------------
--------------------------------------------------------------------------------------------------------------------------------------------------------------------------------------------------------
--------------------------------------------------------------------------------------------------------------------------------------------------------------------------------------------------------
----------------------------------------------------------------------------------------------------------------------------------y---------------------------------------------------------------------
---------------------------------------------------------------------------------------------------------------------------------%%%%-------------------------------------------------------------------
------------------------------------------------------------------------#--#-------#--#------------------------------------------||||-------------------------------------------------------------------
-----------------------------------%%%%%--%%%%%%%%%%%------------------##--##-----##--##-------%%%%---------tt-------------------||||-------------------------------------------------------------------
----------------------------%%---%%|||||--|||||||||||%%%--%%%%%---%%--###--###--%%%%--%%%%---g-||||-----Tt--tt------------%%%%%%%%%%%%%%----------------------------------------------------------------
--------------%%%--%%%------||---|||||||--||||||||||||||--|||||---||%%%%%--%%%%%||||--||||%%%%%%%%%%%%--tt--tt------------||||||||||||||----------------------------------------------------------------
XXXXXXXXXXXXXX|||--|||XXXXXX||---|||||||--||||||||||||||--|||||---|||||||--|||||||||--||||||||||||||||XXXXXXXXXXXXXXXXXXXX||||||||||||||XXXXXXXXFXXXXXXXXXXXXXXXXXXXXXXXXXXXXXXXXXXXXXXXXXXXXXXXXXXXXXXX
