HEIGHT=16;WIDTH=201;THEME=0;OVERRIDE=false
--------------------------------------------------------------------------------------------------------------------------------------------------------------------------------------------------------
--------------------------------------------------------------------------------------------------------------------------------------------------------------------------------------------------------
--------------------------------------------------------------------------------------------------------------------------------------------------------------------------------------------------------
--------------------------------------------------------------------------------------------------------------------------------------------------------------------------------------------------------
--------------------------------------------------------------------------------------------------------------------------------------------------------------------------------------------------------
--------------------------------------------------------------------------------------------------------------------------------------------------------------------------------------------------------
--------------------------------------------------------------------------------------------------------------------------------------------------------------------------------------------------------
--------------------------------------------------------------------------------------------------------------------------------------------------------------------------------------------------------
--------------------------------------------------------------------------------------------------------------------------------------------------------------------------------------------------------
--------------------------Tt-------------------------------SSCU-----------------------------------------------------------------------------------------------------------------------------------------
-----------------------tt-tt--------------------222S----------------------------------------------------------------------------------------------------------------------------------------------------
-----------------------tt-tt----------------------------------------------------------------------------------------------------------------------------------------------------------------------------
----------------------%%%%%%%-------------------------------------------------------------#--#------------------------------------------------------%%%%%%%%F%%%%%%%%%%%%%%%%%%%%%%%%%%%%%%%%%%%%%%%%%%%
%%%%%%%%%%%-----------|||||||---#--#--------------g--k--%%%%%%%%%------------------------##--##------#---#------#--#---%%---%%%%%---%%%%%%%%---%%%%%||||||||%|||||||||||||||||||||||||||||||||||||||||||
|||||||||||-----------|||||||--##--##--------%%%%%%%%%%%|||||||||%%%---%%%%%%%%--%%%%%--###--###----##---##----##--##--||---|||||---||||||||---|||||||||||||||||||||||||||||||||||||||||||||||||||||||||
|||||||||||XXXX---XXXX|||||||XXXX--XXXXXX--XX|||||||||||||||||||||||---||||||||--|||||XXXXX--XXXXXXXXX---XXXXXXXX--XXXX||---|||||---||||||||---|||||||||||||||||||||||||||||||||||||||||||||||||||||||||
