HEIGHT=16;WIDTH=201;THEME=0;OVERRIDE=false
--------------------------------------------------------------------------------------------------------------------------------------------------------------------------------------------------------
--------------------------------------------------------------------------------------------------------------------------------------------------------------------------------------------------------
--------------------------------------------------------------------------------------------------------------------------------------------------------------------------------------------------------
--------------------------------------------------------------------------------------------------------------------------------------------------------------------------------------------------------
--------------------------------------------------------------------------------------------------------------------------------------------------------------------------------------------------------
--------------------------------------------------------------------------------------------------------------------------------------------------------------------------------------------------------
--------------------------------------------------------------------------------------------------------------------------------------------------------------------------------------------------------
--------------------------------------------------------------------------------------------------------------------------------------------------------------------------------------------------------
--------------------------------------------------------------------------------------------------------------------------------------------------------------------------------------------------------
-----------------------------------------------------------k--------------------------------------------------------------------------------------------------------------------------------------------
--------------------------S2C22-----#---#------------------%%%%%%---------------------------------------------------------------------------------------------------------------------------------------
-----------------------------------##---##-----------------||||||-------------------------------------------------SUS2----------------------------------------------------------------------------------
%%%%%%%%%%%%----------------------###---###----------------||||||---------------------------------------------------------------------------------------------------------------------------------------
||||||||||||-----------------g--%%%%%---%%%%%-------%%%%%-y|||||Yy---------%%---%%---------------------#--#---------------------------------------------------------------------------------------------
||||||||||||%%%%%%%--%%%%%%%%%%%|||||---|||||%%---%%|||||%%%%%%%%%%%%------||---||--------------------##--##------r-----%%%%--%%%%%%%%%%--%%%%%%%%%%F%%%%%%%%%%%%%%%%%%%%%%%%%%%%%%%%%%%%%%%%%%%%%%%%%%%
|||||||||||||||||||--||||||||||||||||---|||||||---|||||||||||||||||||XX--XX||---||XXXX--XXXXXXX--XXXXXXX--XXXXXXXXXXXXXX||||--||||||||||--||||||||||X|||||||||||||||||||||||||||||||||||||||||||||||||||
