HEIGHT=16;WIDTH=201;THEME=0;OVERRIDE=false
--------------------------------------------------------------------------------------------------------------------------------------------------------------------------------------------------------
--------------------------------------------------------------------------------------------------------------------------------------------------------------------------------------------------------
--------------------------------------------------------------------------------------------------------------------------------------------------------------------------------------------------------
--------------------------------------------------------------------------------------------------------------------------------------------------------------------------------------------------------
--------------------------------------------------------------------------------------------------------------------------------------------------------------------------------------------------------
--------------------------------------------------------------------------------------------------------------------------------------------------------------------------------------------------------
--------------------------------------------------------------------------------------------------------------------------------------------------------------------------------------------------------
--------------------------------------------------------------------------------------------------------------------------------------------------------------------------------------------------------
--------------------------------------------------------------------------------------------------------------------------------------------------------------------------------------------------------
----------------------------S2SS2CSS--------------------------------------------------------------------------------------------------------------------------------------------------------------------
----------------------Tt--------------------------------------------------------------%%%%--------------------------------------------------------------------------------------------------------------
----------------tt----tt--------------------------------------------------------------||||-------#---#--------------------------------------------------------------------------------------------------
----------------tt----tt---------k------------------------------------------%%%%%-----|||g--r---##---##-------------#--#--------#---#-------------------------------------------------------------------
-------------%%%%%%%%%%%%%%%%%%%%%%%%%%%%%--%%%%%%%--%%%--------------------|||||%%%%%%%%%%%%%%%%%---%%%%----------##--##------##---##------------------------------------------------------------------
-------------|||||||||||||||||||||||||||||--|||||||--|||--------------------||||||||||||||||||||||---||||---------###--###----###---###--%%%%%%%%F%%%%%%%%%%%%%%%%%%%%%%%%%%%%%%%%%%%%%%%%%%%%%%%%%%%%%%
XXXXXXXXXXXXX|||||||||||||||||||||||||||||--|||||||--|||XX---XXXXXXX---XXXXX||||||||||||||||||||||---||||XX---XXXXXXX--XXXXXXXXXX---XXXXX||||||||X||||||||||||||||||||||||||||||||||||||||||||||||||||||
