HEIGHT=16;WIDTH=201;THEME=0;OVERRIDE=false
--------------------------------------------------------------------------------------------------------------------------------------------------------------------------------------------------------
--------------------------------------------------------------------------------------------------------------------------------------------------------------------------------------------------------
--------------------------------------------------------------------------------------------------------------------------------------------------------------------------------------------------------
--------------------------------------------------------------------------------------------------------------------------------------------------------------------------------------------------------
--------------------------------------------------------------------------------------------------------------------------------------------------------------------------------------------------------
--------------------------------------------------------------------------------------------------------------------------------------------------------------------------------------------------------
--------------------------------------------------------------------------------------------------------------------------------------------------------------------------------------------------------
--------------------------------------------------------------------------------------------------------------------------------------------------------------------------------------------------------
------------------------------------------------------------------------------------------------------------------------------------%%%-----------------------------------------------------------------
--------------------------------------------------------------------------SSCC------------------------------------------------------|||-----------------------------------------------------------------
----------------------------------------------------------------------------------------------------------%%%-----------------------|||-----------------------------------------------------------------
--------------------------------------------#---#---------------------------------------------------------|||---------------------y-k|yKr--y-k----------------------------------------------------------
-----------%%%%--%%%%----------------------##---##----------------------------------#---#----%%--%%-------|||----------------%%%%%%%%%%%%%%%%%%%--------------------------------------------------------
-----------||||--||||---------------------###---###-------%%%%--%%%%--%%%%%%%%%%---##---##---||--||%%%%%%%%%%%%%------y-%%%%%|||||||||||||||||||--------------------------------------------------------
%%%%%%%%%%%||||--||||----------%%%---%%%%%%%%---%%%%%-----||||--||||--||||||||||--###---###--||--|||||||||||||||%%%%%%%%||||||||||||||||||||||||--------------------------------------------------------
|||||||||||||||--||||XXXX--XXXX|||---||||||||---|||||XXXXX||||--||||XX||||||||||XXXXX---XXXXX||--|||||||||||||||||||||||||||||||||||||||||||||||XXXXXXXXFXXXXXXXXXXXXXXXXXXXXXXXXXXXXXXXXXXXXXXXXXXXXXXX
