HEIGHT=16;WIDTH=201;THEME=0;OVERRIDE=false
--------------------------------------------------------------------------------------------------------------------------------------------------------------------------------------------------------
--------------------------------------------------------------------------------------------------------------------------------------------------------------------------------------------------------
--------------------------------------------------------------------------------------------------------------------------------------------------------------------------------------------------------
--------------------------------------------------------------------------------------------------------------------------------------------------------------------------------------------------------
--------------------------------------------------------------------------------------------------------------------------------------------------------------------------------------------------------
--------------------------------------------------------------------------------------------------------------------------------------------------------------------------------------------------------
--------------------------------------------------------------------------------------------------------------------------------------------------------------------------------------------------------
--------------------------------------------------------------------------------------------------------------------------------------------------------------------------------------------------------
--------------------------------------------------------------------------------------------------------------------------------------------------------------------------------------------------------
----------------------------------------------------------------------------------------------------#--#--------------------------------CS-C2-----------------------------------------------------------
---------------------------------------------------------------------------------------------------##--##-----------------------------------------------------------------------------------------------
----------------------------------------------------Tt--------------------------------------------###--###--------------------------------%-------------------------------------------------------------
-------------------%%%%%%%--------------------------tt------------------------------------------%%%%%--%%%%%------------------------------|-------------------------------------------------------------
-------------------|||||||------------------------%%%%%%%%%%---%%%%%%---%%%%%%%%---%%%%%--------|||||--|||||--------------------------%%%%%%%%%%--------------------------------------------------------
-------------------|||||||--------%%%%%---%%%%%---||||||||||---||||||---||||||||---|||||--#--#--|||||--|||||------%%---%%%%---%%------||||||||||%%%%%%%%F%%%%%%%%%%%%%%%%%%%%%%%%%%%%%%%%%%%%%%%%%%%%%%%
XXXXXXXXXXXXXXX--XX|||||||XXX--XXX|||||---|||||XXX||||||||||---||||||---||||||||---|||||XXX--XXX|||||--|||||XX--XX||---||||---||XX--XX||||||||||||||||||X|||||||||||||||||||||||||||||||||||||||||||||||
