HEIGHT=16;WIDTH=201;THEME=0;OVERRIDE=false
--------------------------------------------------------------------------------------------------------------------------------------------------------------------------------------------------------
--------------------------------------------------------------------------------------------------------------------------------------------------------------------------------------------------------
--------------------------------------------------------------------------------------------------------------------------------------------------------------------------------------------------------
--------------------------------------------------------------------------------------------------------------------------------------------------------------------------------------------------------
--------------------------------------------------------------------------------------------------------------------------------------------------------------------------------------------------------
--------------------------------------------------------------------------------------------------------------------------------------------------------------------------------------------------------
--------------------------------------------------------------------------------------------------------------------------------------------------------------------------------------------------------
--------------------------------------------------------------------------------------------------------------------------------------------------------------------------------------------------------
--------------------------------------------------------------------------------------------------------------------------------------------------------------------------------------------------------
---------------#---#-------------------tt---------------------------------------------------------------------------------------------------------------------------------------------------------------
--------------##---##------------------tt---------------------------------------------------------------------------------------------------------------------------------------------------------------
-------------###---###-----------------tt--------------------Tt------------------------------------------CSS2-------------------------------------------------------------------------------------------
%%%%%%%%%%%%%%%%---%%%%%-----------%%%%%%%%%---%%------------tt-----------------------------------------------------------------------------------------------------------------------------------------
||||||||||||||||---|||||%%%%%%%%%%%|||||||||---||----------%%%%%%%%----------------#---#----------------------------------------------------------------------------------------------------------------
||||||||||||||||---|||||||||||||||||||||||||---||%%%%--%%%%||||||||%%%%%---%%%%%--##---##--%%%%---%%%%---------r-%%%%%--------%%%%%---%%%%%%%%%%%%%F%%%%%%%%%%%%%%%%%%%%%%%%%%%%%%%%%%%%%%%%%%%%%%%%%%%%
||||||||||||||||---|||||||||||||||||||||||||---||||||--|||||||||||||||||---|||||XXXX---XXXX||||---||||XXXXXXXXXXX|||||XXX--XXX|||||---|||||||||||||X||||||||||||||||||||||||||||||||||||||||||||||||||||
