HEIGHT=16;WIDTH=201;THEME=0;OVERRIDE=false
--------------------------------------------------------------------------------------------------------------------------------------------------------------------------------------------------------
--------------------------------------------------------------------------------------------------------------------------------------------------------------------------------------------------------
--------------------------------------------------------------------------------------------------------------------------------------------------------------------------------------------------------
--------------------------------------------------------------------------------------------------------------------------------------------------------------------------------------------------------
--------------------------------------------------------------------------------------------------------------------------------------------------------------------------------------------------------
--------------------------------------------------------------------------------------------------------------------------------------------------------------------------------------------------------
--------------------------------------------------------------------------------------------------------------------------------------------------------------------------------------------------------
--------------------------------------------------------------------------------------------------------------------------------------------------------------------------------------------------------
----------------------------------------------------------------------------------------------SSCSSU-----S2SC-------------------------------------------------------------------------------------------
-------------------------------------------------------------SCS----------------------------------------------------------------gkk---------------------------------------------------------------------
-------------------------------------------------------------------------------------------------------------------------------%%%%%%%------------------------------------------------------------------
-----------------------------------tt--Tt------------------------------------------------------k-y-----------------------------|||||||------------------------------------------------------------------
-------------------------%%---%%---tt--tt----------%%--%%---ry-Y-----------%%--%%%%%--%%%-----%%%%%%%--%%%%%%%%%---------------|||||||------------------------------------------------------------------
%%%%%%%%%%%%%------%%--%%||---||%%%%%%%%%%%%%%---%%||--||%%%%%%%%----------||--|||||--|||-----|||||||--|||||||||--%%%%%%%%%%---yy|||||--%%%%%%%%F%%%%%%%%%%%%%%%%%%%%%%%%%%%%%%%%%%%%%%%%%%%%%%%%%%%%%%%
|||||||||||||%%--%%||--||||---||||||||||||||||---||||--||||||||||%%%%--%%%%||--|||||--|||-----|||y|||--|||||||||--||||||||||%%%%%%%%%%%%||||||||%|||||||||||||||||||||||||||||||||||||||||||||||||||||||
|||||||||||||||--||||--||||---||||||||||||||||---||||--||||||||||||||--||||||--|||||--|||XXXXXXXXXXXXXX|||||||||XX||||||||||||||||||||||||||||||||||||||||||||||||||||||||||||||||||||||||||||||||||||||
