HEIGHT=16;WIDTH=201;THEME=0;OVERRIDE=false
--------------------------------------------------------------------------------------------------------------------------------------------------------------------------------------------------------
--------------------------------------------------------------------------------------------------------------------------------------------------------------------------------------------------------
--------------------------------------------------------------------------------------------------------------------------------------------------------------------------------------------------------
--------------------------------------------------------------------------------------------------------------------------------------------------------------------------------------------------------
--------------------------------------------------------------------------------------------------------------------------------------------------------------------------------------------------------
--------------------------------------------------------------------------------------------------------------------------------------------------------------------------------------------------------
--------------------------------------------------------------------------------------------------------------------------------------------------------------------------------------------------------
--------------------------------------------------------------------------------------------------------------------------------------------------------------------------------------------------------
--------------------------------------------------------------------------------------------------------------------------------------------------------------------------------------------------------
-----------------------------------------------------------------------------------------------------------------------2CSSCU-------#--#----------------------------------------------------------------
--------------------------------2SSSS2S-----------C-CSS----------------------------------------------------------------------------##--##---------------------------------------------------------------
-----------------------------------------------------------------------------#---#------------------------------------------------###--###--------------------------------------------------------------
%%%%%%%%%%-----------------------------------------%------------------------##---##------------------------------------r--------%%%%%--%%%%%------------------------------------------------------------
||||||||||---------------------gg---r--------------|--r--K-----------tt----###---###------------------%%%%%%%%%--%%%%%%%%%%%%%%%|||||--|||||------------------------------------------------------------
||||||||||------------%%%--%%%%%%%%%%%%%%%%--%%%%%%%%%%%%%%%%---%%---tt--%%%%%---%%%%%--------%%%--%%%|||||||||--||||||||||||||||||||--|||||------------------------------------------------------------
||||||||||XXXXX--XXXXX|||--||||||||||||||||--||||||||||||||||---||XXXXXXX|||||---|||||XXXX--XX|||--||||||||||||--||||||||||||||||||||--|||||XXXXXXXXFXXXXXXXXXXXXXXXXXXXXXXXXXXXXXXXXXXXXXXXXXXXXXXXXXXX
