HEIGHT=16;WIDTH=201;THEME=0;OVERRIDE=false
--------------------------------------------------------------------------------------------------------------------------------------------------------------------------------------------------------
--------------------------------------------------------------------------------------------------------------------------------------------------------------------------------------------------------
--------------------------------------------------------------------------------------------------------------------------------------------------------------------------------------------------------
--------------------------------------------------------------------------------------------------------------------------------------------------------------------------------------------------------
--------------------------------------------------------------------------------------------------------------------------------------------------------------------------------------------------------
--------------------------------------------------------------------------------------------------------------------------------------------------------------------------------------------------------
--------------------------------------------------------------------------------------------------------------------------------------------------------------------------------------------------------
--------------------------------------------------------------------------------------------------------------------------------------------------------------------------------------------------------
--------------------------------------------------------------------------------------------------------------------------------------------------------------------------------------------------------
----------------#--#---------------------------------g--------------------------------------------------------------------------------------------------------------------------------------------------
---------------##--##---------------------------%%%%%%--------------------------------------------------------------------------------------Y-----------------------------------------------------------
--------------###--###--------------------------||||||----------------------------------------------#---#-------------------------------%%%%%%----------------------------------------------------------
------------%%%%%--%%%%%----------------%%---%%-||||||---------------------------------------------##---##--------------------------%%%-||||||----------------------------------------------------------
%%%%%%%%%%%%|||||--|||||----------------||---||%%%%%%%%%%---------------%%---%%%%%%---%%%%%%---%%%%%%---%%%%--------%%%%--%%%%------|||-||||||----%%%%%%%%F%%%%%%%%%%%%%%%%%%%%%%%%%%%%%%%%%%%%%%%%%%%%%
|||||||||||||||||--|||||%%%%--%%%%%%--%%||---||||||||||||%%---%%--#--#--||---||||||---||||||---||||||---||||%%%--%%%||||--||||%%--%%|||-|y||||----||||||||%|||||||||||||||||||||||||||||||||||||||||||||
|||||||||||||||||--|||||||||--||||||--||||---||||||||||||||---||XXX--XXX||---||||||---||||||---||||||---|||||||--|||||||--||||||--|||||XXXXXXXXXXX||||||||||||||||||||||||||||||||||||||||||||||||||||||
