HEIGHT=16;WIDTH=201;THEME=0;OVERRIDE=false
--------------------------------------------------------------------------------------------------------------------------------------------------------------------------------------------------------
--------------------------------------------------------------------------------------------------------------------------------------------------------------------------------------------------------
--------------------------------------------------------------------------------------------------------------------------------------------------------------------------------------------------------
--------------------------------------------------------------------------------------------------------------------------------------------------------------------------------------------------------
--------------------------------------------------------------------------------------------------------------------------------------------------------------------------------------------------------
--------------------------------------------------------------------------------------------------------------------------------------------------------------------------------------------------------
--------------------------------------------------------------------------------------------------------------------------------------------------------------------------------------------------------
--------------------------------------------------------------------------------------------------------------------------------------------------------------------------------------------------------
--------------------------------------------------------------------------------------------------------------------------------------------------------------------------------------------------------
--------------------------------------------------------------------------------------------S-2SC2S---------------k------------------SSU----------------------------------------------------------------
------------------------------------------------------------------------------------------------------------------%%%-----------------------------------------------------------------------------------
---------------------------------------------------------------CCUS--------------------------%--------------------|||-----------------------------------------------------------------------------------
------------------------------------------------------------------------------------#---#---r|-kr-----------------|||-----------------------------------------------------------------------------------
%%%%%%%%%%%%----------------------------------%%%%%---%%%%%-----------------------%%%---%%%%%%%%%%%%-----%%%------|||-------------%%%%%%%%%%%%%%%%%%F%%%%%%%%%%%%%%%%%%%%%%%%%%%%%%%%%%%%%%%%%%%%%%%%%%%
||||||||||||--#---#--%%%%%--%%%%%%%%%%---%%%%%|||||---|||||-----K----%%%%%---%%%%%|||---||||||||||||---Yy||k------|||--%%%%---%%%%||||||||||||||||||%|||||||||||||||||||||||||||||||||||||||||||||||||||
||||||||||||XXX---XXX|||||--||||||||||---||||||||||---|||||XXXXXXXXXX|||||---||||||||---||||||||||||XXXXXXXXXXXXXXXXXXX||||---||||||||||||||||||||||||||||||||||||||||||||||||||||||||||||||||||||||||||
