HEIGHT=16;WIDTH=201;THEME=0;OVERRIDE=false
--------------------------------------------------------------------------------------------------------------------------------------------------------------------------------------------------------
--------------------------------------------------------------------------------------------------------------------------------------------------------------------------------------------------------
--------------------------------------------------------------------------------------------------------------------------------------------------------------------------------------------------------
--------------------------------------------------------------------------------------------------------------------------------------------------------------------------------------------------------
--------------------------------------------------------------------------------------------------------------------------------------------------------------------------------------------------------
---------------------------------------------------------------------------------------------------------------------------S2SSS2S----------------------------------------------------------------------
--------------------------------------------------------------------------------------------------------------------------------------------------------------------------------------------------------
--------------------------------------------------------------------------------------------------------------------------------------------------------------------------------------------------------
--------------------------------------------------------------------------------------------------------------------------------------------------------------------------------------------------------
----------------------------------------------------------#--#----------------------------------------------#--#-----------%%%%%%%--------tt------------------------------------------------------------
---------------------------------------------------------##--##--------------------------------------------##--##----------|||||||--------tt------------------------------------------------------------
-----------------------------------------------#--#-----###--###------------------------------------------###--###---------|||||||--------tt------------------------------------------------------------
-------------%%%--%%%%%%%%---%%%%%------------##--##--%%%%%--%%%%%-----------------------%%---%%--------%%%%%--%%%%%----rG-|||y||k-----%%%%%%%%---------------------------------------------------------
-------------|||--||||||||---|||||%%--%%%%%%%%%%--%%%%|||||--|||||------%%%%---%%%%%%--%%||---||%%%%%%%%|||||--|||||%%%%%%%%%%%%%%%%%%%||||||||---------------------------------------------------------
-------------|||--||||||||---|||||||--||||||||||--|||||||||--|||||%%--%%||||---||||||--||||---|||||||||||||||--||||||||||||||||||||||||||||||||---------------------------------------------------------
XXXXXXXXXXXXX|||--||||||||---|||||||--||||||||||--|||||||||--|||||||--||||||---||||||--||||---|||||||||||||||--||||||||||||||||||||||||||||||||XXXXXXXXFXXXXXXXXXXXXXXXXXXXXXXXXXXXXXXXXXXXXXXXXXXXXXXXX
