HEIGHT=16;WIDTH=201;THEME=0;OVERRIDE=false
--------------------------------------------------------------------------------------------------------------------------------------------------------------------------------------------------------
--------------------------------------------------------------------------------------------------------------------------------------------------------------------------------------------------------
--------------------------------------------------------------------------------------------------------------------------------------------------------------------------------------------------------
--------------------------------------------------------------------------------------------------------------------------------------------------------------------------------------------------------
--------------------------------------------------------------------------------------------------------------------------------------------------------------------------------------------------------
-----------------------------------CU2------------------------------------------------------------------------------------------------------------------------------------------------------------------
--------------------------------------------------------------------------------------------------------------------------------------------------------------------------------------------------------
--------------------------------------%--------------------------------------------------r--------------------------------------------------------------------------------------------------------------
-------------------------------------r|r-------------------------------------------------%%%%%------------------------------------k---------------------------------------------------------------------
----------------------------------%%%%%%-------------------------------------------------|||||------------------------------%%%%%%%---------------------------------------------------------------------
----------------------------------||||||-------------------------------------------------|||||------------#--#--------------|||||||---------------------------------------------------------------------
-----------------#--#-------------|||||%%%%%%--------------------------------------------||r||-k---------##--##-------------||||||r---------------------------------------------------------------------
----------------##--##---%%--%%---|||||||||||----%%%%%--%%%%%%%%--%%%%%%--%%%-------%%%%%%%%%%%%%%%----%%%%--%%%%%%%---%%%%%%%%%%%%%%%%%%%%%%%%%F%%%%%%%%%%%%%%%%%%%%%%%%%%%%%%%%%%%%%%%%%%%%%%%%%%%%%%%
---------------###--###--||--||---|||y|G|||||----|||||--||||||||--||||||--|||-------|||||||||||||||----||||--|||||||---|||||||||||||||||||||||||%|||||||||||||||||||||||||||||||||||||||||||||||||||||||
%%%%%%%%%%%%%%%%%%--%%%%%||--||%%%%%%%%%%%%%%%%%%|||||--||||||||--||||||--|||-------|||||||||||||||%%%%||||--|||||||---|||||||||||||||||||||||||||||||||||||||||||||||||||||||||||||||||||||||||||||||||
||||||||||||||||||--|||||||--|||||||||||||||||||||||||--||||||||--||||||--|||XX---XX|||||||||||||||||||||||--|||||||---|||||||||||||||||||||||||||||||||||||||||||||||||||||||||||||||||||||||||||||||||
