HEIGHT=16;WIDTH=201;THEME=0;OVERRIDE=false
--------------------------------------------------------------------------------------------------------------------------------------------------------------------------------------------------------
--------------------------------------------------------------------------------------------------------------------------------------------------------------------------------------------------------
--------------------------------------------------------------------------------------------------------------------------------------------------------------------------------------------------------
--------------------------------------------------------------------------------------------------------------------------------------------------------------------------------------------------------
--------------------------------------------------------------------------------------------------------------------------------------------------------------------------------------------------------
--------------------------------------------------------------------------------------------------------------------------------------------------------------------------------------------------------
--------------------------------------------------------------------------------------------------------------------------------------------------------------------------------------------------------
--------------------------------------------------------------------------------------------------------------------------------------------------------------------------------------------------------
--------------------------------------------------------------------------------------------------------------------------------------------------------------------------------------------------------
--------------------------------------------------------------------------------------------------------------------------------------------------------------------------------------------------------
--------------------------------------------------------------------------------------%%%%%%%--------------------------#--#-----------------------------------------------------------------------------
--------------------------------------------------------------------------------------||||g||-------------------------##--##----------------------------------------------------------------------------
%%%%%%%%%%%------------%%%%%--%%%%%--------------------------------------------------%%%%%%%%%%%---#---#-------------###--###---------------------------------------------------------------------------
|||||||||||------------|||||--|||||-----------%%---%%--------------------------#--#--|||||||||||--##---##----------%%%%%--%%%%%-------------%%%%%%%%F%%%%%%%%%%%%%%%%%%%%%%%%%%%%%%%%%%%%%%%%%%%%%%%%%%%
|||||||||||------%%--%%|||||--|||||%%%%---%%%%||---||%%--%%%%%%%%%%%%--------%%%--%%%|||||||||||%%%%---%%%%%%%--%%%|||||--|||||-------------||||||||%|||||||||||||||||||||||||||||||||||||||||||||||||||
|||||||||||XX--XX||--|||||||--|||||||||---||||||---||||--||||||||||||XXX--XXX|||--||||||||||||||||||---|||||||--||||||||--|||||XXXXX---XXXXX||||||||||||||||||||||||||||||||||||||||||||||||||||||||||||
