HEIGHT=16;WIDTH=201;THEME=0;OVERRIDE=false
--------------------------------------------------------------------------------------------------------------------------------------------------------------------------------------------------------
--------------------------------------------------------------------------------------------------------------------------------------------------------------------------------------------------------
--------------------------------------------------------------------------------------------------------------------------------------------------------------------------------------------------------
--------------------------------------------------------------------------------------------------------------------------------------------------------------------------------------------------------
---------------22SU-------------------------------------------------------------------------------------------------------------------------------------------------------------------------------------
--------------------------------------------------------------%%%---------------------------------------------------------------------------------------------------------------------------------------
--------------------------------------------------------------|||---------------------------------------------------------------------------------------------------------------------------------------
--------------g---------------------------------------------r-|||---------------------------------------------------------------------------------------------------------------------------------------
-------------%%%%%%%-------------------------------------%%%%%%%|---------------------------------------------------------------------------------------------------------------------------------------
-------------|||||||-------------------------------------||||||||---------------------------------------------------------------------------------------------------------------------------------------
-------------|||||||---------------------S2S-------------|||%%%%%%%-------------------------------------------------------------------------------------------------------------------------------------
-------------|||||||-------------------------------------||||||||||--------------------#--#-------------------------------------------------------------------------------------------------------------
----------%%%%%%%%%%%%-----------%%%%--------------------||y|r|||||------%%%%---------##--##-----r----------------------------Tt----Tt---%%%%%%%%F%%%%%%%%%%%%%%%%%%%%%%%%%%%%%%%%%%%%%%%%%%%%%%%%%%%%%%
----------||||||||||||-----------||||----------%%--%%%%%%%%%%%%%%%%%%%%%%||||---Tt---###--###--%%%%%%%%-----------------------tt----tt---||||||||%||||||||||||||||||||||||||||||||||||||||||||||||||||||
----------||||||||||||%%%%%%%%%%%||||%%%%%%%%%%||--||||||||||||||||||||||||||---tt-%%%%%--%%%%%||||||||-----------------------tt----tt---|||||||||||||||||||||||||||||||||||||||||||||||||||||||||||||||
XXXXXXXXXX|||||||||||||||||||||||||||||||||||||||--||||||||||||||||||||||||||XXXXXX|||||--|||||||||||||XXXX---XXXXXXX---XXXXXXXXXXXXXXXXX|||||||||||||||||||||||||||||||||||||||||||||||||||||||||||||||
