HEIGHT=16;WIDTH=201;THEME=0;OVERRIDE=false
--------------------------------------------------------------------------------------------------------------------------------------------------------------------------------------------------------
--------------------------------------------------------------------------------------------------------------------------------------------------------------------------------------------------------
--------------------------------------------------------------------------------------------------------------------------------------------------------------------------------------------------------
--------------------------------------------------------------------------------------------------------------------------------------------------------------------------------------------------------
--------------------------------------------------------------------------------------------------------------------------------------------------------------------------------------------------------
--------------------------------------------------------------------------------------------------------------------------------------------------------------------------------------------------------
--------------------------------------------------------------------------------------------------------------------------------------------------------------------------------------------------------
--------------------------------------------------------------------------------------------------------------------------------------------------------------------------------------------------------
-----------S2US-----------------------------------------------------------------------------------------------------------------------------------------------------------------------------------------
--------------------------------------------------------------------------------------------------------------------------------------------------------------------------------------------------------
---------------------------tt---------------------------------------------------------------------------------------------------------------------------------------------------------------------------
-----------y---y-----------tt---------------------------------------------------------------------------------------------------------------------------------------------------------------------------
----------%%%%%%%%-------%%%%%%%%%%%%%%%--%%-------------%%%--%%%-----------------------------#--#--%%%%--%%%%---------%%%%--%%%%-----------------------------------------------------------------------
----------||||||||%%---%%|||||||||||||||--||%%--%%-------|||--|||%%---%%--------------------%%%--%%%||||--||||%%%---%%%||||--||||-----------------------------------------------------------------------
----------||||||||||---|||||||||||||||||--||||--||%%---%%|||--|||||---||-----------%%%%%%%%%|||--|||||||--|||||||---|||||||--||||-------%%%%%%%%F%%%%%%%%%%%%%%%%%%%%%%%%%%%%%%%%%%%%%%%%%%%%%%%%%%%%%%%
XXXXXXXXXX||||||||||---|||||||||||||||||--||||--||||---|||||--|||||---||XXXX---XXXX||||||||||||--|||||||--|||||||---|||||||--||||XXXXXXX||||||||X|||||||||||||||||||||||||||||||||||||||||||||||||||||||
