HEIGHT=16;WIDTH=201;THEME=0;OVERRIDE=false
--------------------------------------------------------------------------------------------------------------------------------------------------------------------------------------------------------
--------------------------------------------------------------------------------------------------------------------------------------------------------------------------------------------------------
--------------------------------------------------------------------------------------------------------------------------------------------------------------------------------------------------------
--------------------------------------------------------------------------------------------------------------------------------------------------------------------------------------------------------
---------------------------------------------------------------------------------------------------rg---------------------------------------------------------------------------------------------------
---------------------------------------------------------------------------------------------------%%%%%------------------------------------------------------------------------------------------------
---------------------------------------------------------------------------------------------------|||||------------------------------------------------------------------------------------------------
---------------------------------------------------------------------------------------------------|||||------------------------------------------------------------------------------------------------
------------------------------------------------------------------------------------------------%%%%||||------------------------------------------------------------------------------------------------
-----------------------------------------------------------------------------2SS----------------||||||||------------------------------------------------------------------------------------------------
------------------------------------------------------------------------------------------------||||||||------------------------------------------------------------------------------------------------
--------------------------------------------------------------------------------%---------------|r||||||------r---SS-2S------------%%%%%%%--------------------------------------------------------------
-------------%%%%%--%%%%%%%---%%--------------------------------------------y---|-k------------%%%%%%%%%%%%%%%%%-------------------|||||||--------------------------------------------------------------
-------------|||||--|||||||---||%%%%--%%%%----------------------------------%%%%%%%----%%%%%---|||||||||||||||||----%--------------|||||||--------------------------------------------------------------
%%%%%%%%%%%%%|||||--|||||||---||||||--||||----------------------------------|||y|||---K|||||kk-|||||||||||||||||-g--|-y-----------r||k||||--------------------------------------------------------------
||||||||||||||||||--|||||||---||||||--||||XX---XXXXX---XXXXXXXX--XXXXXXXXXXXXXXXXXXXXXXXXXXXXXX|||||||||||||||||XXXXXXXXXXXXXXXXXXXXXXXXXXXXXXXXXXXXFXXXXXXXXXXXXXXXXXXXXXXXXXXXXXXXXXXXXXXXXXXXXXXXXXXX
