HEIGHT=16;WIDTH=201;THEME=0;OVERRIDE=false
--------------------------------------------------------------------------------------------------------------------------------------------------------------------------------------------------------
--------------------------------------------------------------------------------------------------------------------------------------------------------------------------------------------------------
--------------------------------------------------------------------------------------------------------------------------------------------------------------------------------------------------------
--------------------------------------------------------------------------------------------------------------------------------------------------------------------------------------------------------
--------------------------------------------------------------------------------------------------------------------------------------------------------------------------------------------------------
--------------------------------------------------------------------------------------------------------------------------------------------------------------------------------------------------------
--------------------------------------------------------------------------------------------------------------------------------------------------------------------------------------------------------
--------------------------------------------------------------------------------------------------------------------------------------------------------------------------------------------------------
--------------------------------------------------------------------------------------------------------------------------------------------------------------------------------------------------------
--------------------------------------------------------------------------------------------------------------------------------------y-----------------------------------------------------------------
-----------S2U2SSS-----------------------------------------------------------------------------------------------------------------%%%%%----------------------------------------------------------------
-----------------------------------------------------------------------------------------------------------------------------------||||g----------------------------------------------------------------
%%%%%%%%%%---------%%%%%--%%%%%-----------------%%%--%%%%%%%%--%%%%%---------------------------------------------------------%%%%%%%%%%%%%%%%%----------------------------------------------------------
||||||||||---y-g---|||||--|||||-----------------|||--||||||||--|||||-------------------------%%%%%--%%%%%--------------------|||||||||||||||||----------------------------------------------------------
||||||||||%%%%%%%%%|||||--|||||----------%%---%%|||--||||||||--|||||%%%---%%%%%%%--%%%%------|||||--|||||-------------%%---%%|||||||||||||||||----------------------------------------------------------
||||||||||||||||||||||||--|||||XXXX--XXXX||---|||||--||||||||--||||||||---|||||||--||||XX--XX|||||--|||||XXXXX---XXXXX||---|||||||||||||||||||XXXXXXXXFXXXXXXXXXXXXXXXXXXXXXXXXXXXXXXXXXXXXXXXXXXXXXXXXX
