HEIGHT=16;WIDTH=201;THEME=0;OVERRIDE=false
--------------------------------------------------------------------------------------------------------------------------------------------------------------------------------------------------------
--------------------------------------------------------------------------------------------------------------------------------------------------------------------------------------------------------
--------------------------------------------------------------------------------------------------------------------------------------------------------------------------------------------------------
--------------------------------------------------------------------------------------------------------------------------------------------------------------------------------------------------------
--------------------------------------------------------------------------------------------------------------------------------------------------------------------------------------------------------
--------------------------------------------------------------------------------------------------------------------------------------------------------------------------------------------------------
--------------------------------------------------------------------------------------------------------------------------------------------------------------------------------------------------------
--------------------------------------------------------------------------------------------------------------------------------------------------------------------------------------------------------
--------------------------------------------------------------------------------------------------------------------------------------------------------------------------------------------------------
--------------------------------------------------------------------------------------------------------------------------------------------------------------------------------------------------------
------------------------------------------------#--#----------------------------------------------------------------------------------------------------------------------------------------------------
-----------------------------------------------##--##------#--#-----------------------------------r-------------------------------------CSS-------------------------------------------------------------
%%%%%%%%%%%%------------------#---#---%%--%%--###--###----##--##-------------------------------%%%%%%%------g---%%--%%%%%%%---%%%%%%%%------------------------------------------------------------------
||||||||||||-----------------##---##--||--||%%%%%--%%%%%%%%%--%%%%%%%---%%%-tt---tt------------|||||||----%%%%%%||--|||||||---||||||||------------------------------------------------------------------
||||||||||||------%%%---%%%%%%%---%%%%||--|||||||--|||||||||--|||||||---|||-tt---tt------------|||||||--g-||||||||--|||||||---||||||||------------------------------------------------------------------
||||||||||||XX--XX|||---|||||||---||||||--|||||||--|||||||||--|||||||---|||XXXXXXXXXXXXXXXXXXXXXXXXXXXXXXX||||||||--|||||||---||||||||XXXXXXXXXXXXXXXFXXXXXXXXXXXXXXXXXXXXXXXXXXXXXXXXXXXXXXXXXXXXXXXXXX
