HEIGHT=16;WIDTH=201;THEME=0;OVERRIDE=false
--------------------------------------------------------------------------------------------------------------------------------------------------------------------------------------------------------
--------------------------------------------------------------------------------------------------------------------------------------------------------------------------------------------------------
--------------------------------------------------------------------------------------------------------------------------------------------------------------------------------------------------------
--------------------------------------------------------------------------------------------------------------------------------------------------------------------------------------------------------
--------------------------------------------------------------------------------------------------------------------------------------------------------------------------------------------------------
--------------------------------------------------------------------------------------------------------------------------------------------------------------------------------------------------------
--------------------------------------------------------------------------------------------------------------------------------------------------------------------------------------------------------
----------------------------------k-----------------------------------r---------------------------------------------------------------------------------------------------------------------------------
-------------------------------%%%%%%%-----------------------------%%%%%--------------------------------------------------------------------------------------------------------------------------------
-------------------------------|||||||-----------------------------|||||---r----------------------------------------------------------------------------------------------------------------------------
-------------------------------|||%%%|-----------------------------||%%%%%%%-----------------------------------------------------------Tt---------------------------------------------------------------
--------------#---#------------|||||||-----------------------------|||||||||-----------------------------------------------------------tt---------------------------------------------------------------
------------%%%---%%%----------||||||k-----------------------------||||r||||--------------------------------------------------------%%%%%%--------------------------------------------------------------
------------|||---|||------%%%%%%%%%%%%%%%%%%%%--%%%%%%%%%%%%%%%%%%%%%%%%%%%%%%%----------------------------------------------------||||||--------------------------------------------------------------
%%%%%%%%%%%%|||---|||%%--%%||||||||||||||||||||--|||||||||||||||||||||||||||||||%%---%%------%%%%--%%%%------------------------%%%%%||||||--------------------------------------------------------------
|||||||||||||||---|||||--||||||||||||||||||||||--|||||||||||||||||||||||||||||||||---||XX--XX||||--||||XXXXX--XXXXXXXXXX--XXXXX|||||||||||XXXXXXXXFXXXXXXXXXXXXXXXXXXXXXXXXXXXXXXXXXXXXXXXXXXXXXXXXXXXXX
