HEIGHT=16;WIDTH=201;THEME=0;OVERRIDE=false
--------------------------------------------------------------------------------------------------------------------------------------------------------------------------------------------------------
--------------------------------------------------------------------------------------------------------------------------------------------------------------------------------------------------------
--------------------------------------------------------------------------------------------------------------------------------------------------------------------------------------------------------
--------------------------------------------------------------------------------------------------------------------------------------------------------------------------------------------------------
--------------------------------------------------------------------------------------------------------------------------------------------------------------------------------------------------------
--------------------------------------------------------------------------------------------------------------------------------------------------------------------------------------------------------
--------------------------------------------------------------------------------------------------------------------------------------------------------------------------------------------------------
--------------------------------------------------------------------------------------------------------------------------------------------------------------------------------------------------------
--------------------------------------------------------------------------------------------------SS2S--------------------------------------------------------------------------------------------------
--------------------------------------------------------------------------------------------------------------------------------------------------------------------------------------------------------
---------------------------------------------------------------------------------------------------------------------------k----------------------------------------------------------------------------
-----------------------------------------------------------------------#---#-----------------------------------------------%%%%%%-----------------------------------------------------------------------
------------------------#---#------%%%---%%%--------------------------##---##--------------------%%%%%%%%%%%---%%%%%-------||||||-----------------------------------------------------------------------
-----------------------##---##-----|||---|||---#--#------------------###---###--%%--%%%%%%---%%%%|||||||||||---|||||-------||||||----%%%%%---%%%%%------------------------------------------------------
------------%%%---%%%%%%%---%%%%%%%|||---|||--##--##---------------%%%%%---%%%%%||--||||||---|||||||||||||||---|||||%%%%%%%%%%%%%%%%%|||||---|||||%%%%%%%%F%%%%%%%%%%%%%%%%%%%%%%%%%%%%%%%%%%%%%%%%%%%%%
XXXXXXXXXXXX|||---|||||||---||||||||||---|||XXXX--XXXXXXXXX---XXXXX|||||---|||||||--||||||---|||||||||||||||---|||||||||||||||||||||||||||---|||||||||||||X|||||||||||||||||||||||||||||||||||||||||||||
