HEIGHT=16;WIDTH=201;THEME=0;OVERRIDE=false
--------------------------------------------------------------------------------------------------------------------------------------------------------------------------------------------------------
--------------------------------------------------------------------------------------------------------------------------------------------------------------------------------------------------------
--------------------------------------------------------------------------------------------------------------------------------------------------------------------------------------------------------
--------------------------------------------------------------------------------------------------------------------------------------------------------------------------------------------------------
--------------------------------------------------------------------------------------------------------------------------------------------------------------------------------------------------------
--------------------------------------------------------------------------------------------------------------------------------------------------------------------------------------------------------
--------------------------------------------------------------------------------------------------------------------------------------------------------------------------------------------------------
--------------------------------------------------------------------------------------------------------------------------------------------------------------------------------------------------------
--------------------------------------------------------------------------------------------------------------------------------------------------------------------------------------------------------
-----------------------------------------------------------------------------------------------------------------------------------------SCC2-----------------------------------------------------------
------------------------------------------------------------------------------------------------------------y-y-----------------------------------------------------------------------------------------
-----------------------------------------------------------------------------#--#--------------------------%%%%%%---------------------------------------------------------------------------------------
------------------------------#---#---------------------------------#---#--%%%--%%%---------------%%%--%%%-||||||-------------------------k-------------------------------------------------------------
-------------#--#----tt-----%%%---%%%%%%%--%%%%%%%--%%%-----------%%%---%%%|||--|||------%%%------|||--|||-kgy|||-----------%%%---%%%%%%%%%%%%----------------------------------------------------------
-----------%%%--%%%--tt-----|||---|||||||--|||||||--|||%%%%---%%%%|||---||||||--|||------|||%%--%%|||--|||%%%%%%%%%%%%%--%%%|||---||||||||||||%%%%%%%%F%%%%%%%%%%%%%%%%%%%%%%%%%%%%%%%%%%%%%%%%%%%%%%%%%
XXXXXXXXXXX|||--|||XXXXXXXXX|||---|||||||--|||||||--|||||||---|||||||---||||||--|||XX--XX|||||--|||||--||||||||||||||||--||||||---||||||||||||||||||||X|||||||||||||||||||||||||||||||||||||||||||||||||
