HEIGHT=16;WIDTH=201;THEME=0;OVERRIDE=false
--------------------------------------------------------------------------------------------------------------------------------------------------------------------------------------------------------
--------------------------------------------------------------------------------------------------------------------------------------------------------------------------------------------------------
--------------------------------------------------------------------------------------------------------------------------------------------------------------------------------------------------------
--------------------------------------------------------------------------------------------------------------------------------------------------------------------------------------------------------
--------------------------------------------------------------------------------------------------------------------------------------------------------------------------------------------------------
--------------------------------------------------------------------------------------------------------------------------------------------------------------------------------------------------------
--------------------------------------------------------------------------------------------------------------------------------------------------------------------------------------------------------
--------------------------------------------------------------------------------------------------------------------------------------------------------------------------------------------------------
--------------------------------------------------------------------------------------------------------------------------------------------------------------------------------------------------------
--------------------------------------------------------------------------------------------------------------------------------------------------------------------------------------------------------
-----------------------#--#--------------------------------------------------------------%%%%%%---------------------------------------------------------------------------------------------------------
----------------------##--##-------------------------------------------------------------||||||-y---------------------------------------#---#-----------------------------------------------------------
---------------------###--###--------------------------------------#---#----%%%%%--%%%%%-|||%%%%%%%------------------------%%%%---%%%%%%%---%%%%%%%%%%%F%%%%%%%%%%%%%%%%%%%%%%%%%%%%%%%%%%%%%%%%%%%%%%%%
------------%%---%%%%%%%--%%%%%------%%%%%---y------------tt------##---##---|||||--|||||-||||||||||---k--------------------||||---|||||||---|||||||||||%||||||||||||||||||||||||||||||||||||||||||||||||
------------||---|||||||--|||||%%--%%|||||%%%%%%%%---%%---tt-----###---###--|||||--|||||%%%%%%%%%%%%%%%%%%-----------------||||---|||||||---||||||||||||||||||||||||||||||||||||||||||||||||||||||||||||
XXXXXXXXXXXX||---|||||||--|||||||--|||||||||||||||---||XXXXXXXXXXXXX---XXXXX|||||--|||||||||||||||||||||||XXXX---XXXXXX--XX||||---|||||||---||||||||||||||||||||||||||||||||||||||||||||||||||||||||||||
