HEIGHT=16;WIDTH=201;THEME=0;OVERRIDE=false
--------------------------------------------------------------------------------------------------------------------------------------------------------------------------------------------------------
--------------------------------------------------------------------------------------------------------------------------------------------------------------------------------------------------------
--------------------------------------------------------------------------------------------------------------------------------------------------------------------------------------------------------
--------------------------------------------------------------------------------------------------------------------------------------------------------------------------------------------------------
--------------------------------------------------------------------------------------------------------------------------------------------------------------------------------------------------------
--------------------------------------------------------------------------------------------------------------------------------------------------------------------------------------------------------
--------------------------------------------------------------------------------------------------------------------------------------------------------------------------------------------------------
--------------------------------------------------------------------------------------------------------------------------------------------------------------------------------------------------------
--------------------------------------------------------------------------------------------------------------------------------------------------------------------------------------------------------
--------------------SSSC--------------------------------------------------------------------------------------------------------22C-SSCS----------------------------------------------------------------
-----------------------------------yk--------------------#--#-----tt---------------2CSSSS-----------------------------Tt----tt--------------------------------------------------------------------------
--------------------------------%%%%%%------------------##--##----tt---------------------------------r----------------tt----tt-----%--------------------------------------------------------------------
------------Tt--------g---------||||||----------------%%%%--%%%%%%%%%---------------------------%%%%%%%------------%%%%%%%%%%%%----|--------------------------------------------------------------------
------------tt-----%%%%%%%%%----||||||-------%%%---%%%||||--|||||||||%%%%%--%%%%%----------%%%%%|||||||------------||||||||||||%%%%%%%%%%---------------------------------------------------------------
------------tt-----|||||||||---%%%%%%%%%%%%%%|||---|||||||--||||||||||||||--|||||%%%%%%%%%%||||||||||||------------||||||||||||||||||||||%%%%%%%%F%%%%%%%%%%%%%%%%%%%%%%%%%%%%%%%%%%%%%%%%%%%%%%%%%%%%%%
XXXXXXXXXXXXXXXXXXX|||||||||XXX|||||||||||||||||---|||||||--||||||||||||||--|||||||||||||||||||||||||||XXXXX--XXXXX||||||||||||||||||||||||||||||X||||||||||||||||||||||||||||||||||||||||||||||||||||||
