HEIGHT=16;WIDTH=201;THEME=0;OVERRIDE=false
--------------------------------------------------------------------------------------------------------------------------------------------------------------------------------------------------------
--------------------------------------------------------------------------------------------------------------------------------------------------------------------------------------------------------
--------------------------------------------------------------------------------------------------------------------------------------------------------------------------------------------------------
--------------------------------------------------------------------------------------------------------------------------------------------------------------------------------------------------------
--------------------------------------------------------------------------------------------------------------------------------------------------------------------------------------------------------
--------------------------------------------------------------------------------------------------------------------------------------------------------------------------------------------------------
--------------------------------------------------------------------------------------------------------------------------------------------------------------------------------------------------------
--------------------------------------------------------------------------------------------------------------------------------------------------------------------------------------------------------
--------------------------------------------------------------------------------------------------------------------------------------------------------------------------------------------------------
------------SCU2S----------------------------------------------#--#----------------------------------------------------------------g--------------------------------------------------------------------
---------------------SSS2SSSS---------------------------------##--##--------------------------------------------------------------%%%%%-----------------------------------------------------------------
------------------------------------------#--#---------------###--###-------------------------------------------------------------|||||-----------------------------------------------------------------
-----------------------------------------##--##-----#--#---%%%%%--%%%%%-------------------%%---%%---#---#-------------------------|||||----%%%%%%%%F%%%%%%%%%%%%%%%%%%%%%%%%%%%%%%%%%%%%%%%%%%%%%%%%%%%%
-----------%%%%%%%%%----Y---y----------%%%%--%%%%--##--##--|||||--|||||-------------------||---||--##---##----#---#--%%%%%%%%%%---|||||----||||||||%||||||||||||||||||||||||||||||||||||||||||||||||||||
-----------|||||||||%%%%%%%%%%---------||||--||||%%%%--%%%%|||||--|||||---------%%%%--%%%%||---||%%%%---%%%%%%%---%%%||||||||||%%%%%%%%%%%%|||||||||||||||||||||||||||||||||||||||||||||||||||||||||||||
XXXXXXXXXXX|||||||||||||||||||XXX---XXX||||--||||||||--|||||||||--|||||XXX---XXX||||--||||||---||||||---|||||||---||||||||||||||||||||||||||||||||||||||||||||||||||||||||||||||||||||||||||||||||||||||
