HEIGHT=16;WIDTH=201;THEME=0;OVERRIDE=false
--------------------------------------------------------------------------------------------------------------------------------------------------------------------------------------------------------
--------------------------------------------------------------------------------------------------------------------------------------------------------------------------------------------------------
--------------------------------------------------------------------------------------------------------------------------------------------------------------------------------------------------------
--------------------------------------------------------------------------------------------------------------------------------------------------------------------------------------------------------
--------------------------------------------------------------------------------------------------------------------------------------------------------------------------------------------------------
--------------------------------------------------------------------------------------------------------------------------------------------------------------------------------------------------------
--------------------------------------------------------------------------------------------------------------------------------------------------------------------------------------------------------
--------------------------------------------------------------------------------------------------------------------------------------------------------------------------------------------------------
-------------------------------------------------------------------------------------CSS--------%%%%%%%-------------------------------------------------------------------------------------------------
------------------------------------------------------------------------------------------------|||||||-------------------------------------------------------------------------------------------------
------------------------------------------------------------------------------------------------|||||||-------------------------------------------------------------------------------------------------
-------------SSS-2------------------------tt---------r--------------------------------kk-------k||||K||-------------------------SSSS--------------------------------------------------------------------
----------------------------#--#----------tt-tt----%%%%-----------------%%%---%%%%%%%%%%%%%%%%%%%%%%%%%%%%----------------------------------------------------------------------------------------------
%%%%%%%%%%%%----%--%%---%%%%%--%%%--------tt-tt----||||----g------------|||---||||||||||||||||||||||||||||%%%--%%%------%%%%%%%-----%-------------------------------------------------------------------
||||||||||||--K-|--||---|||||--|||%%%%%%%%%%%%%%%%%%%%%%%%%%%%%%%%%--%%%|||---|||||||||||||||||||||||||||||||--|||%%--%%|||||||---r-|--%%%%--%%%%-------------------------------------------------------
||||||||||||XXXXXXX||---|||||--||||||||||||||||||||||||||||||||||||--||||||---|||||||||||||||||||||||||||||||--|||||--|||||||||XXXXXXXX||||--||||XXXXXXXXFXXXXXXXXXXXXXXXXXXXXXXXXXXXXXXXXXXXXXXXXXXXXXX
