HEIGHT=16;WIDTH=201;THEME=0;OVERRIDE=false
--------------------------------------------------------------------------------------------------------------------------------------------------------------------------------------------------------
--------------------------------------------------------------------------------------------------------------------------------------------------------------------------------------------------------
--------------------------------------------------------------------------------------------------------------------------------------------------------------------------------------------------------
--------------------------------------------------------------------------------------------------------------------------------------------------------------------------------------------------------
--------------------------------------------------------------------------------------------------------------------------------------------------------------------------------------------------------
--------------------------------------------------------------------------------------------------------------------------------------------------------------------------------------------------------
--------------------------------------------------------------------------------------------------------------------------------------------------------------------------------------------------------
--------------------------------------------------------------------------------------------------------------------------------------------------------------------------------------------------------
------------------------------------------------------------------------------------------------%%%%%%--------------------------------------------------------------------------------------------------
------------------------------------------------------------------------------------------------||||||---SSSUSU-----------------------------------------------------------------------------------------
------------------------------------------------------------------------------------------------||||||--------------------------------------------------------------------------------------------------
-----------------------------------------------------------------------------------------------kr|||||---------------#--#-------------------------------------------------------------------------------
-----------------------%%---%%----------------------------------------------------------------%%%%%%||--------------##--##---%%%%%---%%%%%--------------------------------------------------------------
-----------------------||---||-------------------%%%%%--%%%%%--------------------%%%%%--------||||||||--%%%%%%%%%--###--###--|||||---|||||--------------------------------------------------------------
-----------------------||---||%%%--%%%%%%%---%%%%|||||--|||||%%%%%--%%%%%%%%--%%%|||||%%--%%%%%%%%%%%%%%|||||||||%%%%%--%%%%%|||||---|||||%%%%%%%%F%%%%%%%%%%%%%%%%%%%%%%%%%%%%%%%%%%%%%%%%%%%%%%%%%%%%%
XXXXXXXXXXXXXXXX---XXXX||---|||||--|||||||---|||||||||--||||||||||--||||||||--||||||||||--||||||||||||||||||||||||||||--||||||||||---|||||||||||||X|||||||||||||||||||||||||||||||||||||||||||||||||||||
