HEIGHT=16;WIDTH=201;THEME=0;OVERRIDE=false
--------------------------------------------------------------------------------------------------------------------------------------------------------------------------------------------------------
--------------------------------------------------------------------------------------------------------------------------------------------------------------------------------------------------------
--------------------------------------------------------------------------------------------------------------------------------------------------------------------------------------------------------
--------------------------------------------------------------------------------------------------------------------------------------------------------------------------------------------------------
--------------------------------------------------------------------------------------------------------------------------------------------------------------------------------------------------------
--------------------------------------------------------------------------------------------------------------------------------------------------------------------------------------------------------
----------------------------------------------------------------SUU-------------------------------------------------------------------------------------------------------------------------------------
--------------------------------------------------------------------------------------------------------------------------------------------------------------------------------------------------------
-------------------------------------------------------------------------------------------------------------------------%%%----------------------------------------------------------------------------
---------------------------------------------------------------K--g----------------rY------------------------------------|||--------SSCSS---------------------------------------------------------------
--------------------------------------------------------------%%%%%%%------------%%%%%-----------------------------------|||g---------------------------------------------------------------------------
-------------222--------------------------#--#----------------|||||k|------------|||||-----------------------------------||%%%%-------------------------------------------------------------------------
-----------------------------------------##--##------------%%%%%%%%%%%%%%%%%%----|||||--------%%%%---%%%%%%---%%---------||||||-----k-------------------------------------------------------------------
-------------------------%%--%%---Tt---%%%%--%%%%----------||||||||||||||||||---k|||||-----y--||||---||||||---||-------y-r|||||----%%%%%%%--------------------------------------------------------------
%%%%%%%%%%----K----------||--||---tt---||||--||||%%%%--%%%%||||||||||||||||||%%%%%%%%%%%%%%%%%||||---||||||---||------%%%%%%%%%%%%%|||||||--------------------------------------------------------------
||||||||||XXXXXXXXXXXXXXX||--||XXXXXXXX||||--||||||||--|||||||||||||||||||||||||||||||||||||||||||---||||||---||XX--XX||||||||||||||||||||XXXXXXXXFXXXXXXXXXXXXXXXXXXXXXXXXXXXXXXXXXXXXXXXXXXXXXXXXXXXXX
