HEIGHT=16;WIDTH=201;THEME=0;OVERRIDE=false
--------------------------------------------------------------------------------------------------------------------------------------------------------------------------------------------------------
--------------------------------------------------------------------------------------------------------------------------------------------------------------------------------------------------------
--------------------------------------------------------------------------------------------------------------------------------------------------------------------------------------------------------
--------------------------------------------------------------------------------------------------------------------------------------------------------------------------------------------------------
-----------------yK-r-----------------------------------------------------------------------------------------------------------------------------------------------------------------------------------
---------------%%%%%%-----------------------------------------------------------------------------------------------------------------------------------------------------------------------------------
---------------||||||-----------------------------------------------------------------------------------------------------------------------------------------------------------------------------------
---------------||||||-----------------------------------------------------------------------------------------------------------------------------------------------------------------------------------
---------------||%%%|-----------------------------------------------------------------------SSS2SCS-----------------------------------------------------------------------------------------------------
---------------||||||-----------------------------------------------------------------------------------------------------------------------------------------------------------------------------------
---------------||||||----------------------------------------------------------------------------------CUSC------------------------C2SS-----------------------------------------------------------------
---------------||||r|-g---------------------------------------------------------------------K-----------------------------------------------------------------------------------------------------------
--------------%%%%%%%%%%%%%%%---%%%%%---------------------%%%%%--%%%%%--------%%%%%---%%%%%%%%%%%%%%%----------------%%%%--%%%%-------------------------------------------------------------------------
%%%%%%%%%%%%%%|||||||||||||||---|||||%%%%%--%%%%%%%%---%%%|||||--|||||%%%--%%%|||||---|||||||||||||||--------%%%--%%%||||--||||-------g-----------------------------------------------------------------
|||||||||||||||||||||||||||||---||||||||||--||||||||---||||||||--||||||||--||||||||---|||||||||||||||%%%%%%%%|||--|||||||--||||%%%%%%%%%%%%%%%%%F%%%%%%%%%%%%%%%%%%%%%%%%%%%%%%%%%%%%%%%%%%%%%%%%%%%%%%%
|||||||||||||||||||||||||||||---||||||||||--||||||||---||||||||--||||||||--||||||||---||||||||||||||||||||||||||--|||||||--|||||||||||||||||||||X|||||||||||||||||||||||||||||||||||||||||||||||||||||||
