HEIGHT=16;WIDTH=201;THEME=0;OVERRIDE=false
--------------------------------------------------------------------------------------------------------------------------------------------------------------------------------------------------------
--------------------------------------------------------------------------------------------------------------------------------------------------------------------------------------------------------
--------------------------------------------------------------------------------------------------------------------------------------------------------------------------------------------------------
--------------------------------------------------------------------------------------------------------------------------------------------------------------------------------------------------------
--------------------------------------------------------------------------------------------------------------------------------------------------------------------------------------------------------
--------------------------------------------------------------------------------------------------------------------------------------------------------------------------------------------------------
--------------------------------------------------------------------------------------------------------------------------------------------------------------------------------------------------------
--------------------------------------------------------------------------------------------------------------------------------------------------------------------------------------------------------
--------------------------------------------------------------------------------------------------------------------------------------------------------------------------------------------------------
-----------------------------2SSS-----------------------------------------------------------------------------------------------------------------------------------------------------------------------
-------------------------------------------------------------------------------------------------------------------------------------------r------------------------------------------------------------
---------------------#---#-----------------------------------------------------------------------------------------------------------------%%%%%%%------------------------------------------------------
-------------------%%%---%%%-----r------------------------------------------------------------------------------------------%%%---%%%--r---|||||||------------------------------------------------------
%%%%%%%%%%%%-------|||---|||%%%%%%%%%--#--#----------#--#---%%%%%--%%%%%----------------%%%%%%%-----------------------------|||---|||%%%%%%%%%%%%%%%----------------------------------------------------
||||||||||||%%---%%|||---||||||||||||%%%--%%%-------##--##--|||||--|||||--------------r-|||||||-----------------------------|||---||||||||||||||||||%%%%%%%%F%%%%%%%%%%%%%%%%%%%%%%%%%%%%%%%%%%%%%%%%%%%
||||||||||||||---|||||---|||||||||||||||--|||XXXXXXXXX--XXXX|||||--|||||XXX---XXXXXXXXXX|||||||XXX---XXXXX---XXXXXXX---XXXXX|||---||||||||||||||||||||||||||X|||||||||||||||||||||||||||||||||||||||||||
