HEIGHT=16;WIDTH=201;THEME=0;OVERRIDE=false
--------------------------------------------------------------------------------------------------------------------------------------------------------------------------------------------------------
--------------------------------------------------------------------------------------------------------------------------------------------------------------------------------------------------------
--------------------------------------------------------------------------------------------------------------------------------------------------------------------------------------------------------
--------------------------------------------------------------------------------------------------------------------------------------------------------------------------------------------------------
-----------------------------------------------------------------------------------------------------------------------------------%%%%-----------------------------------------------------------------
----------------------------------------------------------------------------------------------------------------y-k----------------||||-----------------------------------------------------------------
---------------------------------------------------------------------------------------------------------------%%%%%%--------------||||-----------------------------------------------------------------
---------------------------------------------------------------------------------------------------------------||||||--------------||||-----------------------------------------------------------------
---------------------------------------------------------------------------------------------------------------||||||--------------||%%%%%%%------------------------------------------------------------
---------------------------------------------------------------------------------------------------------------||||||--------------|||||||||------------------------------------------------------------
----------------------------------------#--#---------------------------------------------------#---#-----------|||%%%%%------------|||||||||------------------------------------------------------------
---------------------------------------##--##-------------------------------------------------##---##----------||||||||------------|||||||||------------------------------------------------------------
%%%%%%%%%%------------------tt--------###--###--%%%%%---%%%%%--------------%%%--%%%---------%%%%---%%%%--------||||||||-----------%%%%%%%%%%%%%%--------------------------------------------------------
||||||||||------------------tt------%%%%%--%%%%%|||||---|||||------------%%|||--|||---------||||---||||-----%%%%%%%%%%%%%---------||||||||||||||--------------------------------------------------------
||||||||||---------%%---%%%%%%%%%%%%|||||--||||||||||---|||||------------|||||--|||---%%--%%||||---||||-----|||||||||||||---------||||||||||||||--------------------------------------------------------
||||||||||XXXXXXXXX||---|||||||||||||||||--||||||||||---|||||XXXXX--XXXXX|||||--|||XXX||--||||||---||||XXXXX|||||||||||||XXX---XXX||||||||||||||XXXXXXXXFXXXXXXXXXXXXXXXXXXXXXXXXXXXXXXXXXXXXXXXXXXXXXXX
