HEIGHT=16;WIDTH=201;THEME=0;OVERRIDE=false
--------------------------------------------------------------------------------------------------------------------------------------------------------------------------------------------------------
--------------------------------------------------------------------------------------------------------------------------------------------------------------------------------------------------------
--------------------------------------------------------------------------------------------------------------------------------------------------------------------------------------------------------
--------------------------------------------------------------------------------------------------------------------------------------------------------------------------------------------------------
--------------------------------------------------------------------------------------------------------------------------------------------------------------------------------------------------------
--------------------------------------------------------------------------------------------------------------------------------------------------------------------------------------------------------
--------------------------------------------------------------------------------------------------------------------------------------------------------------------------------------------------------
--------------------------------------------------------------------------------------------------------------------------------------------------------------------------------------------------------
--------------------------------------------------------------------------------------------------------------------------------------------------------------------------------------------------------
-----------------------------------------------------------------------------------------%%%%%%%--------------------------------------------------------------------------------------------------------
------------------------------------------------------------------------r----------------|||||||--------------------------------------------------------------------------------------------------------
--------------------------------------------------------------------%%%%%%%--------------|||||||------#--#--------------------------------CS2SS---------------------------------------------------------
------------------------------------------------------------#---#---|||||||--%%%%---%%%%-|||||||-----##--##---------------------------------------------------------------------------------------------
------------------------------------------%%%%---%%%%-----%%%---%%%%%%%%%%%%%||||---||||-|||%%%|---%%%%--%%%%%%%%--------%%---%%----------------%%%%%%%%F%%%%%%%%%%%%%%%%%%%%%%%%%%%%%%%%%%%%%%%%%%%%%%%
%%%%%%%%%%%%%%%%--%%%%%---%%%-------------||||---||||%%%%%|||---|||||||||||||||||---||||-|||||||---||||--||||||||--------||---||%%---%%---r-----||||||||%|||||||||||||||||||||||||||||||||||||||||||||||
||||||||||||||||--|||||---|||XXXXX---XXXXX||||---||||||||||||---|||||||||||||||||---||||XXXXXXXXXXX||||--||||||||XXX--XXX||---||||---||XXXXXXXXX||||||||||||||||||||||||||||||||||||||||||||||||||||||||
