HEIGHT=16;WIDTH=201;THEME=0;OVERRIDE=false
--------------------------------------------------------------------------------------------------------------------------------------------------------------------------------------------------------
--------------------------------------------------------------------------------------------------------------------------------------------------------------------------------------------------------
--------------------------------------------------------------------------------------------------------------------------------------------------------------------------------------------------------
--------------------------------------------------------------------------------------------------------------------------------------------------------------------------------------------------------
--------------------------------------------------------------------------------SSSC--------------------------------------------------------------------------------------------------------------------
--------------------------------------------------------------------------------------------------------------------------------------------------------------------------------------------------------
--------------------------------------------------------------------------------------------------------------------------------------------------------------------------------------------------------
----------------------------------------------------------------------------------rg--------------------------------------------------------------------------------------------------------------------
---------------------%%%%%------------------------------------------------------%%%%%-------------------------------------------------------------------------------------------------------------------
---------------------|||||------------------------------------------------------|||||-------------------------------------------------------------------------------------------------------------------
---------------------|||||------------------------------------------------------|||||-------------------------------------------------------------------------------------------------------------------
--------------gk-----|||||r--------------------------------------------------G--r||||-------------------------------------------------------------------------------------------------------------------
-------------%%%%%%%%%%%%%%%--------%%---%%------------------%%%%%%%%--------%%%%%|||----------------#--#---------------%%%%--%%%%----------------------------------------------------------------------
%%%%%%%%%%%%%|||||||||||||||--------||---||--#---#-----------||||||||---g----||||||||----%%%%--%%%%%%%--%%%-------------||||--||||%%%%%%%%%%%%%---------------------------------------------------------
||||||||||||||||||||||||||||%%%%%%%%||---||%%%---%%%---------||||||||%%%%%%%-||||||||----||||--|||||||--|||---------%%%%||||--|||||||||||||||||---------------------------------------------------------
||||||||||||||||||||||||||||||||||||||---|||||---|||XXX---XXX|||||||||||||||XXXXXXXXXXXXX||||--|||||||--|||XXX---XXX||||||||--|||||||||||||||||XXXXXXXXFXXXXXXXXXXXXXXXXXXXXXXXXXXXXXXXXXXXXXXXXXXXXXXXX
