HEIGHT=16;WIDTH=201;THEME=0;OVERRIDE=false
--------------------------------------------------------------------------------------------------------------------------------------------------------------------------------------------------------
--------------------------------------------------------------------------------------------------------------------------------------------------------------------------------------------------------
--------------------------------------------------------------------------------------------------------------------------------------------------------------------------------------------------------
--------------------------------------------------------------------------------------------------------------------------------------------------------------------------------------------------------
--------------------------------------------------------------------------------------------------------------------------------------------------------------------------------------------------------
--------------------------------------------------------------------------------------------------------------------------------------------------------------------------------------------------------
--------------------------------------------------------------------------------------------------------------------------------------------------------------------------------------------------------
--------------------------------------------------------------------------------------------------------------------------------------------------------------------------------------------------------
--------------------------------------------------------------------------------------------------------------------------------------------------------------------------------------------------------
---------------------------------------------------------------------------------------------------------------------------------------tt---------------------------------------------------------------
--------------------------SSSSS2-------------2SC2--------------------------------------------------------------------------------------tt---------------------------------------------------------------
---------------------------------------------------------------------------------------------------------------------------------------tt---------------------------------------------------------------
------------------------------------#---#----------------%%%%%---%%%%%%%%%%---%%%%%----------%%%--%%%---#---#-----------------------%%%%%%%%%%%%%%F%%%%%%%%%%%%%%%%%%%%%%%%%%%%%%%%%%%%%%%%%%%%%%%%%%%%%
-----------%%%%%--%%%%%-----------%%%---%%%--------------|||||---||||||||||---|||||%%%%%%%%%%|||--|||--##---##----------------------||||||||||||||%|||||||||||||||||||||||||||||||||||||||||||||||||||||
-----------|||||--|||||%%%%%%%%%%%|||---|||%%%%%%%-------|||||---||||||||||---||||||||||||||||||--|||%%%%---%%%%%%%%--%%%%----------||||||||||||||||||||||||||||||||||||||||||||||||||||||||||||||||||||
XXXXXXXXXXX|||||--|||||||||||||||||||---||||||||||XX---XX|||||---||||||||||---||||||||||||||||||--|||||||---||||||||--||||XXX--XXXXX||||||||||||||||||||||||||||||||||||||||||||||||||||||||||||||||||||
