HEIGHT=16;WIDTH=201;THEME=0;OVERRIDE=false
--------------------------------------------------------------------------------------------------------------------------------------------------------------------------------------------------------
--------------------------------------------------------------------------------------------------------------------------------------------------------------------------------------------------------
--------------------------------------------------------------------------------------------------------------------------------------------------------------------------------------------------------
--------------------------------------------------------------------------------------------------------------------------------------------------------------------------------------------------------
--------------------------------------------------------------------------------------------------------------------------------------------------------------------------------------------------------
--------------------------------------------------------------------------------------------------------------------------------------------------------------------------------------------------------
--------------------------------------------------------------------------------------------------------------------------------------------------------------------------------------------------------
--------------------------------------------------------------------------------------------------------------------------------------------------------------------------------------------------------
--------------------------------------------------------------------------------------------------------------------------------------------------------------------------------------------------------
--------------------------------------------------------------------------------------------------------------------------------------------------------------------------------------------------------
------------------------------------------------------2SU-----------------------------------------------------------------------------------------------------------------------------------------------
---------------------------------------------------------------CCS--------------------------------------------------------------------------------------------------------------------------------------
------------------#--#----%%%%%---%%%%%-------------------------------------------------------------------%%%%%%%%%---%%%%------------%%--%%------------------------------------------------------------
%%%%%%%%%%%%%%---##--##---|||||---|||||%%%%---%%%%-----k-------------------%%%---%%%%%%%%%----------------|||||||||---||||%%%%%--%%%%%||--||------------------------------------------------------------
||||||||||||||--###--###--|||||---|||||||||---||||%%%%%%%%%----------------|||---|||||||||---------%%---%%|||||||||---|||||||||--|||||||--||%%%%%%%%F%%%%%%%%%%%%%%%%%%%%%%%%%%%%%%%%%%%%%%%%%%%%%%%%%%%
||||||||||||||XXXXX--XXXXX|||||---|||||||||---|||||||||||||XXXXXXXXXXXX--XX|||---|||||||||XXX---XXX||---|||||||||||---|||||||||--|||||||--||||||||||X|||||||||||||||||||||||||||||||||||||||||||||||||||
