HEIGHT=16;WIDTH=201;THEME=0;OVERRIDE=false
--------------------------------------------------------------------------------------------------------------------------------------------------------------------------------------------------------
--------------------------------------------------------------------------------------------------------------------------------------------------------------------------------------------------------
--------------------------------------------------------------------------------------------------------------------------------------------------------------------------------------------------------
--------------------------------------------------------------------------------------------------------------------------------------------------------------------------------------------------------
--------------------------------------------------------------------------------------------------------------------------------------------------------------------------------------------------------
--------------------------------------------------------------------------------------------------------------------------------------------------------------------------------------------------------
--------------------------------------------------------------------------------------------------------------------------------------------------------------------------------------------------------
------------------------------------------------------------------------------------------------------SSS2----------------------------------------------------------------------------------------------
--------------------------------------------------------------------------------------------------------------------------------------------------------------------------------------------------------
--------------------------------------------------------------------------------------------------------------------------------------------------------------------------------------------------------
---------------------------------------------------------S2SCS---------------------------------------gGkg-----------------------------------------------------------------------------------------------
---------------------------------------------------------------------------------------------------%%%%%%%-------------Tt-tt----------------------------------------------------------------------------
-----------------------------------------------------------------------------%%%%------%%%%---%%%%-|||||||--%%%--%%%---tt-tt-----------%%%%%---%%%%%----------------------------------------------------
%%%%%%%%%%%%%%--------------------------------------------------y------------||||------||||---||||-|||||||--|||--|||%%%%%%%%%%%%%%%%%%%|||||---|||||----------------------------------------------------
||||||||||||||----------%%%%%%%%------------------------%%%%%%%%%%-----------||||%%--%%||||---||||-||||y||--|||--|||||||||||||||||||||||||||---|||||----------------------------------------------------
||||||||||||||XXXX--XXXX||||||||XXXX---XXXXXXXXX---XXXXX||||||||||XXXX---XXXX||||||--||||||---||||XXXXXXXXXX|||--|||||||||||||||||||||||||||---|||||XXXXXXXXFXXXXXXXXXXXXXXXXXXXXXXXXXXXXXXXXXXXXXXXXXXX
