HEIGHT=16;WIDTH=201;THEME=0;OVERRIDE=false
--------------------------------------------------------------------------------------------------------------------------------------------------------------------------------------------------------
--------------------------------------------------------------------------------------------------------------------------------------------------------------------------------------------------------
--------------------------------------------------------------------------------------------------------------------------------------------------------------------------------------------------------
--------------------------------------------------------------------------------------------------------------------------------------------------------------------------------------------------------
--------------------------------------------------------------------------------------------------------------------------------------------------------------------------------------------------------
--------------------------------------------------------------------------------------------------------------------------------------------------------------------------------------------------------
--------------------------------------------------------------------------------------------------------------------------------------------------------------------------------------------------------
--------------------------------------------------------------------------g-----%%%%%-------------------------------------------------------------------------------------------------------------------
--------------------------------------------------------------------------%%%---|||||-------------------------------------------------------------------------------------------------------------------
-------------Tt-tt------------------------------------------------------k-|||---|||||-------------------------------------------------------------------------------------------------------------------
-------------tt-tt--------------------------------------------------%%%%%%%||---|||%%%%-----------------------------------------------------------------------------------------------------------------
-------------tt-tt-----------------------------------#---#----------|||||||y|---|||||||-----------------------------------------------------------------------------------------------------------------
%%%%%%%%%%%%%%%%%%%%%---------------%%%%%---%%%%%---##---##---%%%%%%%%%%%%%%%%%-|rr|gg|--yg-%%---%%----------------------------------#--#---------------------------------------------------------------
|||||||||||||||||||||%%%--%%%%%---%%|||||---|||||--###---###--|||||||||||||||||%%%%%%%%%%%%%||---||%%---%%%%%%%--%%%%%-----%%%%%----##--##--%%%%%%%%F%%%%%%%%%%%%%%%%%%%%%%%%%%%%%%%%%%%%%%%%%%%%%%%%%%%
||||||||||||||||||||||||--|||||---|||||||---|||||%%%%%---%%%%%||||||||||||||||||||||||||||||||---||||---|||||||--|||||-----|||||--%%%%--%%%%||||||||%|||||||||||||||||||||||||||||||||||||||||||||||||||
||||||||||||||||||||||||--|||||---|||||||---||||||||||---|||||||||||||||||||||||||||||||||||||---||||---|||||||--|||||XXXXXXXXXXXX||||--||||||||||||||||||||||||||||||||||||||||||||||||||||||||||||||||
