HEIGHT=16;WIDTH=201;THEME=0;OVERRIDE=false
--------------------------------------------------------------------------------------------------------------------------------------------------------------------------------------------------------
--------------------------------------------------------------------------------------------------------------------------------------------------------------------------------------------------------
--------------------------------------------------------------------------------------------------------------------------------------------------------------------------------------------------------
--------------------------------------------------------------------------------------------------------------------------------------------------------------------------------------------------------
--------------------------------------------------------------------------------------------------------------------------------------------------------------------------------------------------------
--------------------------------------------------------------------------------------------------------------------------------------------------------------------------------------------------------
--------------------------------------------------------------------------------------------------------------------------------------------------------------------------------------------------------
------------------------------------------------------g-------------------------------------------------------------------------------------------------------------------------------------------------
-----------------------------------------------------%%%--------------------------------------------------------SSSU2C----------------------------------------------------------------------------------
-------------------------------#--#------------------|||------------------------------------------------------------------------------------------------------------------------------------------------
------------------------------##--##-----------------|||--------------------------------------------------------------|---------------------------------------------------------------------------------
--------------#---#----------###--###----------------|k|------r--y-------------------------------------------------g--y---------------------------------------------------------------------------------
------------%%%---%%%%%--%%%%%%%--%%%%%------------%%%%%%%%%%%%%%%%----------------------%%%%---%%%%%%%%%%------%%%%%%%----------------%%---%%----------------------------------------------------------
------------|||---|||||--|||||||--|||||------------||||||||||||||||-------------%%%---%%%||||---||||||||||------|||||||--g-------------||---||----------------------------------------------------------
%%%%%%%%%%%%|||---|||||--|||||||--|||||%%%%%--%%%%%||||||||||||||||-------------|||---|||||||---||||||||||%%%%%%%%%%%%%%%%%%%----------||---||----------------------------------------------------------
|||||||||||||||---|||||--|||||||--||||||||||--|||||||||||||||||||||XXXXX---XXXXX|||---|||||||---|||||||||||||||||||||||||||||XXXX--XXXX||---||XXXXXXXXFXXXXXXXXXXXXXXXXXXXXXXXXXXXXXXXXXXXXXXXXXXXXXXXXX
