HEIGHT=16;WIDTH=201;THEME=0;OVERRIDE=false
--------------------------------------------------------------------------------------------------------------------------------------------------------------------------------------------------------
--------------------------------------------------------------------------------------------------------------------------------------------------------------------------------------------------------
--------------------------------------------------------------------------------------------------------------------------------------------------------------------------------------------------------
--------------------------------------------------------------------------------------------------------------------------------------------------------------------------------------------------------
--------------------------------------------------------------------------------------------------------------------------------------------------------------------------------------------------------
--------------------------------------------------------------------------------------------------------------------------------------------------------------------------------------------------------
--------------------------------------------------------------------------------------------------------------------------------------------------------------------------------------------------------
--------------------------------------------------------------------------------------------------------------------------------------------------------------------------------------------------------
--------------------------------------------------------------------------------------------------------------------------------------------------------------------------------------------------------
----------------------------------------------------------------------------#---#-----------------------------------------------------------------------------------------------------------------------
-----------------------------------------#--#------------------------------##---##--------------------------------------------------Tt------------------------------------------------------------------
----------------------------------------##--##----------------------------###---###---------#--#------------------------------------tt------------------------------------------------------------------
--------------------#--#--------------%%%%--%%%%%%%---%%%%%--%%---------%%%%%---%%%%%-----%%%--%%%--k---------------------------%%%%%%%%----------------------------------------------------------------
%%%%%%%%%%%%%---%%%%%--%%%-r---y------||||--|||||||---|||||--||--#---#--|||||---|||||-----|||--|||%%%%%%%%%%%%%%--%%%%----------||||||||----------------------------------------------------------------
|||||||||||||---|||||--|||%%%%%%%%%%%%||||--|||||||---|||||--||%%%---%%%|||||---|||||-----|||--|||||||||||||||||--||||%%%%--%%%%||||||||----------------------------------------------------------------
|||||||||||||---|||||--|||||||||||||||||||--|||||||---|||||--|||||---||||||||---|||||XXXXX|||--|||||||||||||||||--||||||||--||||||||||||XXXXXXXXFXXXXXXXXXXXXXXXXXXXXXXXXXXXXXXXXXXXXXXXXXXXXXXXXXXXXXXX
