HEIGHT=16;WIDTH=201;THEME=0;OVERRIDE=false
--------------------------------------------------------------------------------------------------------------------------------------------------------------------------------------------------------
--------------------------------------------------------------------------------------------------------------------------------------------------------------------------------------------------------
--------------------------------------------------------------------------------------------------------------------------------------------------------------------------------------------------------
--------------------------------------------------------------------------------------------------------------------------------------------------------------------------------------------------------
--------------------------------------------------------------------------------------------------------------------------------------------------------------------------------------------------------
---------------------------------------------------------------------------------------------------------------------------------------g----------------------------------------------------------------
-------------------------------------------------------------------------------------------------------------------------------------%%%----------------------------------------------------------------
-------------------------------------------------------------------------------------------------------------------------------------|||----------------------------------------------------------------
-------------------------------------------------------------------------------------------------------------------------------------|||----------------------------------------------------------------
---------------------2S-SS2----------------------------Tt-------------------------------------------#--#-----------------------------|||----------------------------------------------------------------
-------------#--#-----------------------------------Tt-tt------------------------------------------##--##----------------------------|||---%%%%---------------------------------------------------------
------------##--##-----%----------------------------tt-tt---------------------2SCSC---------------###--###---------------------------|||-G-||||---------------------------------------------------------
----------%%%%--%%%%---|------%%%%%--%%%%%------%%%%%%%%%%%---------#---#-------------%%%%%%--%%%%%%%--%%%%%%%---%%-----------------%%%%%%%%%%%%%%%%%%%%%%F%%%%%%%%%%%%%%%%%%%%%%%%%%%%%%%%%%%%%%%%%%%%%
----------||||--||||%%%%%%%%%%|||||--|||||------|||||||||||%%%%%%--##---##------------||||||--|||||||--|||||||---||--------%%%%-----||||||||||||||||||||||%|||||||||||||||||||||||||||||||||||||||||||||
%%%%%%%%%%||||--|||||||||||||||||||--|||||%%--%%|||||||||||||||||%%%%---%%%%----------||||||--|||||||--|||||||---||--------|k||--g--||||||||||||||||||||||||||||||||||||||||||||||||||||||||||||||||||||
||||||||||||||--|||||||||||||||||||--|||||||--|||||||||||||||||||||||---||||XXXXXXXXXX||||||--|||||||--|||||||---||XX---XXXXXXXXXXXX||||||||||||||||||||||||||||||||||||||||||||||||||||||||||||||||||||
