HEIGHT=16;WIDTH=201;THEME=0;OVERRIDE=false
--------------------------------------------------------------------------------------------------------------------------------------------------------------------------------------------------------
--------------------------------------------------------------------------------------------------------------------------------------------------------------------------------------------------------
--------------------------------------------------------------------------------------------------------------------------------------------------------------------------------------------------------
--------------------------------------------------------------------------------------------------------------------------------------------------------------------------------------------------------
--------------------------------------------------------------------------------------------------------------------------------------------------------------------------------------------------------
--------------------------------------------------------------------------------------------------------------------------------------------------------------------------------------------------------
--------------------------------------k-----------------------------------------------------------------------------------------------------------------------------------------------------------------
-------------------------------------%%%%%--------------------------------------------------------------------------------------------------------------------------------------------------------------
-------------------------------------|||||--------------------------------------------------------------------------------------------------------------------------------------------------------------
-------------SSS---------------------|||||--------SSSS---------------------------------------%%%%%------------------------------------------------------------------------------------------------------
-------------------------------------||||%%%%%%----------------------------------------------|||||------------------------------------------------------------------------------------------------------
-----------------------------#---#---||||||||||----------------------------------------------|||||------------------------------------SU2---------------------------------------------------------------
--------------------%%---%%%%%---%%%-||||||||||-----------------------------#---#---------%%%%%%||--------%%---%%---------------------------------------------------------------------------------------
------------%%%%%%%%||---|||||---|||-r|||||||||k-%%%%%%%%%%%---%%%%%------%%%---%%%-------||||||||--------||---||%%%%%--%%%%%---------------------------------------------------------------------------
------------||||||||||---|||||---|||%%%%%%%%%%%%%|||||||||||---|||||------|||---|||%%%%%%%%%%%%%%%%%%%--%%||---|||||||--|||||-----------g-%%%%%%%%F%%%%%%%%%%%%%%%%%%%%%%%%%%%%%%%%%%%%%%%%%%%%%%%%%%%%%
XXXXXXXXXXXX||||||||||---|||||---|||||||||||||||||||||||||||---|||||XX--XX|||---||||||||||||||||||||||--||||---|||||||--|||||XXXXXXXXXXXXX||||||||X|||||||||||||||||||||||||||||||||||||||||||||||||||||
