HEIGHT=16;WIDTH=201;THEME=0;OVERRIDE=false
--------------------------------------------------------------------------------------------------------------------------------------------------------------------------------------------------------
--------------------------------------------------------------------------------------------------------------------------------------------------------------------------------------------------------
--------------------------------------------------------------------------------------------------------------------------------------------------------------------------------------------------------
--------------------------------------------------------------------------------------------------------------------------------------------------------------------------------------------------------
--------------------------------------------------------------------------------------------------------------------------------------------------------------------------------------------------------
--------------------------------------------------------------------------------------------------------------------------------------------------------------------------------------------------------
--------------------------------------------------------------------------------------------------------------------------------------------------------------------------------------------------------
--------------------------------------------------------------------------------------------------------------------------------------------------------------------------------------------------------
---------------%%%%%------------------------------------------------------------------------%%%%--------------------------------------------------------------------------------------------------------
---------------|||||------------------------------------------------------------------------||||--------------------------------------------------------------------------------------------------------
---------------|||||------------------------------------------------------------------------||||---------------------------------------#--#-------------------------------------------------------------
---------------||||g----------tt--------------------#---#------USS-SSS----------------------||||--------------------------------------##--##------------------------------------------------------------
-----------%%%%%%%%%%%----tt--tt-------------------##---##---------------------------r-----%%%%%%%%%%%%%%------tt----------%%%---%%%%%%%--%%%%%%%%%%%%F%%%%%%%%%%%%%%%%%%%%%%%%%%%%%%%%%%%%%%%%%%%%%%%%%
-----------|||||||||||----tt--tt------------------###---###-------%-----------------%%%%%%%||||||||||||||--Tt--tt----%%--%%|||---|||||||--||||||||||||%|||||||||||||||||||||||||||||||||||||||||||||||||
-----------|||||||||||%%%%%%%%%%%%%%%%%%%--%%%%%%%%%%---%%%%%-----|----%%---%%------|||||||||||||||||||||--tt--tt----||--|||||---|||||||--||||||||||||||||||||||||||||||||||||||||||||||||||||||||||||||
XXXXXXXXXXX||||||||||||||||||||||||||||||--||||||||||---|||||XXXXXXXXXX||---||XX--XX|||||||||||||||||||||XXXXXXXXXXXX||--|||||---|||||||--||||||||||||||||||||||||||||||||||||||||||||||||||||||||||||||
