HEIGHT=16;WIDTH=201;THEME=0;OVERRIDE=false
--------------------------------------------------------------------------------------------------------------------------------------------------------------------------------------------------------
--------------------------------------------------------------------------------------------------------------------------------------------------------------------------------------------------------
--------------------------------------------------------------------------------------------------------------------------------------------------------------------------------------------------------
--------------------------------------------------------------------------------------------------------------------------------------------------------------------------------------------------------
--------------------------------------------------------------------------------------------------------------------------------------------------------------------------------------------------------
--------------------------------------------------------------------------------------------------------------------------------------------------------------------------------------------------------
--------------------------------------------------------------------------------------------------------------------------------------------------------------------------------------------------------
--------------------------------------------------------------------------------------------------------------------------------------------------------------------------------------------------------
------------------------------------------------SCCSCC--------------------------------------------------------------------------------------------------------------------------------------------------
-------------------------S2C--------------------------------CSS-----------------------------------------------------------------------------------------------------------------------------------------
-----------------------------------------------------------------SSCCSCS----------------------------------------------tt--------------------------------------------------------------------------------
----------------------------------------------------------------------------------------------------------------------tt--------------------------------------------------------------------------------
------------------------G--r-------------------%%%%%%%%%%%-y------------------%%%%%%%%--------------------------------tt--------------------------------------------------------------------------------
--------------#---#-----%%%%%%%----------------|||||||||||%%%%%%--------------||||||||%%%---%%%---%%%%%%--%%%%---%%%%%%%%%------------------------------------------------------------------------------
-------------##---##----|||||||r---------------|||||||||||||||||%%%%%%%%%%%---|||||||||||---|||---||||||--||||---|||||||||----------%%%%---%%%%%%%%%%%%F%%%%%%%%%%%%%%%%%%%%%%%%%%%%%%%%%%%%%%%%%%%%%%%%
XXXXXXXXXXXXXXX---XXXXXXXXXXXXXXXXXXXXX---XXXXX||||||||||||||||||||||||||||XXX|||||||||||---|||XXXXXXXXXXX||||---|||||||||XXXX--XXXX||||---||||||||||||X||||||||||||||||||||||||||||||||||||||||||||||||
