HEIGHT=16;WIDTH=201;THEME=0;OVERRIDE=false
--------------------------------------------------------------------------------------------------------------------------------------------------------------------------------------------------------
--------------------------------------------------------------------------------------------------------------------------------------------------------------------------------------------------------
--------------------------------------------------------------------------------------------------------------------------------------------------------------------------------------------------------
--------------------------------------------------------------------------------------------------------------------------------------------------------------------------------------------------------
--------------------------------------------------------------------------------------------------------------------------------------------------------------------------------------------------------
--------------------------------------------------------------------------------------------------------------------------------------------------------------------------------------------------------
---------------------------------------------------------------------------------------------k----------------------------------------------------------------------------------------------------------
-------------------------------------------------------------------------------------------%%%%---------------------------------------------------------------------------------------------------------
--------------------------------------------------------%%%%%%-----------------------------||||--------------------------------------------k------------------------------------------------------------
--------------------------------------------------------||||||-----------------------------||||------%%%------------------#--#----------%%%%------------------------------------------------------------
--------------------------------------------------------||||||-----------------------------||||------|||-----------------##--##--------r||||------------------------------------------------------------
-----------------------SSS------------------------------||||||-----------------------------||||------|y|----------------###--###----%%%%%%||------------------------------------------------------------
----------------Tt-------------------%%--y---------%%%%%%%%%%%%%%%%%%-------------%%%--%%%%%%%%%%%%%%%%%%%------------%%%%%--%%%%%--||||||||--%%%%%%%%F%%%%%%%%%%%%%%%%%%%%%%%%%%%%%%%%%%%%%%%%%%%%%%%%%
----------------tt------------%%---%%||%%%%%%------||||||||||||||||||-------------|||--|||||||||||||||||||%%%%%--%%%%%|||||--|||||--||||||||--||||||||%|||||||||||||||||||||||||||||||||||||||||||||||||
----------------tt------------||---||||||||||------||||||||||||||||||--%%%%---%%%%|||--||||||||||||||||||||||||--||||||||||--|||||-y|r|||g||--||||||||||||||||||||||||||||||||||||||||||||||||||||||||||
XXXXXXXXXXXXXXXXXXXXXXXXXXXXXX||---||||||||||XX--XX||||||||||||||||||XX||||---|||||||--||||||||||||||||||||||||--||||||||||--|||||XXXXXXXXXXXX||||||||||||||||||||||||||||||||||||||||||||||||||||||||||
