HEIGHT=16;WIDTH=201;THEME=0;OVERRIDE=false
--------------------------------------------------------------------------------------------------------------------------------------------------------------------------------------------------------
--------------------------------------------------------------------------------------------------------------------------------------------------------------------------------------------------------
--------------------------------------------------------------------------------------------------------------------------------------------------------------------------------------------------------
--------------------------------------------------------------------------------------------------------------------------------------------------------------------------------------------------------
--------------------------------------------------------------------------------------------------------------------------------------------------------------------------------------------------------
--------------------------------------------------------------------------------------------------------------------------------------------------------------------------------------------------------
--------------------------------------------------------------------------------------------------------------------------------------------------------------------------------------------------------
--------------------------------------------------------------------------------------------------------------------------------------------------------------------------------------------------------
--------------------------------------------------------------------------------------------------------------------------------------------------------------------------------------------------------
--------------------------------------------------------------------------------------------------------------------------------------------------------------------------------------------------------
----------------------------------------------------------------------#---#-----------------------------------------------------------------------------------------------------------------------------
-------------------USS2S2--------------------------------------------##---##------------------------------------------------------%%%%%%----------------------------------------------------------------
----------%%%%%--------------------------------------------#--#-----###---###--%%%%---%%%%---------------%%%%%--%%%%%%%%%--%%%%---||||||----------------------------------------------------------------
%%%%%%%%%%|||||-----------%%--%%-------------%%%%---%%%%--##--##--%%%%%---%%%%%||||---||||---#--#---%%%%%|||||--|||||||||--||||---|||yr|----------------------------------------------------------------
|||||||||||||||----k---g--||--||-------------||||---||||%%%%--%%%%|||||---|||||||||---||||--##--##--||||||||||--|||||||||--||||%%%%%%%%%%%--------------------------------------------------------------
|||||||||||||||XXXXXXXXXXX||--||XXXXX---XXXXX||||---||||||||--|||||||||---|||||||||---||||XXXX--XXXX||||||||||--|||||||||--|||||||||||||||XXXXXXXXFXXXXXXXXXXXXXXXXXXXXXXXXXXXXXXXXXXXXXXXXXXXXXXXXXXXXX
