HEIGHT=16;WIDTH=201;THEME=0;OVERRIDE=false
--------------------------------------------------------------------------------------------------------------------------------------------------------------------------------------------------------
--------------------------------------------------------------------------------------------------------------------------------------------------------------------------------------------------------
--------------------------------------------------------------------------------------------------------------------------------------------------------------------------------------------------------
--------------------------------------------------------------------------------------------------------------------------------------------------------------------------------------------------------
--------------------------------------------------------------------------------------------------------------------------------------------------------------------------------------------------------
--------------------------------------------------------------------------------------------------------------------------------------------------------------------------------------------------------
--------------------------------------------------------------------------------------------------------------------------------------------------------------------------------------------------------
----------------------------------------------------------------------------------------------------------%%%-------------------------------------------------------------------------------------------
----------------------------------------------------------------------------------------------------------|||-------------------------------------------------------------------------------------------
----------------------------------------------------------------------------------------------------------|||-------------------------------------------------------------------------------------------
----------------------------------------------------------------------------------------------------------|||-------------------------------------------------------------------------------------------
----------------------------------------------------------------------------------------------------------||%%%%%---------------------------------------------------------------------------------------
-------------%%%--%%%----------------------------------------------%%%--%%%%%%--%%%-----------------------|||||||---------------%%%%---%%%%%%%%%%%%F%%%%%%%%%%%%%%%%%%%%%%%%%%%%%%%%%%%%%%%%%%%%%%%%%%%%
%%%%%%%%%%%%%|||--|||-----------------------y---%%%%--%%%%---------|||--||||||--|||-----------------------|||||||--%%%%%---%%%%%||||---||||||||||||%||||||||||||||||||||||||||||||||||||||||||||||||||||
||||||||||||||||--|||--------------------%%%%%%%||||--||||---------|||--||||||--|||-----------%%%%--%%%%-y|y|||||--|||||---|||||||||---|||||||||||||||||||||||||||||||||||||||||||||||||||||||||||||||||
||||||||||||||||--|||XXXX--XXXXXXXX--XXXX|||||||||||--||||XXX---XXX|||--||||||--|||XXXX---XXXX||||--||||XXXXXXXXXXX|||||---|||||||||---|||||||||||||||||||||||||||||||||||||||||||||||||||||||||||||||||
