HEIGHT=16;WIDTH=201;THEME=0;OVERRIDE=false
--------------------------------------------------------------------------------------------------------------------------------------------------------------------------------------------------------
--------------------------------------------------------------------------------------------------------------------------------------------------------------------------------------------------------
--------------------------------------------------------------------------------------------------------------------------------------------------------------------------------------------------------
--------------------------------------------------------------------------------------------------------------------------------------------------------------------------------------------------------
--------------------------------------------------------------------------------------------------------------------------------------------------------------------------------------------------------
--------------------------------------------------------------------------%%%%%-------------------------------------------------------------------------------------------------------------------------
--------------------------------------------------------------------------|||||-------------------------------------------------------------------------------------------------------------------------
--------------------------------------------------------------------------|||||-------------------------------------------------------------------------------------------------------------------------
------------------------------------------------------------------------y-|||||-------------------------------------------------------------------------------------------------------------------------
------------------------------------------------------------------------%%%%%||---------------------------------------y---------------------------------------------------------------------------------
------------------------------------------------------------------------|||||||------------------------------------%%%%---------------------------------------------------------------------------------
-----------------------------------------------------------#---#--------|||||y|Y-----------------------------------ky||---------------------------------------------------------------------------------
--------------------%%%%%---%%%%%%%--%%-------------------##---##---%%%%%%%%%%%%%%%%--------%%%---%%%-----%%---%%%%%%%%%%%%%----#--#--------------------------------------------------------------------
--------------------|||||---|||||||--||%%%---%%%---------###---###--||||||||||||||||--#--#--|||---|||-----||---|||||||||||||---##--##---%%%%%%%%F%%%%%%%%%%%%%%%%%%%%%%%%%%%%%%%%%%%%%%%%%%%%%%%%%%%%%%%
-----------%%%---%%%|||||---|||||||--|||||---|||-------%%%%%---%%%%%||||||||||||||||%%%--%%%|||---|||-----||---|||||||||||||--###--###--||||||||%|||||||||||||||||||||||||||||||||||||||||||||||||||||||
XXXXXXXXXXX|||---||||||||---|||||||--|||||---|||XXXXXXX|||||---||||||||||||||||||||||||--||||||---|||XXXXX||---|||||||||||||XXXXX--XXXXX||||||||||||||||||||||||||||||||||||||||||||||||||||||||||||||||
