HEIGHT=16;WIDTH=201;THEME=0;OVERRIDE=false
--------------------------------------------------------------------------------------------------------------------------------------------------------------------------------------------------------
--------------------------------------------------------------------------------------------------------------------------------------------------------------------------------------------------------
--------------------------------------------------------------------------------------------------------------------------------------------------------------------------------------------------------
--------------------------------------------------------------------------------------------------------------------------------------------------------------------------------------------------------
--------------------------------------------------------------------------------------------------------------------------------------------------------------------------------------------------------
--------------------------------------------------------------------------------------------------------------------------------------------------------------------------------------------------------
--------------------------------------------------------------------------------------------------------------------------------------------------------------------------------------------------------
--------------------------------------------------------------------------------------------------------------------------------------------------------------------------------------------------------
-------------------------------------%%%----------------------------------------------------------------------------------------------------------------------------------------------------------------
----------------US22SS---------------|||----------------------------------------------------------------------------------------------------------------------------------------------------------------
-------------------------------------|||------------------------------------------------------------------SC22-------------tt-tt------------------------------------------------------------------------
-------------------------------------|||------------yy------------#--#-----------------------------------------------------tt-tt------------------------------------------------------------------------
%%%%%%%%%%%%%%----------------------%%%%%%%%%%%%%%%%%%%----------##--##-------------%%%%%%--------------------%------------tt-tt------------------------------------------------------------------------
||||||||||||||%%%%%%%%%%%-----------|||||||||||||||||||%%---%%--###--###--%%%%%%%%%%||||||---------------k----|--------%%%%%%%%%%-----------------------------------------------------------------------
|||||||||||||||||||||||||%%%%---%%%%|||||||||||||||||||||---||%%%%%--%%%%%||||||||||||||||%%%%%---%%%%%%%%%%%%%%%------||||||||||%%%%%---%%%%%----------------------------------------------------------
|||||||||||||||||||||||||||||---|||||||||||||||||||||||||---|||||||--||||||||||||||||||||||||||---|||||||||||||||XX--XX|||||||||||||||---|||||XXXXXXXXFXXXXXXXXXXXXXXXXXXXXXXXXXXXXXXXXXXXXXXXXXXXXXXXXX
