HEIGHT=16;WIDTH=201;THEME=0;OVERRIDE=false
--------------------------------------------------------------------------------------------------------------------------------------------------------------------------------------------------------
--------------------------------------------------------------------------------------------------------------------------------------------------------------------------------------------------------
--------------------------------------------------------------------------------------------------------------------------------------------------------------------------------------------------------
--------------------------------------------------------------------------------------------------------------------------------------------------------------------------------------------------------
-----------------------------------------------------------------------------g--------------------------------------------------------------------------------------------------------------------------
-----------------------------------------------------------------------------%%%%%----------------------------------------------------------------------------------------------------------------------
-----------------------------------------------------------------------------|||||----------------------------------------------------------------------------------------------------------------------
-------------------------------------------------------------------------r---|||||----------------------------------------------------------------------------------------------------------------------
---------------------------------------------------------------------%%%%%%--|||||----------------------------------------------------------------------------------------------------------------------
---------------------------------------------------------------------||||||--|||||----------------------------------------------------------------------------------------------------------------------
---------------------------------------------------------------------||||||--|||||----------------------------------------------------------------------------------------------------------------------
----------------------------#---#------------------------------------||||k|g-|||||----------------------------------------------------------------------------------------------------------------------
---------------------------##---##----g---%%%%%--%%%%%%%%%%---%%%%%%%%%%%%%%%%%%%%%%-----------------------%%--%%----------------%%%%%--%%%%%%%%%%%%%F%%%%%%%%%%%%%%%%%%%%%%%%%%%%%%%%%%%%%%%%%%%%%%%%%%
-------------------------%%%%---%%%%%%%%%%|||||--||||||||||---||||||||||||||||||||||%%%%%---%%%%%----------||--||----------------|||||--|||||||||||||%||||||||||||||||||||||||||||||||||||||||||||||||||
%%%%%%%%%%%%-------------||||---|||||||||||||||--||||||||||---|||||||||||||||||||||||||||---|||||----------||--||----------------|||||--||||||||||||||||||||||||||||||||||||||||||||||||||||||||||||||||
||||||||||||XXXXX---XXXXX||||---|||||||||||||||--||||||||||---|||||||||||||||||||||||||||---|||||XXXX--XXXX||--||XXX--XXXXXX--XXX|||||--||||||||||||||||||||||||||||||||||||||||||||||||||||||||||||||||
