HEIGHT=16;WIDTH=201;THEME=0;OVERRIDE=false
--------------------------------------------------------------------------------------------------------------------------------------------------------------------------------------------------------
--------------------------------------------------------------------------------------------------------------------------------------------------------------------------------------------------------
--------------------------------------------------------------------------------------------------------------------------------------------------------------------------------------------------------
--------------------------------------------------------------------------------------------------------------------------------------------------------------------------------------------------------
--------------------------------------------------------------------------------------------------------------------------------------------------------------------------------------------------------
--------------------------------------------------------------------------------------------------------------------------------------------------------------------------------------------------------
--------------------------------------------------------------------------------------------------------------------------------------------------------------------------------------------------------
--------------------------------------------------------------------------------------------------------------------------------------------------------------------------------------------------------
--------------------------------------------------------------------------------------------------------------------------------------------------------------------------------------------------------
-----------------------------------------------------------------------------------------------tt-------------------------------------------------------------------------------------------------------
-----------------------------------------------------------------------------------------------tt-tt-tt-------------------------------------------------------------------------------------------------
-----------------------------------------------------------------------------#---#-------------tt-tt-tt------------------------------%%%%%--------------------------------------------------------------
--------------------------------------%%%%%%%%%---%%%%---------------------%%%---%%%-------%%%%%%%%%%%%%%-------%%%--%%%-------------y||||--------------------------------------------------------------
-------------%%%%%%%%%%--%%%%%%%%--%%%|||||||||---||||---------------%%--%%|||---|||-------||||||||||||||-------|||--|||----------%%%%%%%%%%%%%---------------------------------------------------------
%%%%%%%%%%%%%||||||||||--||||||||--||||||||||||---||||%%%%%----------||--|||||---|||-------||||||||||||||%%---%%|||--|||%%%%--%%%%|||||||||||||%%%%%%%%F%%%%%%%%%%%%%%%%%%%%%%%%%%%%%%%%%%%%%%%%%%%%%%%%
|||||||||||||||||||||||--||||||||--||||||||||||---|||||||||XXXX--XXXX||--|||||---|||XX---XX||||||||||||||||---|||||--|||||||--|||||||||||||||||||||||||X||||||||||||||||||||||||||||||||||||||||||||||||
