HEIGHT=16;WIDTH=201;THEME=0;OVERRIDE=false
--------------------------------------------------------------------------------------------------------------------------------------------------------------------------------------------------------
--------------------------------------------------------------------------------------------------------------------------------------------------------------------------------------------------------
-------------------------------------------------------------------%%%%---------------------------------------------------------------------------------------------------------------------------------
-------------------------------------------------------------------||||---------------------------------------------------------------------------------------------------------------------------------
-------------------------------------------------------------------||||---------------------------------------------------------------------------------------------------------------------------------
---------------------------------------------------------------g---||||---------------------------------------------------------------------------------------------------------------------------------
-------------------------------------------------------------%%%%--||||---------------------------------------------------------------------------------------------------------------------------------
-------------------------------------------------------------||||--||||---------------------------------------------------------------------------------------------------------------------------------
-------------------------------------------------------------||||--||||---------------------------------------------------------------------------------------------------------------------------------
-------------------------------------------------------------||||--||||-------------------------------SCSSS---------------------------------------------------------------------------------------------
---------------Tt-Tt-----------------------------------------||||--||||--%%%----------------------------------------------------------------------------------------------------------------------------
---------------tt-tt----SSS---------------------------------G||||--||||-k|||----------------------------------------------------------------------------------------------------------------------------
-----------%%%%%%%%%%%%------------------------------------%%%%%%%%%%%%%%%%%%%-----------------------g--------------------------------------------------------------------------------------------------
-----------||||||||||||------------------------------------|||||||||||||||||||%%%%---%%%%----------%%%%%%%%%-----------%%%%%%%%%%%%%%---%%%%%%%%%%%F%%%%%%%%%%%%%%%%%%%%%%%%%%%%%%%%%%%%%%%%%%%%%%%%%%%%
%%%%%%%%%%%||||||||||||------------------------------------|||||||||||||||||||||||---||||%%%%--%%%%|||||||||%%%%---%%%%||||||||||||||---|||||||||||%||||||||||||||||||||||||||||||||||||||||||||||||||||
|||||||||||||||||||||||XXXXXXXXXXX--XXXXXXXXX---XXXXXX---XX|||||||||||||||||||||||---||||||||--|||||||||||||||||---||||||||||||||||||---||||||||||||||||||||||||||||||||||||||||||||||||||||||||||||||||
