HEIGHT=16;WIDTH=201;THEME=0;OVERRIDE=false
--------------------------------------------------------------------------------------------------------------------------------------------------------------------------------------------------------
--------------------------------------------------------------------------------------------------------------------------------------------------------------------------------------------------------
--------------------------------------------------------------------------------------------------------------------------------------------------------------------------------------------------------
--------------------------------------------------------------------------------------------------------------------------------------------------------------------------------------------------------
--------------------------------------------------------------------------------------------------------------------------------------------------------------------------------------------------------
--------------------------------------------------------------------------------------------------------------------------------------------------------------------------------------------------------
--------------------------------------------------------------------------------------------------------------------------------------------------------------------------------------------------------
--------------------------------------------------------------------------------------------------------------------------------------------------------------------------------------------------------
---------------------------------------------------------------%%%%-------------------------------------------------------------------------------------------------------------------------------------
---------------------------------------------------------------||||---------------------------------------------------------------S-CCS-----------------------------------------------------------------
---------------------------------------------------------------||||--------------SCUS-------------------------------------------------------------------------------------------------------------------
---------------------------------------------------------------||||----------------------------%%%---------------------------------%--------------------------------------------------------------------
-------------------------------------------------#---#--%%%%%%%%%%%%%---------%%---------------|||------------%%---%%--%%%%%%%-----|--------------------------------------------------------------------
-----------------------------------------------%%%---%%%|||||||||||||%%%---%%%||------%%%%%%%%-|||------------||---||%%|||||||%%%%%%%%%%%%%%%%%%%F%%%%%%%%%%%%%%%%%%%%%%%%%%%%%%%%%%%%%%%%%%%%%%%%%%%%%%
%%%%%%%%%%%%%%%%%%%%%---%%%%--#---#------------|||---|||||||||||||||||||---|||||%%%%%%||||||||-|||------------||---||||||||||||||||||||||||||||||%||||||||||||||||||||||||||||||||||||||||||||||||||||||
|||||||||||||||||||||---||||XXX---XXXXXXX--XXXX|||---|||||||||||||||||||---|||||||||||||||||||XXXXXXXXXXXXXXXX||---|||||||||||||||||||||||||||||||||||||||||||||||||||||||||||||||||||||||||||||||||||||
