HEIGHT=16;WIDTH=201;THEME=0;OVERRIDE=false
--------------------------------------------------------------------------------------------------------------------------------------------------------------------------------------------------------
--------------------------------------------------------------------------------------------------------------------------------------------------------------------------------------------------------
--------------------------------------------------------------------------------------------------------------------------------------------------------------------------------------------------------
--------------------------------------------------------------------------------------------------------------------------------------------------------------------------------------------------------
--------------------------------------------------------------------------------------------------------------------------------------------------------------------------------------------------------
--------------------------------------------------------------------------------------------------------------------------------------------------------------------------------------------------------
--------------------------------------------------------------------------------------------------------------------------------------------------------------------------------------------------------
--------------------------------------------------------------------------------------------------------------------------------------------------------------------------------------------------------
-----------------------------------------%%%%%%%-------------------------------------------------------------------------------------SCUSS2U------------------------------------------------------------
-----------------------------------------|||||||--------------------------------------------------------------------------------------------------------------------------------------------------------
-----------------------------------------|||||||--------------------------------------------------------------------------------------------------------------------------------------------------------
-----------------------------------------||||y||------------------------#---#----#--#--------------------------------------------------r----y-----------------------------------------------------------
--------------------------------#---#--%%%%%%%%%%%%-------------------%%%---%%%%%%--%%%%%%%%-----------%%%%%--%%%%%----------------%%%%%%%%%%%----------------------------------------------------------
------------------------------%%%---%%%||||||||||||-----------%%--%%--|||---||||||--||||||||-----------|||||--|||||--------%%%--%%%|||||||||||----------------------------------------------------------
--------------------------%%%%|||---|||||||||||||||%%%%---%%%%||--||%%|||---||||||--||||||||%%%%---%%%%|||||--|||||%%%--%%%|||--||||||||||||||----------------------------------------------------------
XXXXXXXXXXXXXXXXXXX--XXXXX|||||||---|||||||||||||||||||---||||||--|||||||---||||||--||||||||||||---|||||||||--||||||||--||||||--||||||||||||||XXXXXXXXFXXXXXXXXXXXXXXXXXXXXXXXXXXXXXXXXXXXXXXXXXXXXXXXXX
