HEIGHT=16;WIDTH=201;THEME=0;OVERRIDE=false
--------------------------------------------------------------------------------------------------------------------------------------------------------------------------------------------------------
--------------------------------------------------------------------------------------------------------------------------------------------------------------------------------------------------------
--------------------------------------------------------------------------------------------------------------------------------------------------------------------------------------------------------
--------------------------------------------------------------------------------------------------------------------------------------------------------------------------------------------------------
------------------------------------------------------------------%%%%%%%-------------------------------------------------------------------------------------------------------------------------------
------------------------------------------------------------------|||||||-------------------------------------------------------------------------------------------------------------------------------
------------------------------------------------------------------|||||||-------------------------------------------------------------------------------------------------------------------------------
------------------------------------------------------------------|||||||-------------------------------------------------------------------------------------------------------------------------------
----------------------------------------SCS------------------%%%--|||||||---------------------------g----------------------%%%%%%%----------------------------------------------------------------------
-------------------------------------------------------------|||--|||||||---------------------------%%%--------------------|||||||----------------------------------------------------------------------
-------------------------------------------------------------|||--|||||||---------------------------|||--------------------|||||||----------------------------------------------------------------------
-----------------------------------------yr------------------|||--|||||||-----SSC-------------------|||--------------------k|||r||----------------------------------------------------------------------
----------------%%%%--%%%%--------------%%%-----------------%%%%%%%%%%%%%%%%%-----------------------|||-------------%%--%%%%%%%%%%%%--------------------------------------------------------------------
--------------%%||||--||||---#---#------|||----------#---#--|||||||||||||||||-------%%%%%--%%%%%--%%%%%%%-----------||--||||||||||||--------------------------------------------------------------------
%%%%%%%%%%%%%%||||||--||||--##---##-----|||--------%%%---%%%|||||||||||||||||--Y----|||||--|||||--||K||||-----------||--||||||||||||%%---%%%%%%%%%%F%%%%%%%%%%%%%%%%%%%%%%%%%%%%%%%%%%%%%%%%%%%%%%%%%%%%
||||||||||||||||||||--||||XXXX---XXXXXXXXXXXXXXXXXX|||---||||||||||||||||||||XXXXXXX|||||--|||||XXXXXXXXXXXXXXXXXXXX||--||||||||||||||---||||||||||X||||||||||||||||||||||||||||||||||||||||||||||||||||
