HEIGHT=16;WIDTH=201;THEME=0;OVERRIDE=false
--------------------------------------------------------------------------------------------------------------------------------------------------------------------------------------------------------
--------------------------------------------------------------------------------------------------------------------------------------------------------------------------------------------------------
--------------------------------------------------------------------------------------------------------------------------------------------------------------------------------------------------------
--------------------------------------------------------------------------------------------------------------------------------------------------------------------------------------------------------
--------------------------------------------------------------------------------------------------------------------------------------------------------------------------------------------------------
-------------------------------------------------------------------------------------------%%%%---------------------------------------------------------------------------------------------------------
-------------------------------------------------------------------------------------------||||---------------------------------------------------------------------------------------------------------
-------------------------------------------------------------------------------------------|||%%%%------------------------------------------------------------------------------------------------------
-------------------------------------------------------------------------------------------|||||||------------------------------------------------------------------------------------------------------
---------------------------------------------------------------------------------------%%%%%||||||------------------g-----------------------------------------------------------------------------------
----------------------------------------%%%%%%-----------------------------------------|||||||||||-----------------%%%%---------------------------------------------------------------------------------
------------------------#--#------------||||||----------K------------------------------|||||||||||-----------------||||---------------------------------------------------------------------------------
----------------------%%%--%%%----------||||||-----%%%%%%%%%---------------%%%%--%%%%--|||||||||||r----------------||||---------%%%%%--%%%%%------------------------------------------------------------
----------%%%---------|||--|||----------||r|||-----|||||||||---------#--#--||||--||||%%%%%%%%%%%%%%%%%----------%%%%%%%%%%%%%%--|||||--|||||------------------------------------------------------------
----------|||%%%---%%%|||--|||--------%%%%%%%%%%%%%|||||||||-------%%%--%%%||||--|||||||||||||||||||||%%%%--%%%%||||||||||||||--|||||--|||||%%%%%%%%F%%%%%%%%%%%%%%%%%%%%%%%%%%%%%%%%%%%%%%%%%%%%%%%%%%%
XXXXXXXXXX||||||---||||||--|||XXX--XXX||||||||||||||||||||||XX---XX|||--|||||||--|||||||||||||||||||||||||--||||||||||||||||||XX|||||--|||||||||||||X|||||||||||||||||||||||||||||||||||||||||||||||||||
