HEIGHT=16;WIDTH=201;THEME=0;OVERRIDE=false
--------------------------------------------------------------------------------------------------------------------------------------------------------------------------------------------------------
--------------------------------------------------------------------------------------------------------------------------------------------------------------------------------------------------------
--------------------------------------------------------------------------------------------------------------------------------------------------------------------------------------------------------
--------------------------------------------------------------------------------------------------------------------------------------------------------------------------------------------------------
--------------------------------------------------------------------------------------------------------------------------------------------------------------------------------------------------------
--------------------------------------------------------------------------------------------------------------------------------------------------------------------------------------------------------
--------------------------------------------------------------------------------------------------------------------------------------------------------------------------------------------------------
--------------------------------------------------------------------------------------------------------------------------------------------------------------------------------------------------------
--------------------------------------------------------------C-S---------------------------------------------------------------------------------------------------------------------------------------
--------------------------------------------------------------------------------------------------------------------------------------------------------------------------------------------------------
------------------------SSUCSSSS-------------------------------%------USS-CUS---------------------------------------------------------------------------------------------------------------------------
--------------------------------------------------------------y|--------------------------------------------#--#----------------------------------------------------------------------------------------
------------------------------------------------%%%%%--%%%%%%%%%%%%------|--------------------%%%%%--%%%%%%%%--%%%---------------------%%%%--%%%%-------------------------------------------------------
%%%%%%%%%%%---------------g------%%--%%%%%---%%%|||||--||||||||||||--gg--r-g------------------|||||--||||||||--|||-------------%%%--%%%||||--||||-------------------------------------------------------
|||||||||||------------%%%%%%%%%%||--|||||---||||||||--||||||||||||%%%%%%%%%%%--#--#----#--#--|||||--||||||||--|||-------------|||--|||||||--||||%%%%%%%%F%%%%%%%%%%%%%%%%%%%%%%%%%%%%%%%%%%%%%%%%%%%%%%
|||||||||||XXXXX--XXXXX||||||||||||--|||||---||||||||--|||||||||||||||||||||||XXX--XXXXXX--XXX|||||--||||||||--|||XXXXX---XXXXX|||--|||||||--||||||||||||X||||||||||||||||||||||||||||||||||||||||||||||
