HEIGHT=16;WIDTH=201;THEME=0;OVERRIDE=false
--------------------------------------------------------------------------------------------------------------------------------------------------------------------------------------------------------
--------------------------------------------------------------------------------------------------------------------------------------------------------------------------------------------------------
--------------------------------------------------------------------------------------------------------------------------------------------------------------------------------------------------------
--------------------------------------------------------------------------------------------------------------------------------------------------------------------------------------------------------
--------------------------------------------------------------------------------------------------------------------------------------------------------------------------------------------------------
--------------------------------------------------------------------------------------------------------------------------------------------------------------------------------------------------------
--------------------------------------------------------------------------------------------------------------------------------------------------------------------------------------------------------
--------------------------------------------------------------------------------------------------------------------------------------------------------------------------------------------------------
--------------------------------------------------------------------------------------------------------------------------------------------------------------------------------------------------------
---------------------------------------------------------------SCSSS------------------------------------------------------------------------------------------------------------------------------------
--------------------------------------------------------------------------------------------------------------------------------------------------------------------------------------------------------
----------------------%%%%%--------SC2----------------------------------------------#---#---------------------------------------------------------------------------------------------------------------
%%%%%%%%%%%%%---------|||||------------------%%--%%---#---#------------------------##---##------------------------------%%%%%--%%%%%----------%%%%%%%%F%%%%%%%%%%%%%%%%%%%%%%%%%%%%%%%%%%%%%%%%%%%%%%%%%
|||||||||||||---------|||||-g-g----------Tt--||--||--##---##--%%%%%%%%------%%%%%%%%%---%%%%%%--%%-----------%%%%%%%%%%%|||||--|||||%%%%--%%%%||||||||%|||||||||||||||||||||||||||||||||||||||||||||||||
|||||||||||||%%--%%%%%%%%%%%%%%%%%--ry---tt--||--||%%%%---%%%%||||||||------|||||||||---||||||--||%%%%---%%%%||||||||||||||||--|||||||||--||||||||||||||||||||||||||||||||||||||||||||||||||||||||||||||
|||||||||||||||--|||||||||||||||||XXXXXXXXXXX||--||||||---||||||||||||XX--XX|||||||||---||||||--||||||---||||||||||||||||||||--|||||||||--||||||||||||||||||||||||||||||||||||||||||||||||||||||||||||||
