HEIGHT=16;WIDTH=201;THEME=0;OVERRIDE=false
--------------------------------------------------------------------------------------------------------------------------------------------------------------------------------------------------------
--------------------------------------------------------------------------------------------------------------------------------------------------------------------------------------------------------
--------------------------------------------------------------------------------------------------------------------------------------------------------------------------------------------------------
--------------------------------------------------------------------------------------------------------------------------------------------------------------------------------------------------------
--------------------------------------------------------------------------------------------------------------------------------------------------------------------------------------------------------
--------------------------------------------------------------------------------------------------------------------------------------------------------------------------------------------------------
--------------------------------------------------------------------------------------------------------------------------------------------------------------------------------------------------------
--------------------------------------------------------------------------------------------------------------------------------------------------------------------------------------------------------
------------------------------------------------------S2-SSUCS------------------------------------------------------------------------------------------------------------------------------------------
--------------------------------------------------------------------------------------------------------------------------------------------------------------------------------------------------------
--------------------------------------------------------%-----------------------------------------------------------------------------------------------------------------------------------------------
-----------------#---#--------------------------------k-|---g--------------------------------------------------------------SSS22------------------------------------------------------------------------
%%%%%%%%%%%%%---##---##------------------------------%%%%%%%%%%---------------------------------------------%%--%%----------------%%--%%----------------------------------------------------------------
|||||||||||||--###---###-----#--#---%%%%---%%%%%%--%%||||||||||%%%%%---%%%%%----------------%%%%------------||--||----------------||--||----------------------------------------------------------------
|||||||||||||%%%%%---%%%%%--##--##--||||---||||||--|||||||||||||||||---|||||---------%%%%%%%||||%%%%%--%%%%%||--||%%%--%%%-r------||--||%%%%%%%%F%%%%%%%%%%%%%%%%%%%%%%%%%%%%%%%%%%%%%%%%%%%%%%%%%%%%%%%
||||||||||||||||||---|||||XXXX--XXXX||||---||||||--|||||||||||||||||---|||||XXX---XXX||||||||||||||||--|||||||--|||||--|||XXXXXXXX||--||||||||||X|||||||||||||||||||||||||||||||||||||||||||||||||||||||
