HEIGHT=16;WIDTH=201;THEME=0;OVERRIDE=false
--------------------------------------------------------------------------------------------------------------------------------------------------------------------------------------------------------
--------------------------------------------------------------------------------------------------------------------------------------------------------------------------------------------------------
--------------------------------------------------------------------------------------------------------------------------------------------------------------------------------------------------------
--------------------------------------------------------------------------------------------------------------------------------------------------------------------------------------------------------
-------------------------------CCSS---------------------------------------------------------------------------------------------------------------------------------------------------------------------
--------------------------------------------------------------------------------------------------------------------------------------------------------------------------------------------------------
--------------------------------------------------------------------------------------------------------------------------------------------------------------------------------------------------------
----------------------------y---------------------------------------------------------------------------------------------------------------------------------------------------------------------------
----------------------------%%%%%%%---------------------------------------------------------------------------------------------------------------------------------------------------------------------
----------------------------|||||||---------------------------------------------------------------------------SU2---------------------------------------------------------------------------------------
----------------------------|||||||----------------------------------UCS---------------CC22-------------------------------------------------------------------------------------------------------------
-------------#---#----------||||||k-----r--------------------------------------------------------------------------------------------y------------------------------------------------------------------
%%%%%%%%%%--##---##--------%%%%%%%%%%%%%%%%%%%--------tt------------------------------------------------------------%%%---%%%%%---%%-%%%%%--------------------------------------------------------------
||||||||||%%%%---%%%%------|||||||||||||||||||--Tt----tt---%%---%%---------%%%---%%%-------------#--#---------%%%%--|||---|||||---||-|||||-----%%%%%%%%F%%%%%%%%%%%%%%%%%%%%%%%%%%%%%%%%%%%%%%%%%%%%%%%%
||||||||||||||---||||------|||||||||||||||||||--tt----tt---||---||%%%%%%%%%|||---|||%%%%%%%%%%--##--##-----r--||||--|||---|||||---||-|||||-----||||||||%||||||||||||||||||||||||||||||||||||||||||||||||
||||||||||||||---||||XX--XX|||||||||||||||||||XXXXXXXXXXXXX||---||||||||||||||---|||||||||||||XXXX--XXXXXXXXXXXXXXXX|||---|||||---||XXXXXXXXXXX|||||||||||||||||||||||||||||||||||||||||||||||||||||||||
