HEIGHT=16;WIDTH=201;THEME=0;OVERRIDE=false
--------------------------------------------------------------------------------------------------------------------------------------------------------------------------------------------------------
--------------------------------------------------------------------------------------------------------------------------------------------------------------------------------------------------------
--------------------------------------------------------------------------------------------------------------------------------------------------------------------------------------------------------
--------------------------------------------------------------------------------------------------------------------------------------------------------------------------------------------------------
--------------------------------------------------------------------------------------------------------------------------------------------------------------------------------------------------------
--------------------------------------------------------------------------------------------------------------------------------------------------------------------------------------------------------
--------------------------------------------------------------------------------------------------------------------------------------------------------------------------------------------------------
--------------------------------------------------------------------------------------------------SS----------------------------------------------------------------------------------------------------
--------------------------------------------------------------------------------------------------------------------------------------------------------------------------------------------------------
------------------CUSS---------------------------------------------------------------------------%------------------------------------------------------------------------------------------------------
------------------------------------------SSSSCU-------------------------------------------------|-g----SC-S--------------------------------------------------------------------------------------------
----------------------------------------------------------------------------------------------%%%%%%----------------------------------------------------------------------------------------------------
------------------------k---#--#--%%---%%---------------------------------%%%%%--%%%%%--------||||||------%---------------------------------------------------------------------------------------------
----------------%%%%%%%%%%%%%--%%%||---||--------------------#--#---------|||||--|||||--------||||||------|-----%%%%%%%%%%%%%%%%---%%%%%%%%%%%%%F%%%%%%%%%%%%%%%%%%%%%%%%%%%%%%%%%%%%%%%%%%%%%%%%%%%%%%%
-----------%%%%%|||||||||||||--|||||---||%%%%%%%%%%--------%%%--%%%%%---%%|||||--|||||%%%%%---||||||--%%%%%%%%%%||||||||||||||||---|||||||||||||%|||||||||||||||||||||||||||||||||||||||||||||||||||||||
XXXXXXXXXXX||||||||||||||||||--|||||---||||||||||||XXX--XXX|||--|||||---|||||||--||||||||||XXXXXXXXXXX||||||||||||||||||||||||||---|||||||||||||||||||||||||||||||||||||||||||||||||||||||||||||||||||||
