HEIGHT=16;WIDTH=201;THEME=0;OVERRIDE=false
--------------------------------------------------------------------------------------------------------------------------------------------------------------------------------------------------------
--------------------------------------------------------------------------------------------------------------------------------------------------------------------------------------------------------
--------------------------------------------------------------------------------------------------------------------------------------------------------------------------------------------------------
--------------------------------------------------------------------------------------------------------------------------------------------------------------------------------------------------------
--------------------------------------------------------------------------------------------------------------------------------------------------------------------------------------------------------
--------------------------------------------------------------------------------------------------------------------------------------------------------------------------------------------------------
--------------------------------------------------------------------------------------------------------------------------------------------------------------------------------------------------------
------------------------------------------------------------------------------%%%%%%--------------------------------------------------------------------------------------------------------------------
------------------------------------------------------------------------------||||||--------------------------------------------------------------------------------------------------------------------
------------------------------------------------------------------------------||||||--------------------------------------------------------------------------------------------------------------------
------------------------------------------------------------------------------|%%%%|------CSS22--------------------------tt-----------------------------------------------------------------------------
------------------------------#--#-------------------------------------------k||||||-------------------------------------tt-----------------------------------------------------------------------------
--------------------%%---%%--##--##-----------------------------%%--%%------%%%%%%%%%%---------------------------------%%%%%%%%%%-----------------------------------------------------------------------
------------%%%--%%%||---||%%%%--%%%%--#--#---------------%%--%%||--||------||||||||||--r--------%%%--%%%--------------||||||||||-------%%%%%%%%F%%%%%%%%%%%%%%%%%%%%%%%%%%%%%%%%%%%%%%%%%%%%%%%%%%%%%%%
%%%%%%%%%%%%|||--|||||---||||||--||||%%%--%%%-------------||--||||--||%%%%%%||||||||||%%%%%%%%%%%|||--|||-y-------yy---||||||||||%%%%%%%||||||||%|||||||||||||||||||||||||||||||||||||||||||||||||||||||
|||||||||||||||--|||||---||||||--|||||||--|||XXXXX---XXXXX||--||||--||||||||||||||||||||||||||||||||--|||XXXXXXXXXXXXXX|||||||||||||||||||||||||||||||||||||||||||||||||||||||||||||||||||||||||||||||||
