HEIGHT=16;WIDTH=201;THEME=0;OVERRIDE=false
--------------------------------------------------------------------------------------------------------------------------------------------------------------------------------------------------------
--------------------------------------------------------------------------------------------------------------------------------------------------------------------------------------------------------
--------------------------------------------------------------------------------------------------------------------------------------------------------------------------------------------------------
--------------------------------------------------------------------------------------------------------------------------------------------------------------------------------------------------------
--------------------------------------------------------------------------------------------------------------------------------------------------------------------------------------------------------
--------------------------------------------------------------------------------------------------------------------------------------------------------------------------------------------------------
--------------------------------------------------------------------------------------------------------------------------------------------------------------------------------------------------------
--------------------------------------------------------------------------------------------------------------------------------------------------------------------------------------------------------
--------------------------------------------------------------------------------------------------------------------------------------------------------------------------------------------------------
--------------------------------------------------------------------------------------------------------------------------------------------------------------------------------------------------------
--------------------------------tt--tt--------------------------------------------------#--#------------------------------------------------------------------------------------------------------------
----------------------S22CSSS---tt--tt---------------------k------SUCSS2---------------##--##-----------------------------------------------------------------------------------------------------------
-------------#--#--------------%%%%%%%%%%%%%%---%%%%%----%%%-------------------------%%%%--%%%%----------------------------------------------%%%%%%%%F%%%%%%%%%%%%%%%%%%%%%%%%%%%%%%%%%%%%%%%%%%%%%%%%%%
------------##--##-------------||||||||||||||---|||||----g||r------------------------||||--||||%%%%%--%%%%%-----------%%%%-------------%%--%%||||||||%||||||||||||||||||||||||||||||||||||||||||||||||||
----------%%%%--%%%%---g-------||||||||||||||---|||||%%%%%%%%%%%---y-r---------------||||--|||||||||--|||||----r---y-k||||-------------||--|||||||||||||||||||||||||||||||||||||||||||||||||||||||||||||
XXXXXXXXXX||||--||||XXXXXXXXXXX||||||||||||||---||||||||||||||||XXXXXXXXXXXXXX--XXXXX||||--|||||||||--|||||XXXXXXXXXXXXXXXXXXXXXX--XXXX||--|||||||||||||||||||||||||||||||||||||||||||||||||||||||||||||
