HEIGHT=16;WIDTH=201;THEME=0;OVERRIDE=false
--------------------------------------------------------------------------------------------------------------------------------------------------------------------------------------------------------
--------------------------------------------------------------------------------------------------------------------------------------------------------------------------------------------------------
--------------------------------------------------------------------------------------------------------------------------------------------------------------------------------------------------------
--------------------------------------------------------------------------------------------------------------------------------------------------------------------------------------------------------
--------------------------------------------------------------------------------------------------------------------------------------------------------------------------------------------------------
--------------------------------------------------------------------------------------------------------------------------------------------------------------------------------------------------------
--------------------------------------------------------------------------------------------------------------------------------------------------------------------------------------------------------
--------------------------------------------------------------------------------------------------------------------------------------------------------------------------------------------------------
--------------------------------------------------------------------------------------------------------------------------------------------------------------------------------------------------------
-------------------------------------------------------------CC22---------------------------------------------------------------------------------------------------------------------------------------
-------------------------------------CSSS--------------------------------------------------------2222C--------------------------------------------------------------------------------------------------
-------------------tt-tt--------------------------------------------------------------------------------------------------------------------------------------------------------------------------------
-------------------tt-tt--%%%%%%%%%------------------%%%%%---y---g-------#--#-------------------------------------------------------------%%%%%%%%F%%%%%%%%%%%%%%%%%%%%%%%%%%%%%%%%%%%%%%%%%%%%%%%%%%%%%
-------------------tt-tt--|||||||||---g------#---#---|||||%%%%%%%%%%%---##--##-----------%%%%%%%--y--------------------------%%%%%--------||||||||%|||||||||||||||||||||||||||||||||||||||||||||||||||||
----------%%---%%%%%%%%%%%|||||||||%%%%%%%--##---##--||||||||||||||||--###--###----#--#--|||||||%%%%%%%%%--------------------|||||--------||||||||||||||||||||||||||||||||||||||||||||||||||||||||||||||
XXXXXXXXXX||---|||||||||||||||||||||||||||XXXX---XXXX||||||||||||||||XXXXX--XXXXXXXX--XXX||||||||||||||||XXX--XXXXXXXXXXX--XX|||||XXX--XXX||||||||||||||||||||||||||||||||||||||||||||||||||||||||||||||
