HEIGHT=16;WIDTH=201;THEME=0;OVERRIDE=false
--------------------------------------------------------------------------------------------------------------------------------------------------------------------------------------------------------
--------------------------------------------------------------------------------------------------------------------------------------------------------------------------------------------------------
--------------------------------------------------------------------------------------------------------------------------------------------------------------------------------------------------------
--------------------------------------------------------------------------------------------------------------------------------------------------------------------------------------------------------
--------------------------------------------------------------------------------------------------------------------------------------------------------------------------------------------------------
--------------------------------------------------------------------------------------------------------------------------------------------------------------------------------------------------------
--------------------------------------------------------------------------------------------------------------------------------------------------------------------------------------------------------
--------------------------------------------------------------------------------------------------------------------------------------------------------------------------------------------------------
--------------SCS---------------------------SSS2CS-------------------------%%%%%------------------------------------------------------------------------------------------------------------------------
---------------------------------------------------------------------------|||||-k----------------------------------------------------------------------------------------------------------------------
---------------------------------------------------------------------------||||%%%%%%-------------------------------------------------------------------------------------------------------------------
--------------r------------------------------------k---------------------y-||r|||||||K--------------------Tt--------------------------------------------------------------------------------------------
-------------%%%%%%%%%%%---%%%%%-----------%%%%%%%%%%%------%%%%%--%%%%%%%%%%%%%%%%%%%%%%%%%%---%%%%---Tt-tt--Tt---%%---%%----------%%%%%%%%%%%%%%%%F%%%%%%%%%%%%%%%%%%%%%%%%%%%%%%%%%%%%%%%%%%%%%%%%%%%
-------------|||||||||||---|||||-----------|||||||||||%%%%%%|||||--||||||||||||||||||||||||||---||||---tt-tt--tt-%%||---||----------||||||||||||||||%|||||||||||||||||||||||||||||||||||||||||||||||||||
-------------|||||||||||---|||||-----------||||||||||||||||||||||--||||||||||||||||||||||||||---||||%%%%%%%%%%%%%||||---||----------||||||||||||||||||||||||||||||||||||||||||||||||||||||||||||||||||||
XXXXXXXXXXXXX|||||||||||---|||||XXXXXXXXXXX||||||||||||||||||||||--||||||||||||||||||||||||||---|||||||||||||||||||||---||XXXX--XXXX||||||||||||||||||||||||||||||||||||||||||||||||||||||||||||||||||||
