HEIGHT=16;WIDTH=201;THEME=0;OVERRIDE=false
--------------------------------------------------------------------------------------------------------------------------------------------------------------------------------------------------------
--------------------------------------------------------------------------------------------------------------------------------------------------------------------------------------------------------
--------------------------------------------------------------------------------------------------------------------------------------------------------------------------------------------------------
--------------------------------------------------------------------------------------------------------------------------------------------------------------------------------------------------------
----------------------------------------------------------%%%%%%%---------------------------------------------------------------------------------------------------------------------------------------
----------------------------------------------------------|||||||---------------------------------------------------------------------------------------------------------------------------------------
----------------------------------------------------------|||||||---------------------------------------------------------------------------------------------------------------------------------------
----------------------------------------------------------|||yr||---------------------------------------------------------------------------------------------------------------------------------------
----------------------------------------------------------|%%%%||---------------------------------------------------------------------------------------------------------------------------------------
----------------------------------------------------------|||||||---------------------------------------------------------------------------------------------------------------------------------------
---------------------Tt-----------------------------------|||||||-------------------------------------------------#--#---------%%%%---------------------------------------------------------------------
---------------------tt----------------#---#--------------|||||||-r---g------------------------------------------##--##--------||||---------------------------------------------------------------------
%%%%%%%%%%%%-------%%%%%-rk-----------##---##--%%%%--%%%%%%%%%%%%%%%%%%%%%%-------------------------------------###--###-------||||-y-----r--%%%%%%%%F%%%%%%%%%%%%%%%%%%%%%%%%%%%%%%%%%%%%%%%%%%%%%%%%%%
||||||||||||%%---%%|||||-%%%%%------%%%%---%%%%||||--||||||||||||||||||||||-----------%%%--%%%%%%---%%%%%---%%%%%%%--%%%%%%%%%%%%%%%%%%%%%%%%||||||||%||||||||||||||||||||||||||||||||||||||||||||||||||
||||||||||||||---|||||||-|||||--g-k-||||---||||||||--||||||||||||||||||||||-----------|||--||||||---|||||---|||||||--|||||||||||||||||||||||||||||||||||||||||||||||||||||||||||||||||||||||||||||||||||
||||||||||||||---|||||||XXXXXXXXXXXX||||---||||||||--||||||||||||||||||||||XXXX---XXXX|||--||||||---|||||---|||||||--|||||||||||||||||||||||||||||||||||||||||||||||||||||||||||||||||||||||||||||||||||
