HEIGHT=16;WIDTH=201;THEME=0;OVERRIDE=false
--------------------------------------------------------------------------------------------------------------------------------------------------------------------------------------------------------
--------------------------------------------------------------------------------------------------------------------------------------------------------------------------------------------------------
--------------------------------------------------------------------------------------------------------------------------------------------------------------------------------------------------------
--------------------------------------------------------------------------------------------------------------------------------------------------------------------------------------------------------
--------------------------------------------------------------------------------------------------------------------------------------------------------------------------------------------------------
--------------------------------------------------------------------------------------------------------------------------------------------------------------------------------------------------------
--------------------------------------------------------------------------------------------------------------------------------------------------------------------------------------------------------
--------------------------------------------------------------------------------------------------------------------------------------------------------------------------------------------------------
---------------------------------------------------------------------------------------y----------------------------------------------------------------------------------------------------------------
-----------------------------------------------------------------------------------%%%%%----------------------------------------------------------------------------------------------------------------
-------------------------------------------------%%%-------------------------------|||||----------------------------------------------------------------------------------------------------------------
-------------------------------------------------|||-------------------------------|||||-g--------------------------------------------------------------------------------------------------------------
----------%%%%%----------------------------------|||-------------------------------|%%%%%%%------------------%%%%%%%------------------------------------------------------------------------------------
%%%%%%%%%%|||||-----%%%--%%%--------%%%%---%%%%--|||r-----%%%%%--%%%%%-------%%%%%-||||||||------------------|||||||-------#---#---%%%%%----------------------------------------------------------------
|||||||||||||||-----|||--|||--------||||---||||%%%%%%%%%%%|||||--|||||-------|||||-r|||||||gG----------------|||||||------##---##--|||||----------------------------------------------------------------
|||||||||||||||XXXXX|||--|||XXX--XXX||||---||||||||||||||||||||--|||||XX---XX|||||XXXXXXXXXXXXXXXXX---XXXXXXXXXXXXXXXXXXXXXX---XXXX|||||XXXXXXXXFXXXXXXXXXXXXXXXXXXXXXXXXXXXXXXXXXXXXXXXXXXXXXXXXXXXXXXX
