HEIGHT=16;WIDTH=201;THEME=0;OVERRIDE=false
--------------------------------------------------------------------------------------------------------------------------------------------------------------------------------------------------------
--------------------------------------------------------------------------------------------------------------------------------------------------------------------------------------------------------
--------------------------------------------------------------------------------------------------------------------------------------------------------------------------------------------------------
--------------------------------------------------------------------------------------------------------------------------------------------------------------------------------------------------------
--------------------------------------------------------------------------------------------------------------------------------------------------------------------------------------------------------
--------------------------------------------------------------------------------------------------------------------------------------------------------------------------------------------------------
--------------------------------------------------------------------------------------------------------------------------------------------------------------------------------------------------------
--------------------------------------------------------------------------------------------------------------------------------------------------------------------------------------------------------
--------------------%%%%%-------------------------------------------------------------------------------------------------------------------------------------------------------------------------------
--------------------|||||--------------SS-2S----------------------------------------#--#----------------------------------------------------------------------------------------------------------------
--------------------|||||----------------------------------------------------------##--##---------------------------------------------------------------------------------------------------------------
--------------------|||||----------------%----------------------------------------###--###--------------------------------------------------------------------------------------------------------------
-----------%%%%%%%%%%%%%%%%%%%-----------|--------------%%%---%%%%%%%%%%%--%%%%%%%%%%--%%%%%%%%---%%%----------------------#---#------------------------------------------------------------------------
-----------|||||||||||||||||||--------%%%%%%%%%---------|||---|||||||||||--||||||||||--||||||||---|||---------------------##---##-----------------------------------------------------------------------
-----------|||||||||||||||||||--------|||||||||---------|||---|||||||||||--||||||||||--||||||||---|||--------------------###---###--%%%--%%%------------------------------------------------------------
XXXXXXXXXXX|||||||||||||||||||XXX--XXX|||||||||XXX---XXX|||---|||||||||||--||||||||||--||||||||---|||XX---XXXXXX---XXXXXXXXX---XXXXX|||--|||XXXXXXXXFXXXXXXXXXXXXXXXXXXXXXXXXXXXXXXXXXXXXXXXXXXXXXXXXXXX
