HEIGHT=16;WIDTH=201;THEME=0;OVERRIDE=false
--------------------------------------------------------------------------------------------------------------------------------------------------------------------------------------------------------
--------------------------------------------------------------------------------------------------------------------------------------------------------------------------------------------------------
--------------------------------------------------------------------------------------------------------------------------------------------------------------------------------------------------------
--------------------------------------------------------------------------------------------------------------------------------------------------------------------------------------------------------
--------------------------------------------------------------------------------------------------------------------------------------------------------------------------------------------------------
--------------------------------------------------------------------------------------------------------------------------------------------------------------------------------------------------------
--------------------------------------------------------SCS---------------------------------------------------------------------------------------------------------------------------------------------
--------------------------------------------------------------------------------------------------------------------------------------------------------------------------------------------------------
------------------------------------------------22---------%--------------------------------------------------------------------------------------------------------------------------------------------
-----------------------------------------------------------|--------------------------------------------------------------------------------------------------------------------------------------------
---------------#---#---------------------------%--------%%%%--------------------------------------------------------------------------------------------------------------------------------------------
--------------##---##--------------------------|--------||||---------------------tt----tt---------------------------------------------------------------------------------------------------------------
%%%%%%%%%%%%%%%%---%%%%%%%%%%%--%%%---------%%%%%%%%%%%%%%%%%%%%%%%%%%%%---------tt----tt---------%%%%%--%%%%%---%%%%%---%%%%%--------------------------------------------------------------------------
||||||||||||||||---|||||||||||--|||---------||||||||||||||||||||||||||||-------%%%%%%%%%%%--------|||||--|||||---|||||---|||||------------%%%%%%%%F%%%%%%%%%%%%%%%%%%%%%%%%%%%%%%%%%%%%%%%%%%%%%%%%%%%%%
||||||||||||||||---|||||||||||--|||%%%---%%%||||||||||||||||||||||||||||---%%%%|||||||||||--------|||||--|||||%%%|||||---|||||%%--%%%%--%%||||||||%|||||||||||||||||||||||||||||||||||||||||||||||||||||
||||||||||||||||---|||||||||||--||||||---|||||||||||||||||||||||||||||||XXX|||||||||||||||XXX--XXX|||||--|||||||||||||---|||||||--||||--||||||||||||||||||||||||||||||||||||||||||||||||||||||||||||||||
