HEIGHT=16;WIDTH=201;THEME=0;OVERRIDE=false
--------------------------------------------------------------------------------------------------------------------------------------------------------------------------------------------------------
--------------------------------------------------------------------------------------------------------------------------------------------------------------------------------------------------------
--------------------------------------------------------------------------------------------------------------------------------------------------------------------------------------------------------
--------------------------------------------------------------------------------------------------------------------------------------------------------------------------------------------------------
--------------------------------------------------------------------------------------------------------------------------------------------------------------------------------------------------------
--------------------------------------------------------------------------------------------------------------------------------------------------------------------------------------------------------
--------------------------------------------------------------------------------------------------------------------------------------------------------------------------------------------------------
--------------------------------------------------------------------------------------------------------------------------------------------------------------------------------------------------------
-------------------------------------------------------------------------------------%%%----------------------------------------------------------------------------------------------------------------
---------------------------------------gg--------------------------------------------|||----------------------------------------------------------------------------------------------------------------
---------------y----------------------%%%%%%%----------------------------------------|||----------------------------------------------------------------------------------------------------------------
------------%%%%%%%-------------------||r||||----------------------------------------g||------r---y-----------------------------------------------------------------------------------------------------
%%%%%%%%%%%-|||r|||----------#---#---%%%%%%%%%%%------%%%--%%%----------------------%%%%%%%%%%%%%%%%------------%%%%---%%%%-----------------------------------------------------------------------------
|||||||||||%%%%%%%%%%-------##---##--|||||||||||%%--%%|||--|||%%%%%---%%%%%---------||||||||||||||||------------||||---||||------------Y--%%%%%%%%F%%%%%%%%%%%%%%%%%%%%%%%%%%%%%%%%%%%%%%%%%%%%%%%%%%%%%
|||||||||||||||||||||-----%%%%---%%%%|||||||||||||--|||||--||||||||---|||||---------||||||||||||||||%%%--%%%----||||---||||--#--#--%%%%%%%||||||||%|||||||||||||||||||||||||||||||||||||||||||||||||||||
|||||||||||||||||||||XXXXX||||---|||||||||||||||||--|||||--||||||||---|||||XXX---XXX|||||||||||||||||||--|||XXXX||||---||||XXX--XXX|||||||||||||||||||||||||||||||||||||||||||||||||||||||||||||||||||||
