HEIGHT=16;WIDTH=201;THEME=0;OVERRIDE=false
--------------------------------------------------------------------------------------------------------------------------------------------------------------------------------------------------------
--------------------------------------------------------------------------------------------------------------------------------------------------------------------------------------------------------
--------------------------------------------------------------------------------------------------------------------------------------------------------------------------------------------------------
--------------------------------------------------------------------------------------------------------------------------------------------------------------------------------------------------------
--------------------------------------------------------------------------------------------------------------------------------------------------------------------------------------------------------
--------------------------------------------------------------------------------------------------------------------------------------------------------------------------------------------------------
--------------------------------------------------------------------------------------------------------------------------------------------------------------------------------------------------------
--------------------------------------------------------------------------------------------------------------------------------------------------------------------------------------------------------
----------------------------------------------------------------------------------------------2---------------------------------------------------------------------------------------------------------
--------------------------------------------------------------------------------------------------------------------------------------------------------------------------------------------------------
--------------------------------------------------------------------------------------------%%----------------------------------------------------------------------------------------------------------
---------------------------------------k----------------------------------------------------||----------------------------------------------------------------------------------------------------------
-----------------------------------%%%%%----------------------------#--#----%%%%%--%%%%%%%%%%%%%---------%%---%%----------------------------------------------------------------------------------------
%%%%%%%%%%%------------------------|||||---------------------------##--##---|||||--|||||||||||||---------||---||-------------%%--%%---------------------------------------------------------------------
|||||||||||--------------%%%--%%%--||gy|-y--%%%%--%%%%------------###--###--|||||--|||||||||||||%%%---%%%||---||-------------||--||-------%%%%%%%%F%%%%%%%%%%%%%%%%%%%%%%%%%%%%%%%%%%%%%%%%%%%%%%%%%%%%%
|||||||||||XX---XXXX---XX|||--|||XXXXXXXXXXX||||--||||XXXX--XXXXXXXXX--XXXXX|||||--||||||||||||||||---|||||---||XXXXX---XXXXX||--||XX---XX||||||||X|||||||||||||||||||||||||||||||||||||||||||||||||||||
