HEIGHT=16;WIDTH=201;THEME=0;OVERRIDE=false
--------------------------------------------------------------------------------------------------------------------------------------------------------------------------------------------------------
--------------------------------------------------------------------------------------------------------------------------------------------------------------------------------------------------------
--------------------------------------------------------------------------------------------------------------------------------------------------------------------------------------------------------
--------------------------------------------------------------------------------------------------------------------------------------------------------------------------------------------------------
--------------------------------------------------------------------------------------------------------------------------------------------------------------------------------------------------------
--------------------------------------------------------------------------------------------------------------------------------------------------------------------------------------------------------
--------------------------------------------------------------------------------------------------------------------------------------------------------------------------------------------------------
--------------------------------------------------------------------------------------------------------------------------------------------------------------------------------------------------------
--------------------------------------------------------------------------------------------------------------------------------------------------------------------------------------------------------
-------------------------------------------------------------------------gyy------------------------------------------------S2C-------------------------------------------------------------------------
-------------------------------------------------------------------------%%%-------------------------------#--#-----------------------------------------------------------------------------------------
-------------------------------------------------------------------------|||------------------------------##--##----------------------------------------------------------------------------------------
--------------%%%%--%%%%%%--%%-------------------------------------------|||----------------------#--#--%%%%--%%%%--#--#------------------%%%%%%%%F%%%%%%%%%%%%%%%%%%%%%%%%%%%%%%%%%%%%%%%%%%%%%%%%%%%%%
--------------||||--||||||--||---------%%%--%%%---#--#---%%%%%--%%%%%----|||--------------%%--%%%%%--%%%||||--||||%%%--%%%%%%%%%%%--------||||||||%|||||||||||||||||||||||||||||||||||||||||||||||||||||
--------------||||--||||||--||%%%%%%%%%|||--|||--##--##--|||||--|||||%%%%%%%%%%%%%%%---%%%||--|||||--|||||||--|||||||--|||||||||||%%%--%%%||||||||||||||||||||||||||||||||||||||||||||||||||||||||||||||
XXXXXXXXXXXXXX||||--||||||--||||||||||||||--|||XXXX--XXXX|||||--||||||||||||||||||||---|||||--|||||--|||||||--|||||||--||||||||||||||--|||||||||||||||||||||||||||||||||||||||||||||||||||||||||||||||||
