HEIGHT=16;WIDTH=201;THEME=0;OVERRIDE=false
--------------------------------------------------------------------------------------------------------------------------------------------------------------------------------------------------------
--------------------------------------------------------------------------------------------------------------------------------------------------------------------------------------------------------
--------------------------------------------------------------------------------------------------------------------------------------------------------------------------------------------------------
--------------------------------------------------------------------------------------------------------------------------------------------------------------------------------------------------------
--------------------------------------------------------------------------------------------------------------------------------------------------------------------------------------------------------
--------------------------------------------------------------------------------------------------------------------------------------------------------------------------------------------------------
------------------------------------------------------------------------------------------------SC------------------------------------------------------------------------------------------------------
--------------------------------------------------------------------------------------------------------------------------------------------------------------------------------------------------------
--------------------------------------------------------------------------------------------------|-----------------------------------------------------------------------------------------------------
----------------C-SSSS----------------------------------------------------------------------------k-----------SCUS2-------------------------------------------------------------------------------------
------------------------------------------------------------------------------------------------%%%-----------------------------------------------------------------------------------------------------
---------------%-%-----------------------%%%%%%-------------------------------------------------|||-----------------------------------------------------------------------------------------------------
%%%%%%%%%%%%%%-|-|-------%%---%%---------||||||---------%%%%--%%%%-----%%%%--%%%%---------------|||-------------k--------------------%%%%%--%%%%%-------------------------------------------------------
||||||||||||||%%%%%%%%%%%||---||%%%--%%%-||||||---%%--%%||||--||||--tt-||||--||||-------------%%%||---%%--%%%%%%%%%%-----------------|||||--|||||-------------------------------------------------------
|||||||||||||||||||||||||||---|||||--|||%%%%%%%%%%||--||||||--||||--tt-||||--||||%%%%---%%%%--|||||---||--||||||||||-----------%%--%%|||||--|||||%%%%%%%%F%%%%%%%%%%%%%%%%%%%%%%%%%%%%%%%%%%%%%%%%%%%%%%
|||||||||||||||||||||||||||---|||||--|||||||||||||||--||||||--||||XXXXX||||--||||||||---||||XXXXXXXXXX||--||||||||||XXXXXXXXXXX||--|||||||--|||||||||||||X||||||||||||||||||||||||||||||||||||||||||||||
