HEIGHT=16;WIDTH=201;THEME=0;OVERRIDE=false
--------------------------------------------------------------------------------------------------------------------------------------------------------------------------------------------------------
--------------------------------------------------------------------------------------------------------------------------------------------------------------------------------------------------------
--------------------------------------------------------------------------------------------------------------------------------------------------------------------------------------------------------
--------------------------------------------------------------------------------------------------------------------------------------------------------------------------------------------------------
--------------------------------------------------------------------------------------------------------------------------------------------------------------------------------------------------------
--------------------------------------------------------------------------------------------------------------------------------------------------------------------------------------------------------
--------------------------------------------------------------------------------------------------------------------------------------------------------------------------------------------------------
--------------------------------------------------------------------------------------------------------S2SU--------------------------------------------------------------------------------------------
--------------------------------------------------------------------------------------------------------------------------------------------------------------------------------------------------------
--------------------------------------------------------------------------------------------------------------------------------------------------------------------------------------------------------
------------------------------------------------------------------------------------------------SCUSSS--------------------------------------------------------------------------------------------------
---------------------------------------------------------%%%--------------------------------------------%%%%%-------------------------------------------------------------------------------------------
---------------------------------%%%-----------y-g-g--g--|||-------#--#---------------------------------|||||----------%%---%%--------------------------------------------------------------------------
--------------------------%%---%%|||--------%%%%%%%%%%%%%%%%%%%---##--##--------------------------------|||||----------||---||--------------------------------------------------------------------------
%%%%%%%%%%%%%%%%%%--------||---|||||--------|||||||||||||||||||--###--###--------%%%%%---%%%%%%%%%%%%%%-|||||----------||---||%%%%--%%%%%%%%%%%%F%%%%%%%%%%%%%%%%%%%%%%%%%%%%%%%%%%%%%%%%%%%%%%%%%%%%%%%
||||||||||||||||||XXX--XXX||---|||||XXX--XXX|||||||||||||||||||XXXXX--XXXXXXX--XX|||||---||||||||||||||XXXXXXXXXXXXXXXX||---||||||--||||||||||||X|||||||||||||||||||||||||||||||||||||||||||||||||||||||
