HEIGHT=16;WIDTH=201;THEME=0;OVERRIDE=false
--------------------------------------------------------------------------------------------------------------------------------------------------------------------------------------------------------
--------------------------------------------------------------------------------------------------------------------------------------------------------------------------------------------------------
--------------------------------------------------------------------------------------------------------------------------------------------------------------------------------------------------------
--------------------------------------------------------------------------------------------------------------------------------------------------------------------------------------------------------
--------------------------------------------------------------------------------------------------------------------------------------------------------------------------------------------------------
--------------------------------------------------------------------------------------------------------------------------------------------------------------------------------------------------------
---------------------------------%%%--------------------------------------------------------------------------------------------------------------------------------------------------------------------
---------------------------------|||--------------------------------------------------------------------------------------------------------------------------------------------------------------------
---------------------------------|||--------------------------------------------------------------------------------------------------------------------------------------------------------------------
---------------------------------|||--------------------------------------------------------------------------------------------------------------------------------------------------------------------
---------------------------------|||----------%%%-------------------------------------------------------------------------------------------------------------------------------------------------------
---------------------------------|||----------|||-------------------------------------------------------------------------------------------------------------------------------------------------------
---------------------------------|||----------|||-------------%%--%%%%---%%--tt--------------------------------------------------------%%%---%%%%%%%%%%%F%%%%%%%%%%%%%%%%%%%%%%%%%%%%%%%%%%%%%%%%%%%%%%%
---------------------------------|||----------||r--%%%%---%%%%||--||||---||--tt------------%%%%--%%%%------------------%%%%%---%%%%%---|||---|||||||||||%|||||||||||||||||||||||||||||||||||||||||||||||
%%%%%%%%%%%%%------------#---#--%%%%%%%%%%%%%%%%%%%||||---||||||--||||---||--tt--%%%%--%%%%||||--||||------------------|||||---|||||---|||---|||||||||||||||||||||||||||||||||||||||||||||||||||||||||||
|||||||||||||XXXX--XXXXXXX---XXX|||||||||||||||||||||||---||||||--||||---||XXXXXX||||--||||||||--||||XXXX--XXXXXXX--XXX|||||---|||||XXX|||---|||||||||||||||||||||||||||||||||||||||||||||||||||||||||||
