HEIGHT=16;WIDTH=201;THEME=0;OVERRIDE=false
--------------------------------------------------------------------------------------------------------------------------------------------------------------------------------------------------------
--------------------------------------------------------------------------------------------------------------------------------------------------------------------------------------------------------
--------------------------------------------------------------------------------------------------------------------------------------------------------------------------------------------------------
--------------------------------------------------------------------------------------------------------------------------------------------------------------------------------------------------------
--------------------------------------------------------------------------------------------------------------------------------------------------------------------------------------------------------
--------------------------------------------------------------------------------------------------------------------------------------------------------------------------------------------------------
--------------------------------------------------------------------------------------------------------------------------------------------------------------------------------------------------------
--------------------------------------------------------------------------------------------------------------------------------------------------------------------------------------------------------
------------------------------------------------------------------SSSS----------------------------------------------------------------------------------------------------------------------------------
------------------------------------------------SU-CS---------------------------------------------------------------------------------------------------------------------------------------------------
--------------------------------------------------------------------------SSSS----------------------------%%%%%-----------------------------------------------------------------------------------------
--------------------------------------------------%-------------------------------------------------------|||||--------%%%%%%%--------------------------------------------------------------------------
--------------------------------------------------|----r---------%%%%%%%%-----------------%%--------------|||||--------|||||||-k---------%%%%%%%%F%%%%%%%%%%%%%%%%%%%%%%%%%%%%%%%%%%%%%%%%%%%%%%%%%%%%%%
--------------------%%---%%--------------------%%%%%%%%%%--------||||||||---------%%%--%%%||----------y---||g||-----%%%%%%%%%%%%%--------||||||||%||||||||||||||||||||||||||||||||||||||||||||||||||||||
--------------%%--%%||---||-------------%%---%%||||||||||--------||||||||%%%%%%%%%|||--|||||%%--%%%%%%%%%%%%%%%%%%%%|||||||||||||%%%%%%%%|||||||||||||||||||||||||||||||||||||||||||||||||||||||||||||||
XXXXXXXXXXXXXX||--||||---||XXXXX---XXXXX||---||||||||||||XXX--XXX||||||||||||||||||||--|||||||--||||||||||||||||||||||||||||||||||||||||||||||||||||||||||||||||||||||||||||||||||||||||||||||||||||||||
