HEIGHT=16;WIDTH=201;THEME=0;OVERRIDE=false
--------------------------------------------------------------------------------------------------------------------------------------------------------------------------------------------------------
--------------------------------------------------------------------------------------------------------------------------------------------------------------------------------------------------------
--------------------------------------------------------------------------------------------------------------------------------------------------------------------------------------------------------
--------------------------------------------------------------------------------------------------------------------------------------------------------------------------------------------------------
--------------------------------------------------------------------------------------------------------------------------------------------------------------------------------------------------------
--------------------------------------------------------------------------------------------------------------------------------------------------------------------------------------------------------
--------------------------------------------------------------------------------------------------------------------------------------------------------------------------------------------------------
-----------------------------g--------------------------------------------------------------------------------------------------------------------------------------------------------------------------
----------------------------%%%-------------------------------------------------------------------------------------------------------------------------------------------------------------------------
----------------------------|||-------------------------------------------------------------------------------------------------------------------------------------------------------------------------
------------------------y--g|||--------------------------------------------------------------------------------------------#---#------------------------------------------------------------------------
--------------#--#-----%%%%%%%|----------------------------------------------------------------#---#--------#--#----------##---##-----------------------------------------------------------------------
-------------##--##----||||||||----%%%---%%%----------------------------%%%%%%-------%%%%%%---##---##------##--##--------###---###-----#--#---%%%%%%%%F%%%%%%%%%%%%%%%%%%%%%%%%%%%%%%%%%%%%%%%%%%%%%%%%%
-----------%%%%--%%%%--||||||||----|||---|||----------------------------||||||-------||||||--###---###----###--###-----%%%%%---%%%%%--##--##--||||||||%|||||||||||||||||||||||||||||||||||||||||||||||||
%%%%%%%%%%%||||--||||--||||||||----|||---|||%%%---%%%-------%%%%%--%%%%%||||||%%---%%||||||%%%%%---%%%%%%%%%%--%%%%%---|||||---|||||%%%%--%%%%||||||||||||||||||||||||||||||||||||||||||||||||||||||||||
|||||||||||||||--||||XXXXXXXXXXXXXX|||---||||||---|||XX---XX|||||--|||||||||||||---|||||||||||||---||||||||||--|||||XXX|||||---|||||||||--||||||||||||||||||||||||||||||||||||||||||||||||||||||||||||||
