HEIGHT=16;WIDTH=201;THEME=0;OVERRIDE=false
--------------------------------------------------------------------------------------------------------------------------------------------------------------------------------------------------------
--------------------------------------------------------------------------------------------------------------------------------------------------------------------------------------------------------
--------------------------------------------------------------------------------------------------------------------------------------------------------------------------------------------------------
--------------------------------------------------------------------------------------------------------------------------------------------------------------------------------------------------------
--------------------------------------------------------------------------------------------------------------------------------------------------------------------------------------------------------
--------------------------------------------------------------------------------------------------------------------------------------------------------------------------------------------------------
--------------------------------------------------------------------------------------------------------------------------------------------------------------------------------------------------------
--------------------------------------------------------------------------------------------------------------------------------------------------------------------------------------------------------
--------------------------------------------------------------------------------------------------------------------------------------------------------------------------------------------------------
--------------------------------------------------------------------------------------------------------------------------------------------------------------------------------------------------------
-------------------------------------------------------------------------------------------------------r-y----------------------------------------------------------------------------------------------
----------------UCS---------------------------------------------------------------------------------%%%%%%%---------------------------------------------------------------------------------------------
%%%%%%%%%%%%%%-----------------------------------------------------------------------------------y--|||||||--------------------------------%%%%%%%%F%%%%%%%%%%%%%%%%%%%%%%%%%%%%%%%%%%%%%%%%%%%%%%%%%%%%
||||||||||||||--------------------%%%%%--%%%%%----------------------------%%%%%--%%%%%%%%--%%%%%%%%%%%%%%%%%%%%%%---------#---#------------||||||||%||||||||||||||||||||||||||||||||||||||||||||||||||||
||||||||||||||--------------------|||||--|||||%%%%%--%%%%%----------------|||||--||||||||--||||||||||||||||||||||--------##---##----#---#--|||||||||||||||||||||||||||||||||||||||||||||||||||||||||||||
||||||||||||||XXXXXXXXX---XXXX--XX|||||--||||||||||--|||||XXXX--XXXXXX--XX|||||--||||||||--||||||||||||||||||||||XXXXXXXXXX---XXXXXXX---XXX|||||||||||||||||||||||||||||||||||||||||||||||||||||||||||||
