HEIGHT=16;WIDTH=201;THEME=0;OVERRIDE=false
--------------------------------------------------------------------------------------------------------------------------------------------------------------------------------------------------------
--------------------------------------------------------------------------------------------------------------------------------------------------------------------------------------------------------
--------------------------------------------------------------------------------------------------------------------------------------------------------------------------------------------------------
--------------------------------------------------------------------------------------------------------------------------------------------------------------------------------------------------------
--------------------------------------------------------------------------------------------------------------------------------------------------------------------------------------------------------
--------------------------------------------------------------------------------------------------------------------------------------------------------------------------------------------------------
--------------------------------------------------------------------------------------------------------------------------------------------------------------------------------------------------------
--------------------------------------------------------------------------------------------------------------------------------------------------------------------------------------------------------
--------------------------------------------------------------------------------------------------------------------------------------------------------------------------------------------------------
--------------------------------------------------------------------------------------------------------------------------------------------------------------------------------------------------------
----------------------------------------------------------------------SCS-------------------------------------------------tt----------------------------------------------------------------------------
-------------------------------------------------------------------------------------------------------------------kg-----tt----------------------------------------------------------------------------
%%%%%%%%%%%%%--------------------------------%%%%--%%%%%%%%%---%%%%%---------------%%%---%%%----------------------%%%-----tt----------------------------------------------------------------------------
|||||||||||||-------%%%%%%%-------%%%%---%%%%||||--|||||||||---|||||---------------|||---|||----------------------|||--%%%%%%%%%%%----------------------------------------------------------------------
|||||||||||||%%---%%|||||||%%---%%||||---||||||||--|||||||||---|||||%%%%%%%--------|||---|||------------%%%%%%%%%%%%%%%|||||||||||%%%--%%%%%%%%%%%F%%%%%%%%%%%%%%%%%%%%%%%%%%%%%%%%%%%%%%%%%%%%%%%%%%%%%
|||||||||||||||---|||||||||||---||||||---||||||||--|||||||||---||||||||||||XXX--XXX|||---|||XXXXX--XXXXX|||||||||||||||||||||||||||||--|||||||||||X|||||||||||||||||||||||||||||||||||||||||||||||||||||
