HEIGHT=16;WIDTH=201;THEME=0;OVERRIDE=false
--------------------------------------------------------------------------------------------------------------------------------------------------------------------------------------------------------
--------------------------------------------------------------------------------------------------------------------------------------------------------------------------------------------------------
--------------------------------------------------------------------------------------------------------------------------------------------------------------------------------------------------------
--------------------------------------------------------------------------------------------------------------------------------------------------------------------------------------------------------
--------------------------------------------------------------------------------------------------------------------------------------------------------------------------------------------------------
--------------------------------------------------------------------------------------------------------------------------------------------------------------------------------------------------------
--------------------------------------------------------------------------------------------------------------------------------------------------------------------------------------------------------
-----------------------------------------------------------------------k----k---------------------------------------------------------------------------------------------------------------------------
-----------------------------------------------------------------------%%%%%%---------------------------------------------------------------------------------------------------------------------------
-----------------------------------------------------------------------||||||---------------------------------------------------------------------------------------------------------------------------
---------------------------------------------------------------------%%%%%%%|---------------------------------------------------------------------------------------------------------------------------
----------------------------------------------#---#------------------|r||||||---------------------------------------------------------------------------------------------------------------------------
%%%%%%%%%%-----------------g--------%%--%%---##---##---%%%--%%%%%%%%%%%%%%%%%%%%---------------------------------#---#--------------------%%%%%%%%F%%%%%%%%%%%%%%%%%%%%%%%%%%%%%%%%%%%%%%%%%%%%%%%%%%%%%
||||||||||----------%%%%%%%%%%%%%%%%||--||--###---###--|||--||||||||||||||||||||-------------%%%%---%%%%%%%%%%%%%%---%%%%%%%%-------------||||||||%|||||||||||||||||||||||||||||||||||||||||||||||||||||
||||||||||%%%%--%%%%||||||||||||||||||--||%%%%%---%%%%%|||--||||||||||||||||||||-------------||||---||||||||||||||---||||||||-------------||||||||||||||||||||||||||||||||||||||||||||||||||||||||||||||
||||||||||||||--||||||||||||||||||||||--|||||||---||||||||--||||||||||||||||||||XXXXX---XXXXX||||---||||||||||||||---||||||||XXXXXXXX---XX||||||||||||||||||||||||||||||||||||||||||||||||||||||||||||||
