HEIGHT=16;WIDTH=201;THEME=0;OVERRIDE=false
--------------------------------------------------------------------------------------------------------------------------------------------------------------------------------------------------------
--------------------------------------------------------------------------------------------------------------------------------------------------------------------------------------------------------
---------------------------------------------------SUSC-------------------------------------------------------------------------------------------------------------------------------------------------
--------------------------------------------------------------------------------------------------------------------------------------------------------------------------------------------------------
--------------------------------------------------------------------------------------------------------------------------------------------------------------------------------------------------------
------------------------------------------------------g-------------------------------------------------------------------------------------------------------------------------------------------------
---------------------------------------------------%%%%%%-----------------------------------------------------------------------------------------------------------------------------------------------
---------------------------------------------------||||||-----------------------------------------------------------------------------------------------------------------------------------------------
---------------------------------------------------||||||-----------------------------------------------------------------------------------------------------------------------------------------------
--------------------------------------------CSS----||||||-----------------------------------------------------------------------------------------------------------------------------------------------
---------------------------------------------------||||||-----%%%%----------------%%%%%-----------------------------------------------------------------------------------------------------------------
---------------------------------SSCS----------%---|||gG|-----|||g----------------|||||-----------------------------------------------------------------------------------------------------------------
%%%%%%%%%%%------------------------------------|-%%%%%%%%%%%%%%%%%%%-------%%%%%%%%%%%%%%--------------%%%---%%%----------------------------------------------------------------------------------------
|||||||||||%%%--%%%----------------------%%%%%%%%|||||||||||||||||||-------||||||||||||||---#--#---%%%%|||---|||---------%%%%------%%%--%%%%%%%%%%%F%%%%%%%%%%%%%%%%%%%%%%%%%%%%%%%%%%%%%%%%%%%%%%%%%%%%
||||||||||||||--|||--------------r-------|||||||||||||||||||||||||||-------||||||||||||||--##--##--|||||||---|||---------||||------|||--|||||||||||%||||||||||||||||||||||||||||||||||||||||||||||||||||
||||||||||||||--|||XX--XXXX---XXXXXXXXXXX|||||||||||||||||||||||||||XX---XX||||||||||||||XXXX--XXXX|||||||---|||XXX---XXX||||XX--XX|||--||||||||||||||||||||||||||||||||||||||||||||||||||||||||||||||||
