HEIGHT=16;WIDTH=201;THEME=0;OVERRIDE=false
--------------------------------------------------------------------------------------------------------------------------------------------------------------------------------------------------------
--------------------------------------------------------------------------------------------------------------------------------------------------------------------------------------------------------
--------------------------------------------------------------------------------------------------------------------------------------------------------------------------------------------------------
--------------------------------------------------------------------------------------------------------------------------------------------------------------------------------------------------------
--------------------------------------------------------------------------------------------------------------------------------------------------------------------------------------------------------
--------------------------------------------------------------------------------------------------------------------------------------------------------------------------------------------------------
--------------------------------------------------------------------------------------------------------------------------------------------------------------------------------------------------------
--------------------------------------------------------------------------------------------------------------------------------------------------------------------------------------------------------
--------------------------------------------------------------------------------------------------------------------------------------------------------------------------------------------------------
---------------------------------------------------------------------------------------------------------------------------SSSSSSS----------------------------------------------------------------------
-------------------------------------------------------------------CSSSC--------------------------------------------------------------------------------------------------------------------------------
--------------------------------------------------------------------------------------------------------------------------------------------------------------------------------------------------------
------------%%---%%------------------------#---#-------#---#----------------------------------k-------------------------------r--------------%%%%%%%%F%%%%%%%%%%%%%%%%%%%%%%%%%%%%%%%%%%%%%%%%%%%%%%%%%%
------------||---||--#--#--%%--%%---------##---##-----##---##------g-------------------------%%%%%%%----------------------%%%%%%%%%----------||||||||%||||||||||||||||||||||||||||||||||||||||||||||||||
------------||---||%%%--%%%||--||-------%%%%---%%%%--###---###--%%%%%%%%%%%%%--%%%-----------|||||||-------------%%%---%%%|||||||||----------|||||||||||||||||||||||||||||||||||||||||||||||||||||||||||
XXXXXXXXXXXX||---|||||--|||||--||XX---XX||||---||||XXXXX---XXXXX|||||||||||||--|||XXXX---XXXX|||||||XXXXX---XXXXX|||---||||||||||||XXXX--XXXX|||||||||||||||||||||||||||||||||||||||||||||||||||||||||||
