HEIGHT=16;WIDTH=201;THEME=0;OVERRIDE=false
--------------------------------------------------------------------------------------------------------------------------------------------------------------------------------------------------------
--------------------------------------------------------------------------------------------------------------------------------------------------------------------------------------------------------
-----------------------------------------------------------------------------------------------------r--------------------------------------------------------------------------------------------------
-----------------------------------------------------------------------------------------------------%%%------------------------------------------------------------------------------------------------
-----------------------------------------------------------------------------------------------------|||------------------------------------------------------------------------------------------------
-----------------------------------------------------------------------------------------------------|%%%%%%%-------------------------------------------------------------------------------------------
-----------------------------------------------------------------------------------------------------||||||||-------------------------------------------------------------------------------------------
-----------------------------------------------------------------------------------------------------||||||||-------------------------------------------------------------------------------------------
-----------------------------------------------------------------------------------------------------||||||||-------------------------------------------------------------------------------------------
-----------------------------------------------------------------------------------------------------||||||%%%%-----------------------------------------------------------------------------------------
-----------------------------------------------------------------------------------------------------||||||||||-----------------------------------------------------------------------------------------
---------------------------------SSC2---------------------SS2CSS----#---#----------------------------yr||||||||--y-yk-----------------------------------------------------------------------------------
-----------------------------------------------%%%%%%%-------------##---##----#---#----------------%%%%%%%%%%%%%%%%%%%---%%---%%%%%%---%%%%-------------------------------------------------------------
-----------------------------------------------|||||||-----------%%%%---%%%%%%%---%%%-----%%%---%%%|||||||||||||||||||---||---||||||---||||%%%%%%%%F%%%%%%%%%%%%%%%%%%%%%%%%%%%%%%%%%%%%%%%%%%%%%%%%%%%%
%%%%%%%%%%%%----------%%---%%--k--r--k---------|||||||--g-k-y----||||---|||||||---|||%%%%%|||---||||||||||||||||||||||---||---||||||---||||||||||||%||||||||||||||||||||||||||||||||||||||||||||||||||||
||||||||||||XXXX--XXXX||---||XXXXXXXXXXXXX--XXX|||||||XXXXXXXXXXX||||---|||||||---|||||||||||---||||||||||||||||||||||XXX||---||||||---|||||||||||||||||||||||||||||||||||||||||||||||||||||||||||||||||
