HEIGHT=16;WIDTH=201;THEME=0;OVERRIDE=false
--------------------------------------------------------------------------------------------------------------------------------------------------------------------------------------------------------
--------------------------------------------------------------------------------------------------------------------------------------------------------------------------------------------------------
--------------------------------------------------------------------------------------------------------------------------------------------------------------------------------------------------------
--------------------------------------------------------------------------------------------------------------------------------------------------------------------------------------------------------
--------------------------------------------------------------------------------------------------------------------------------------------------------------------------------------------------------
--------------------------------------------------------------------------------------------------------------------------------------------------------------------------------------------------------
--------------------------------------------------------------------------------------------------------------------------------------------------------------------------------------------------------
--------------------------------------------------------------------------------------------------------------------------------------------------------------------------------------------------------
--------------------------------------------------------------------------------------------------------------------------------------------------------------------------------------------------------
-----------------------------------------------------------------------------------------------------------------------r--------------------------------------------------------------------------------
------------------------------------------------------------------------------------------#---#---------------------%%%%--------------------------------------------------------------------------------
--------------------------------------------------------------------------------%%%------##---##--------------------||||--------------------------------------------------------------------------------
%%%%%%%%%%%%%%------------------------------------------------------------------|||----%%%%---%%%%-----------------gy|||r-------------------------------------------------------------------------------
||||||||||||||-----r------#--#-------Tt-----%%%%---%%%%-------------tt----------|||----||||---||||%%%%---k-------%%%%%%%%%%%----------------------------------------------------------------------------
||||||||||||||%%%%%%%%%--##--##------tt-----||||---||||--#---#------tt----------||g----||||---||||||||%%%%%%-----|||||||||||-------------%%%%%%%%F%%%%%%%%%%%%%%%%%%%%%%%%%%%%%%%%%%%%%%%%%%%%%%%%%%%%%%
|||||||||||||||||||||||XXXX--XXXXXXXXXXXXXXX||||---||||XXX---XXXXXXXXXXXXXXXXXXXXXXXXXX||||---||||||||||||||XXXXX|||||||||||XXXXX---XXXXX||||||||X||||||||||||||||||||||||||||||||||||||||||||||||||||||
