HEIGHT=16;WIDTH=201;THEME=0;OVERRIDE=false
--------------------------------------------------------------------------------------------------------------------------------------------------------------------------------------------------------
--------------------------------------------------------------------------------------------------------------------------------------------------------------------------------------------------------
--------------------------------------------------------------------------------------------------------------------------------------------------------------------------------------------------------
--------------------------------------------------------------------------------------------------------------------------------------------------------------------------------------------------------
--------------------------------------------------------------------------------------------------------------------------------------------------------------------------------------------------------
--------------------------------------------------------------------------------------------------------------------------------------------------------------------------------------------------------
--------------------------------------------------------------------------------------------------------------------------------------------------------------------------------------------------------
--------------------------------------------------------------------------------------------------------------------------------------------------------------------------------------------------------
--------------------------------------------------------------------------------------------------------------------------------------------------------------------------------------------------------
-----------------------------------------------------------------------------------#--#-----------------------------------------------------------------------------------------------------------------
----------------------------------------------------------------------------------##--##----------------------------------------------------------------------------------------------------------------
--------------------Tt-----------------------------------------------------------###--###---------------------------------------------------------------------------------------------------------------
--------------tt----tt---------%%%---%%%---------------------------------------%%%%%--%%%%%---------------------#--#------------------------------------------------------------------------------------
%%%%%%%%%%%%%-tt----tt---------|||---|||---------------------------------------|||||--|||||%%%---%%%----------%%%--%%%%%---%%-------------%%%%%%%%F%%%%%%%%%%%%%%%%%%%%%%%%%%%%%%%%%%%%%%%%%%%%%%%%%%%%%
|||||||||||||%%%%%%%%%%--------|||---|||%%%%%--%%%%%-----------%%%---%%%%%---%%|||||--||||||||---|||%%%%%%%%%%|||--|||||---||%%%%%---%%%%%||||||||%|||||||||||||||||||||||||||||||||||||||||||||||||||||
|||||||||||||||||||||||XXX--XXX|||---||||||||--|||||XXXX---XXXX|||---|||||---|||||||--||||||||---||||||||||||||||--|||||---|||||||---|||||||||||||||||||||||||||||||||||||||||||||||||||||||||||||||||||
