HEIGHT=16;WIDTH=201;THEME=0;OVERRIDE=false
--------------------------------------------------------------------------------------------------------------------------------------------------------------------------------------------------------
--------------------------------------------------------------------------------------------------------------------------------------------------------------------------------------------------------
--------------------------------------------------------------------------------------------------------------------------------------------------------------------------------------------------------
--------------------------------------------------------------------------------------------------------------------------------------------------------------------------------------------------------
--------------------------------------------------------------------------------------------------------------------------------------------------------------------------------------------------------
--------------------------------------------------------------SSS-SS------------------------------------------------------------------------------------------------------------------------------------
--------------------------------------------------------------------------------------------------------------------------------------------------------------------------------------------------------
-----------------------------------------------------------------%--%-----------------------------------------------------------------------------------------------------------------------------------
-----------------------------------------------------------------|-g|---------------------------k-------------------------------------------------------------------------------------------------------
------------------------g-k-----------------------------------%%%%%%%---------------------------%%%%%%--------------------------------------------------------------------------------------------------
------------------------%%%-----------------------------------|||||||---------------------------||||||--------------------------------------------------------------------------------------------------
------------------------|||-----------------------------------||k||||---------------------------||||||--------------------------------------------------------------------------------------------------
-------------#--#-------|||----------------------------%%%%%%%%%%%%%%%%%%-----------------------||||||--------------------------%%%%%--%%%%%------------------------------------------------------------
------------##--##--%%%%%%%%%%-------------------------||||||||||||||||||---------------%%%%%%%%%%%%%%%%%%%--%%------%%%%---%%%%|||||--|||||%%%%%%%%F%%%%%%%%%%%%%%%%%%%%%%%%%%%%%%%%%%%%%%%%%%%%%%%%%%%
%%%%%%%%%%%%%%--%%%%||||||||||------------------%%---%%||||||||||||||||||%%%%--%%%%%%%%%|||||||||||||||||||--||%%--%%||||---|||||||||--|||||||||||||%|||||||||||||||||||||||||||||||||||||||||||||||||||
||||||||||||||--||||||||||||||XXXXX--XXXXXXXXXXX||---||||||||||||||||||||||||--||||||||||||||||||||||||||||--||||--||||||---|||||||||--|||||||||||||||||||||||||||||||||||||||||||||||||||||||||||||||||
