HEIGHT=16;WIDTH=201;THEME=0;OVERRIDE=false
--------------------------------------------------------------------------------------------------------------------------------------------------------------------------------------------------------
--------------------------------------------------------------------------------------------------------------------------------------------------------------------------------------------------------
--------------------------------------------------------------------------------------------------------------------------------------------------------------------------------------------------------
--------------------------------------------------------------------------------------------------------------------------------------------------------------------------------------------------------
--------------------------------------------------------------------------------------------------------------------------------------------------------------------------------------------------------
--------------------------------------------------------------------------------------------------------------------------------------------------------------------------------------------------------
--------------------------------------------------------------------------------------------------------------------------------------------------------------------------------------------------------
--------------------------------------------------------------------------------------------------------------------------------------------------------------------------------------------------------
--------------------------------------------------------------------------------------------------------------------------------------------------------------------------------------------------------
-----------------------------------------------------------------------------------------------g--------------------------------------------------------------------------------------------------------
-----------------------------------------------------------------------------------------------%%%%-----------rg----------------------------------------------------------------------------------------
-----------------------------------------------------------------------#---#-------------------||||-----------%%%---------------------------------------------------------------------------------------
--------------#---#--------#--#---------------------------------%%%%--##---##------------------|y||Y----------|||------%%%%%--%%%%%------------%%%%%%%%F%%%%%%%%%%%%%%%%%%%%%%%%%%%%%%%%%%%%%%%%%%%%%%%%
%%%%%%%%%%---##---##------##--##---%%%--%%%---------------------||||%%%%---%%%%---------------%%%%%%%%%%%%%--kr||------|||||--|||||------------||||||||%||||||||||||||||||||||||||||||||||||||||||||||||
||||||||||--###---###----###--###--|||--|||%%---%%--------------||||||||---||||%%--%%%%%---%%%|||||||||||||%%%%%%%%%%%%|||||--|||||%%%%%--%%%%%|||||||||||||||||||||||||||||||||||||||||||||||||||||||||
||||||||||XXXXX---XXXXXXXXXX--XXXXX|||--|||||---||XXXXXXXXX---XX||||||||---||||||--|||||---|||||||||||||||||||||||||||||||||--||||||||||--||||||||||||||||||||||||||||||||||||||||||||||||||||||||||||||
