HEIGHT=16;WIDTH=201;THEME=0;OVERRIDE=false
--------------------------------------------------------------------------------------------------------------------------------------------------------------------------------------------------------
--------------------------------------------------------------------------------------------------------------------------------------------------------------------------------------------------------
--------------------------------------------------------------------------------------------------------------------------------------------------------------------------------------------------------
--------------------------------------------------------------------------------------------------------------------------------------------------------------------------------------------------------
--------------------------------------------------------------------------------------------------------------------------------------------------------------------------------------------------------
--------------------------------------------------------------------------------------------------------------------------------------------------------------------------------------------------------
--------------------------------------------------------------------------------------------------------------------------------------------------------------------------------------------------------
--------------------------------------------------------------------------------------------------------------------------------------------------------------------------------------------------------
--------------------------------------------------------------------------------------------------------------------------------------------------------------------------------------------------------
--------------------------------------------------------------------------------------------------------------------------------------------------------------------------------------------------------
--------------------------------------------------------------------------------------SS2----#--#-------------------------------------------------------------------------------------------------------
--------------------------------------------------------------------------------------------##--##---------------------------------------SSC------------------------------------------------------------
------------%%%%%%------------------%%%%--%%%%-----------%%--%%----#--#----%%---%%--------%%%%--%%%%----------------------------------------------------------------------------------------------------
------------||||||---------%%%%%%%%%||||--||||-----------||--||---##--##---||---||----g---||||--||||-------------%%%%%--%%%%%---------------------------------------------------------------------------
%%%%%%%%%%%%%%%%%%%%%%%%%%%|||||||||||||--||||%%%%---%%%%||--||--###--###--||---||%%%%%%%%||||--||||-------------|||||--|||||-------------k-------------------------------------------------------------
||||||||||||||||||||||||||||||||||||||||--||||||||---||||||--||XXXXX--XXXXX||---||||||||||||||--||||XXXXX---XXXXX|||||--|||||XXXX--XXXXXXXXXXXXXXXXXXXXXFXXXXXXXXXXXXXXXXXXXXXXXXXXXXXXXXXXXXXXXXXXXXXXX
