HEIGHT=16;WIDTH=201;THEME=0;OVERRIDE=false
--------------------------------------------------------------------------------------------------------------------------------------------------------------------------------------------------------
--------------------------------------------------------------------------------------------------------------------------------------------------------------------------------------------------------
--------------------------------------------------------------------------------------------------------------------------------------------------------------------------------------------------------
--------------------------------------------------------------------------------------------------------------------------------------------------------------------------------------------------------
--------------------------------------------------------------------------------------------------------------------------------------------------------------------------------------------------------
-----------------------------%%%%-----------------------------------------------------------------------------------------------------------------------------------------------------------------------
-----------------------------||||-----------------------------------------------------------------------------------------------------------------------------------------------------------------------
--------------------------k--||||-----------------------------------------------------------------------------------------------------------------------------------------------------------------------
----------------US2S------%%%%|||-----------------------------------------------------------------------------------------------------------------------------------------------------------------------
--------------------------|||||||-----------------------------------------------k--k--------------------------------------------------------------------------------------------------------------------
-----------------------%%%%||||||---------------------------------------------%%%%%%%--------------------------------------------y----------------------------------------------------------------------
-----------------------||||||||||----------------------------------#---#------|||||||-----------------------------------------%%%%%%%-------------------------------------------------------------------
--------------%%%%%%%%-||||||||||---%%%--%%%-----%%%%%---%%%%%%%%%%%---%%%----|||||||-----------------------------------------|||||||-------------------------------------------------------------------
--------------||||||||-||r|||||||---|||--|||-----|||||---|||||||||||---|||-%%%%%%%|||-------%%%--%%%%%%%%---%%%%%--#---#------|||||||-----%%%%%%%%F%%%%%%%%%%%%%%%%%%%%%%%%%%%%%%%%%%%%%%%%%%%%%%%%%%%%%
%%%%%%%%%%%%%%||||||||%%%%%%%%%%%%%%|||--|||-----|||||---|||||||||||---|||-|||||||||yg------|||--||||||||---|||||%%%---%%%----|||||||-----||||||||%|||||||||||||||||||||||||||||||||||||||||||||||||||||
|||||||||||||||||||||||||||||||||||||||--|||XXXXX|||||---|||||||||||---|||XXXXXXXXXXXXXXXXXX|||--||||||||---||||||||---|||XXXXXXXXXXXXXXXX||||||||||||||||||||||||||||||||||||||||||||||||||||||||||||||
