HEIGHT=16;WIDTH=201;THEME=0;OVERRIDE=false
--------------------------------------------------------------------------------------------------------------------------------------------------------------------------------------------------------
--------------------------------------------------------------------------------------------------------------------------------------------------------------------------------------------------------
--------------------------------------------------------------------------------------------------------------------------------------------------------------------------------------------------------
--------------------------------------------------------------------------------------------------------------------------------------------------------------------------------------------------------
--------------------------------------------------------------------------------------------------------------------------------------------------------------------------------------------------------
--------------------------------------------------------------------------------------------------------------------------------------------------------------------------------------------------------
--------------------------------------------------------------------------------------------------------------------------------------------------------------------------------------------------------
--------------------------------------------------------------------------------------------------------------------------------------------------------------------------------------------------------
-------------------------------SSSSSU-------------------------------------------------------------------------------------------------------------------------------------------------------------------
--------------------------------------------------------------------------------------------------------------------------------------------------------------------------------------------------------
-----------------------------------------------------------------------------------------------------------------tt-------------------------------------------------------------------------------------
--------------------SSSCUC-------------------------------------------------------SSCC2S---------------------Tt---tt-------------------------------------------------------------------------------------
------------------------------%%%%%%%%%----------%%---%%------------------------------------------g---------tt---tt----------%%%%%%%%%------------------------------------------------------------------
-----------------g------------|||||||||----------||---||%%---%%----------------------------------%%%%%%%%%%%%%%%%%%%%%-------|||||||||-----------%%%%%%%%F%%%%%%%%%%%%%%%%%%%%%%%%%%%%%%%%%%%%%%%%%%%%%%
%%%%%%%%%%%%%%%%%%%-----g-----|||||||||----------||---||||---||---r---%%%%--%%%%--g--------------|||||||||||||||||||||-------|||||||||%%%%---%%%%||||||||%||||||||||||||||||||||||||||||||||||||||||||||
|||||||||||||||||||XXXXXXXXXXX|||||||||XXXX--XXXX||---||||---||XXXXXXX||||--||||XXXXXXXXXXXX---XX|||||||||||||||||||||XX---XX|||||||||||||---|||||||||||||||||||||||||||||||||||||||||||||||||||||||||||
