HEIGHT=16;WIDTH=201;THEME=0;OVERRIDE=false
--------------------------------------------------------------------------------------------------------------------------------------------------------------------------------------------------------
--------------------------------------------------------------------------------------------------------------------------------------------------------------------------------------------------------
--------------------------------------------------------------------------------------------------------------------------------------------------------------------------------------------------------
--------------------------------------------------------------------------------------------------------------------------------------------------------------------------------------------------------
--------------------------------------------------------------------------------------------------------------------------------------------------------------------------------------------------------
--------------------------------------------------------------------------------------------------------------------------------------------------------------------------------------------------------
--------------------------------------------------------------------------------------------------------------------------------------------------------------------------------------------------------
--------------------------------------------------------------------------------------------------------------------------------------------------------------------------------------------------------
--------------------------------------------------------------------------------------------------------------------------------------------------------------------------------------------------------
------------------------------------------CS2S----------------------------------------------------------------------------------------------------------------------------------------------------------
--------------------------------------------------------------------------------------------------------------------------------------------------------------------------------------------------------
------------------------------------------------------------------y--r----------------------------------------------------------------------------------------------------------------------------------
---------------------------------------------------------#---#---%%%%%%------------------%%--%%--------------------#---#-----------%%%---%%%------------------------------------------------------------
%%%%%%%%%%%%---%%---------#--#----------%%%%%%%%%---%%--##---##--||||||%%%%%%%%--%%%%%%%%||--||%%---%%%%%---%%%---##---##---%%%%%%%|||---|||%%%%%%%%F%%%%%%%%%%%%%%%%%%%%%%%%%%%%%%%%%%%%%%%%%%%%%%%%%%%
||||||||||||---||--------##--##---------|||||||||---||%%%%---%%%%||||||||||||||--||||||||||--||||---|||||---|||--###---###--||||||||||---|||||||||||%|||||||||||||||||||||||||||||||||||||||||||||||||||
||||||||||||---||XX--XXXXXX--XXXXXX---XX|||||||||---||||||---||||||||||||||||||--||||||||||--||||---|||||---|||XXXXX---XXXXX||||||||||---|||||||||||||||||||||||||||||||||||||||||||||||||||||||||||||||
