HEIGHT=16;WIDTH=201;THEME=0;OVERRIDE=false
--------------------------------------------------------------------------------------------------------------------------------------------------------------------------------------------------------
--------------------------------------------------------------------------------------------------------------------------------------------------------------------------------------------------------
--------------------------------------------------------------------------------------------------------------------------------------------------------------------------------------------------------
--------------------------------------------------------------------------------------------------------------------------------------------------------------------------------------------------------
--------------------------------------------------------------------------------------------------------------------------------------------------------------------------------------------------------
--------------------------------------------------------------------------------------------------------------------------------------------------------------------------------------------------------
--------------------------------------------------------------------------------------------------------------------------------------------------------------------------------------------------------
--------------------------------------------------------------------------------------------------------------------------------------------------------------------------------------------------------
-------------------------------------------------------%%%%%--------------------------------------------------------------------------------------------------------------------------------------------
-------------------------------------------------------|||||--------------------------------------------------------------------------------------------------------------------------------------------
-------------------------------------------------------|||||-------k---g--------------------------------------------------------------------------------------------------------------------------------
------------------------------------------------%%%%%--|||||-------%%%%%%---------------------------%%%%%-----------------------------------------------------------------------------------------------
%%%%%%%%%%%%%------------------------%%%%-------|||||--|||||-------||||||----%%--%%-----------------|||||---------------------%%---%%-------------------------------------------------------------------
|||||||||||||------------%%%%%--%%%%%||||%%--%%-|||||--|||||-------||||||----||--||-----------------||||g---------------------||---||%%%%---%%%%%%%%%%%%F%%%%%%%%%%%%%%%%%%%%%%%%%%%%%%%%%%%%%%%%%%%%%%%
|||||||||||||------------|||||--|||||||||||--||-||||g--|||||-----k-||||||--k-||--||%%%%%%%%%%%%%%%%%%%%%%%%%------------------||---||||||---||||||||||||%|||||||||||||||||||||||||||||||||||||||||||||||
|||||||||||||XXXXX--XXXXX|||||--|||||||||||--||XXXXXXXXXXXXXXXXXXXXXXXXXXXXXX||--|||||||||||||||||||||||||||XXXXX--XXXXXXX--XX||---||||||---||||||||||||||||||||||||||||||||||||||||||||||||||||||||||||
