HEIGHT=16;WIDTH=201;THEME=0;OVERRIDE=false
--------------------------------------------------------------------------------------------------------------------------------------------------------------------------------------------------------
--------------------------------------------------------------------------------------------------------------------------------------------------------------------------------------------------------
--------------------------------------------------------------------------------------------------------------------------------------------------------------------------------------------------------
--------------------------------------------------------------------------------------------------------------------------------------------------------------------------------------------------------
--------------------------------------------------------------------------------------------------------------------------------------------------------------------------------------------------------
--------------------------------------------------------------------------------------------------------------------------------------------------------------------------------------------------------
--------------------------------------------------------------------------------------------------------------------------------------------------------------------------------------------------------
--------------------------------------------------------------------------------------------------------------------------------------------------------------------------------------------------------
--------------------------------------------------------------------------------------------------------------------------------------------------------------------------------------------------------
--------------------------------------------------------------------------------------------------------------------------------------------------------------------------------------------------------
-----------------------------------------------------------------------------------------------------SSCCSS---------------------------------------------------------------------------------------------
--------------------------------------------------------------------------------------------------------------------------------------------------------------------------------------------------------
------------------%%--#--#---------------#--#----%%--%%-----------------------------%%%%%%%%%%----------------#---#-----------------tt------------------------------------------------------------------
------------------||%%%--%%%%%%---%%%---##--##---||--||---------------------%%------||||||||||%%%%%---------%%%---%%%------------Tt-tt------%%%%%%%%F%%%%%%%%%%%%%%%%%%%%%%%%%%%%%%%%%%%%%%%%%%%%%%%%%%%
%%%%%%%%%%%%%%--%%|||||--||||||---|||--###--###--||--||%%%%--%%%%-----------||------|||||||||||||||%%%%%%%%%|||---|||--#---#-----tt-tt------||||||||%|||||||||||||||||||||||||||||||||||||||||||||||||||
||||||||||||||--|||||||--||||||---|||XXXXX--XXXXX||--||||||--||||XX--XXXXXXX||XX--XX|||||||||||||||||||||||||||---|||XXX---XXXXXXXXXXXXXXXXX||||||||||||||||||||||||||||||||||||||||||||||||||||||||||||
