HEIGHT=16;WIDTH=201;THEME=0;OVERRIDE=false
--------------------------------------------------------------------------------------------------------------------------------------------------------------------------------------------------------
--------------------------------------------------------------------------------------------------------------------------------------------------------------------------------------------------------
--------------------------------------------------------------------------------------------------------------------------------------------------------------------------------------------------------
--------------------------------------------------------------------------------------------------------------------------------------------------------------------------------------------------------
--------------------------------------------------------------------------------------------------------------------------------------------------------------------------------------------------------
--------------------------------------------------------------------------------------------------------------------------------------------------------------------------------------------------------
--------------------------------------------------------------------------------------------------------------------------------------------------------------------------------------------------------
--------------------------------------------------------------------------------------------------------------------------------------------------------------------------------------------------------
--------------------------------------------------------------------------------------------------------------------------------------------------------------------------------------------------------
--------------------------------------------------------------------------------------------------------------------------------------------------------------------------------------------------------
----------------#---#-----------------------------------------------------------------------------------------------------------------------------------------------------------------------------------
---------------##---##----------------------------------------------------------------------------------------------------------------------------------------------------------------------------------
-------------%%%%---%%%%--#--#---------------------------tt----tt--%%--%%------------%%%%---%%%%-----------------------------------------Tt-%%%%%%%%F%%%%%%%%%%%%%%%%%%%%%%%%%%%%%%%%%%%%%%%%%%%%%%%%%%%
-------------||||---||||%%%--%%%------%%%%%%-------------tt-tt-tt--||--||%%%%%--%%%%%||||---||||----------------%%%---%%%----------------tt-||||||||%|||||||||||||||||||||||||||||||||||||||||||||||||||
-------------||||---|||||||--|||------||||||%%%%--%%%%---tt-tt-tt--||--|||||||--|||||||||---||||%%%%%%%%---%%%%%|||---|||%%%%%--%%%%%%%%%%%%||||||||||||||||||||||||||||||||||||||||||||||||||||||||||||
XXXXXXXXXXXXX||||---|||||||--|||XX--XX||||||||||--||||XXXXXXXXXXXXX||--|||||||--|||||||||---||||||||||||---||||||||---||||||||--||||||||||||||||||||||||||||||||||||||||||||||||||||||||||||||||||||||||
