HEIGHT=16;WIDTH=201;THEME=0;OVERRIDE=false
--------------------------------------------------------------------------------------------------------------------------------------------------------------------------------------------------------
--------------------------------------------------------------------------------------------------------------------------------------------------------------------------------------------------------
--------------------------------------------------------------------------------------------------------------------------------------------------------------------------------------------------------
--------------------------------------------------------------------------------------------------------------------------------------------------------------------------------------------------------
--------------------------------------------------------------------------------------------------------------------------------------------------------------------------------------------------------
--------------------------------------------------------------------------------------------------------------------------------------------------------------------------------------------------------
--------------------------------------------------------------------------------------------------------------------------------------------------------------------------------------------------------
--------------------------------------------------------------------------------------------------------------------------------------------------------------------------------------------------------
-----------------------------------k--------------------------------------------------------------------------------------------------------------------------------------------------------------------
-----------------------------%%%%%%%--------------------------------------------------------------------------------------------------------------------------------------------------------------------
-----------------------------|||||||--------------------------------------------%%%%%%------------------------------------------------------------------------------------------------------------------
----------------r------------|||||||-------------------r-------------------tt---||||||----------------------Tt------------------------------------------------------------------------------------------
%%%%%%%%%%---%%%%%%%---------||||||g----------------%%%%%--------#--#------tt---||||||---%%%%%--%%%%%-------tt------------------------------------------------------------------------------------------
||||||||||---r||||g|--%%%%%%%%%%%%%%%%--------------|||||-------##--##---%%%%%%%%%%%%%%%%|||||--|||||%%--%%-tt-----%%%%%---%%%%%%%%---%%%%%%%%%%%F%%%%%%%%%%%%%%%%%%%%%%%%%%%%%%%%%%%%%%%%%%%%%%%%%%%%%%
||||||||||%%%%%%%%%%%%||||||||||||||||%%%%%---%%%%%-|||y|------###--###--|||||||||||||||||||||--|||||||--||%%%%%%%%|||||---||||||||---|||||||||||%||||||||||||||||||||||||||||||||||||||||||||||||||||||
|||||||||||||||||||||||||||||||||||||||||||---|||||XXXXXXXXXXXXXXX--XXXXX|||||||||||||||||||||--|||||||--|||||||||||||||---||||||||---||||||||||||||||||||||||||||||||||||||||||||||||||||||||||||||||||
