HEIGHT=16;WIDTH=201;THEME=0;OVERRIDE=false
--------------------------------------------------------------------------------------------------------------------------------------------------------------------------------------------------------
--------------------------------------------------------------------------------------------------------------------------------------------------------------------------------------------------------
--------------------------------------------------------------------------------------------------------------------------------------------------------------------------------------------------------
------------------------------------------------------------------------%%%%----------------------------------------------------------------------------------------------------------------------------
------------------------------------------------------------------------||||----------------------------------------------------------------------------------------------------------------------------
------------------------------------------------------------------------||||----------------------------------------------------------------------------------------------------------------------------
------------------------------------------------------------------------||||----------r-----------------------------------------------------------------------------------------------------------------
------------------------------------------------------------------------||||-------%%%%-----------------------------------------------------------------------------------------------------------------
------------S2SUCCC2----------------------------------------------------||||-------r|||-----------------------------------------------------------------------------------------------------------------
----------------------------------------------------------%%%%%---------||||-----%%%%%|----------------------------------2SSSS2-------------------------------------------------------------------------
----------------------------------------------------------|||||---------||||-----||||||----------------------------------------------CSCS---------------------------------------------------------------
----------------r-----------------#--#--------------------|||||---------||||-----||||||-----------------------------------------------------------------------------------------------------------------
-----------%%%%%%%%%%%%%%--%%%---##--##-------------------|||||----g----|k||-k---||||||-------------#--#------------------------------------------------------------------------------------------------
-----------||||||||||||||--|||--###--###---tt----------%%%%%%%%%%%%%%%%%%%%%%%%%%%%%%%%%%%---------##--##--------------%%%%%%%%%%---y-------------------------------------------------------------------
%%%%%%%%%%%||||||||||||||--|||%%%%%--%%%%%-tt---%%---%%|||||||||||||||||||||||||||||||||||%%--%%--###--###--%%%%---%%%%||||||||||%%%%%%%%%%%%%%%%%F%%%%%%%%%%%%%%%%%%%%%%%%%%%%%%%%%%%%%%%%%%%%%%%%%%%%%
|||||||||||||||||||||||||--||||||||--|||||XXXXXX||---|||||||||||||||||||||||||||||||||||||||--||XXXXX--XXXXX||||---|||||||||||||||||||||||||||||||X|||||||||||||||||||||||||||||||||||||||||||||||||||||
