HEIGHT=16;WIDTH=201;THEME=0;OVERRIDE=false
--------------------------------------------------------------------------------------------------------------------------------------------------------------------------------------------------------
--------------------------------------------------------------------------------------------------------------------------------------------------------------------------------------------------------
--------------------------------------------------------------------------------------------------------------------------------------------------------------------------------------------------------
--------------------------------------------------------------------------------------------------------------------------------------------------------------------------------------------------------
--------------------------------------------------------------------------------------------------------------------------------------------------------------------------------------------------------
--------------------------------------------------------------------------------------------------------------------------------------------------------------------------------------------------------
--------------------------------------------------------------------------------------------------------------------------------------------------------------------------------------------------------
--------------------------------------------------------------------------------------------------------------------------------------------------------------------------------------------------------
------------------------------------------------------------------------------------------------------------------------%%%%----------------------------------------------------------------------------
------------------------------------------------------------------------------------------------------------------------||||----------------------------------------------------------------------------
-------------tt----------------------------------------------%%%%%----------------------------------------------------%%%|||----------------------------------------------------------------------------
-------------tt------------------------------------#---#-----|||||----------------------------------------------------|||||y-------CCUC2----------------------------------------------------------------
-------------tt-%%%%%--%%%%%----%%-------%%--%%---##---##----|||||----------------------%%%---%%%%%%%%%%%----------%%%%%%%%%%%%-------------------------------------------------------------------------
-----------%%%%%|||||--|||||----||-------||--||--###---###--%%%%%%%%%%%-----------------|||---|||||||||||----------||||||||||||-------------------------------------------------------------------------
%%%%%%%%%%%||||||||||--|||||%%%%||%%---%%||--||%%%%%---%%%%%|||||||||||%%%--%%%%%%---%%%|||---|||||||||||%%%%------||||||||||||-----------%%%%%%%%F%%%%%%%%%%%%%%%%%%%%%%%%%%%%%%%%%%%%%%%%%%%%%%%%%%%%%
|||||||||||||||||||||--|||||||||||||---||||--|||||||---|||||||||||||||||||--||||||---||||||---|||||||||||||||XX--XX||||||||||||XXXXXXXXXXX||||||||X|||||||||||||||||||||||||||||||||||||||||||||||||||||
