HEIGHT=16;WIDTH=201;THEME=0;OVERRIDE=false
--------------------------------------------------------------------------------------------------------------------------------------------------------------------------------------------------------
--------------------------------------------------------------------------------------------------------------------------------------------------------------------------------------------------------
--------------------------------------------------------------------------------------------------------------------------------------------------------------------------------------------------------
--------------------------------------------------------------------------------------------------------------------------------------------------------------------------------------------------------
----------------------------------------------SSS-S-----------------------------------------------------------------------------------------------------------------------------------------------------
--------------------------------------------------------------------------------------------------------------------------------------------------------------------------------------------------------
-------------------------------------------------|------------------------------------------------------------------------------------------------------------------------------------------------------
---------------------------------------------GK--r-k----------------------------------------------------------------------------------------------------------------------------------------------------
---------------------------------------------%%%%%%%----------------------------------------------------------------------------------------------------------------------------------------------------
---------------------------------------------|||||||------------------------------------------------------------------------------------r--g-g----------------------------------------------------------
---------------------------------------------|||||||---------------------------------------------------#--#----------------------------%%%%%%%----------------------------------------------------------
--------------------------------------------Y|||||||----r---------------------------------------------##--##---------------------------|||||||----------------------------------------------------------
-----------------------------%%%%%%--------%%%%%%%%%%%%%%%%%%---------------------------------------%%%%--%%%%------------------------r|||||||----------------------------------------------------------
-----------------------------||||||--------||||||||||||||||||%%---%%--------------------------------||||--||||%%%%%--%%%%%------%%--%%%%%|||||----------------------------------------------------------
----------%%%%%---%%%%%----k-||||||--------||||||||||||||||||||---||------------%%%%%--%%%%%--------||||--|||||||||--|||||%%--%%||--||||||||||--%%%%%%%%F%%%%%%%%%%%%%%%%%%%%%%%%%%%%%%%%%%%%%%%%%%%%%%%
XXXXXXXXXX|||||---|||||XXXXXXXXXXXXXXXXXXXX||||||||||||||||||||---||XXXXX--XXXXX|||||--|||||XXX--XXX||||--|||||||||--|||||||--||||XXXXXXXXXXXXXX||||||||X|||||||||||||||||||||||||||||||||||||||||||||||
