HEIGHT=16;WIDTH=201;THEME=0;OVERRIDE=false
--------------------------------------------------------------------------------------------------------------------------------------------------------------------------------------------------------
--------------------------------------------------------------------------------------------------------------------------------------------------------------------------------------------------------
--------------------------------------------------------------------------------------------------------------------------------------------------------------------------------------------------------
--------------------------------------------------------------------------------------------------------------------------------------------------------------------------------------------------------
--------------------------------------------------------------------------------------------------------------------------------------------------------------------------------------------------------
--------------------------------------------------------------------------------------------------------------------------------------------------------------------------------------------------------
--------------------------------------------------------------------------------------------------------------------------------------------------------------------------------------------------------
--------------------------------------------------------------------------------------------------------------------------------------------------------------------------------------------------------
--------------------------------------------------------------------------------------------------------------------------------------------------------------------------------------------------------
--------------------------------------------------------------------------------------------------------------------------------------------------------------------------------------------------------
--------------------------------------------------------------------------------------------------------------CSS---------------------------------------------------------------------------------------
----------------#---#-------------------------------------------------------------------------------------------------------------#---#-----------------------------------------------------------------
---------------##---##-------------#--#----------#---#------#--#----tt-------Tt-%%%%---%%%%--------------------------------------##---##----------------------------------------------------------------
%%%%%%%%%%%%%%%%%---%%%%%%%---%%%%%%--%%%-------##---##---%%%--%%%--tt--tt---tt-||||---||||------------------------------------%%%%---%%%%%%%%%%%%F%%%%%%%%%%%%%%%%%%%%%%%%%%%%%%%%%%%%%%%%%%%%%%%%%%%%%
|||||||||||||||||---|||||||---||||||--|||%%%%--###---###--|||--|||--tt--tt---tt-||||---||||%%--%%---------%%%%%%%%%------------||||---||||||||||||%|||||||||||||||||||||||||||||||||||||||||||||||||||||
|||||||||||||||||---|||||||---||||||--|||||||XXXXX---XXXXX|||--|||XXXXXXXXXXXXXX||||---||||||--||XXX---XXX|||||||||XXXXX--XXXXX||||---||||||||||||||||||||||||||||||||||||||||||||||||||||||||||||||||||
