HEIGHT=16;WIDTH=201;THEME=0;OVERRIDE=false
--------------------------------------------------------------------------------------------------------------------------------------------------------------------------------------------------------
--------------------------------------------------------------------------------------------------------------------------------------------------------------------------------------------------------
--------------------------------------------------------------------------------------------------------------------------------------------------------------------------------------------------------
--------------------------------------------------------------------------------------------------------------------------------------------------------------------------------------------------------
--------------------------------------------------------------------------------------------------------------------------------------------------------------------------------------------------------
--------------------------------------------------------------------------------------------------------------------------------------------------------------------------------------------------------
--------------------------------------------------------------------------SC-SCSS-----------------------------------------------------------------------------------------------------------------------
--------------------------------------------------------------------------------------------------------------------------------------------------------------------------------------------------------
----------------------------------------------------------------------------%---------------------------------------------------------------------------------------------------------------------------
---------------------------------------------------------------------------g|y--g-----------------------------------------------------------------------------------------------------------------------
--------------------------------------------------------------------------%%%%%%%-----------------------------------------------------------------------------------------------------------------------
-----------------------------------------------------------------------g-r|||||||-----------------------------------------------------------------------------------------------------------------------
-----------%%%---%%%-------------%%---%%------------------------------%%%%%%%%%%%%%---------%%%---%%%-----------------#---#----%%--%%-------------------------------------------------------------------
-----------|||---|||%%%%%---%%%%%||---||------------------------------|||||||||||||%%---%%--|||---|||----------------##---##---||--||-------------------------------------------------------------------
%%%%%%%%%%%|||---||||||||---|||||||---||------------------------------|||||||||||||||---||%%|||---|||%%%%%---%%%%%--###---###--||--||%%--%%%%%%%%%%F%%%%%%%%%%%%%%%%%%%%%%%%%%%%%%%%%%%%%%%%%%%%%%%%%%%%
||||||||||||||---||||||||---|||||||---||XXX---XXXXXXX---XXXXXXXX--XXXX|||||||||||||||---|||||||---||||||||---|||||XXXXX---XXXXX||--||||--||||||||||X||||||||||||||||||||||||||||||||||||||||||||||||||||
