HEIGHT=16;WIDTH=201;THEME=0;OVERRIDE=false
--------------------------------------------------------------------------------------------------------------------------------------------------------------------------------------------------------
--------------------------------------------------------------------------------------------------------------------------------------------------------------------------------------------------------
--------------------------------------------------------------------------------------------------------------------------------------------------------------------------------------------------------
--------------------------------------------------------------------------------------------------------------------------------------------------------------------------------------------------------
--------------------------------------------------------------------------------------------------------------------------------------------------------------------------------------------------------
--------------------------------------------------------------------------------------------------------------------------------------------------------------------------------------------------------
-------------------------------------------------------------------------------------------------------------%%%----------------------------------------------------------------------------------------
-------------------------------------------------------------------------------------------------------------|||--k-------------------------------------------------------------------------------------
-------------------------------------------------------------------------------------------------------------||%%%%%------------------------------------------------------------------------------------
--------------------------------------------------------------------------------------------------------g----|||||||------------------------------------------------------------------------------------
--------------------------------------------------------------------------------------------------------%%%--|||||||------------------------------------------------------------------------------------
--------------------------------------------------------------------------------------------------------|||--|||||||------------------------------------------------------------------------------------
-------------------------------------------%%%%%--%%%%%----------------#--#--------k----------%%%%%----%%%%%%%%%%%%%%%%----%%%---%%%--------------------------------------------------------------------
-----------------------%%%%---%%%%%%%%%%%%%|||||--|||||---------------##--##----%%%%%%--------|||||%%%%||||||||||||||||%%%%|||---|||-------%%%%%%%%F%%%%%%%%%%%%%%%%%%%%%%%%%%%%%%%%%%%%%%%%%%%%%%%%%%%%
-----------------------||||---||||||||||||||||||--|||||--------------###--###---||||||--------||||||||||||||||||||||||||||||||---|||-------||||||||%||||||||||||||||||||||||||||||||||||||||||||||||||||
XXXXXXXXXXXXXXXX---XXXX||||---||||||||||||||||||--|||||XXXXX--XXXXXXXXXX--XXXXXXXXXXXXXXXXXXXX||||||||||||||||||||||||||||||||---|||XX---XX|||||||||||||||||||||||||||||||||||||||||||||||||||||||||||||
