HEIGHT=16;WIDTH=201;THEME=0;OVERRIDE=false
--------------------------------------------------------------------------------------------------------------------------------------------------------------------------------------------------------
--------------------------------------------------------------------------------------------------------------------------------------------------------------------------------------------------------
--------------------------------------------------------------------------------------------------------------------------------------------------------------------------------------------------------
--------------------------------------------------------------------------------------------------------------------------------------------------------------------------------------------------------
--------------------------------------------------------------------------------------------------------------------------------------------------------------------------------------------------------
--------------------------------------------------------------------------------------------------------------------------------------------------------------------------------------------------------
--------------------------------------------------------------------------------------------------------------------------------------------------------------------------------------------------------
-------------------k------------------------------------------------------------------------------------------------------------------------------------------------------------------------------------
------------------%%%------------CS2S2------------------------------------------------------------------------------------------------------------------------------------------------------------------
------------------|||-----------------------------------------------------------------------------------------------------------------------------------------------------------------------------------
------------------|||------------------------------------------------------------#---#------------------------------------------------------------------------------------------------------------------
--------------r---|||----------k-g----------------------------------------------##---##-----------------------------------------------------------------------------------------------------------------
%%%%%%%%%%%%%%%%%%%%%%%%%%%%%%%%%%%%%%%%------%%%%%%%%%%%------%%---%%---------###---###-------%%%%--%%%%-----------------%%%%%---%%%%%-----------------------------------------------------------------
||||||||||||||||||||||||||||||||||||||||%%----|||||||||||%%%%%%||---||%%%%%%%%%%%%---%%%%%-----||||--||||%%%---%%%--------|||||---|||||----%%%%%%%%F%%%%%%%%%%%%%%%%%%%%%%%%%%%%%%%%%%%%%%%%%%%%%%%%%%%%
||||||||||||||||||||||||||||||||||||||||||%%%%|||||||||||||||||||---||||||||||||||---|||||%%%%%||||--|||||||---|||%%%--%%%|||||---|||||%%%%||||||||%||||||||||||||||||||||||||||||||||||||||||||||||||||
|||||||||||||||||||||||||||||||||||||||||||||||||||||||||||||||||---||||||||||||||---||||||||||||||--|||||||---||||||--||||||||---||||||||||||||||||||||||||||||||||||||||||||||||||||||||||||||||||||||
