HEIGHT=16;WIDTH=201;THEME=0;OVERRIDE=false
--------------------------------------------------------------------------------------------------------------------------------------------------------------------------------------------------------
--------------------------------------------------------------------------------------------------------------------------------------------------------------------------------------------------------
--------------------------------------------------------------------------------------------------------------------------------------------------------------------------------------------------------
--------------------------------------------------------------------------------------------------------------------------------------------------------------------------------------------------------
--------------------------------------------------------------------------------------------------------------------------------------------------------------------------------------------------------
--------------------------------------------------------------------------------------------------------------------------------------------------------------------------------------------------------
------------------y-y-y---------------------------------------------------------------------------------------------------------------------------------------------------------------------------------
------------------%%%%%---------------------------------------------------------------------------------------------------------------------------------------------------------------------------------
------------------|||||---------------------------------------------------------------------------------------------------------------------------------------------------------------------------------
------------------|||||-------------------------------------------------------------------------------------------------------------SCCUSS--------------------------------------------------------------
---------------%%%%%%||---------------------------------------------------------------------------------------------------------------------------------------------------------------------------------
---------------||||||||-------------------------------------%%%------CSSS-------------------------------------------------------------------------------------------------------------------------------
-----------g---||||||||r------------------------------------|||-----------%%---%%----------------------------------------------------g------------------------------------------------------------------
%%%%%%%%%%%%%%%%%%%%%%%%%%%%--------------------------------||gk----------||---||----------------------------------------%%%--%%%%%%%%%%%%%%------------------------------------------------------------
||||||||||||||||||||||||||||-------------%%---%%%%%%%%%%%%%%%%%%%%---y----||---||-----------y----------------------yk----|||--||||||||||||||------------------------------------------------------------
||||||||||||||||||||||||||||XXXXX---XXXXX||---||||||||||||||||||||XXXXXXXX||---||XXX---XXXXXXXXXXXXXXXXX---XXXXXXXXXXXXXX|||--||||||||||||||XXXXXXXXFXXXXXXXXXXXXXXXXXXXXXXXXXXXXXXXXXXXXXXXXXXXXXXXXXXX
