HEIGHT=16;WIDTH=201;THEME=0;OVERRIDE=false
--------------------------------------------------------------------------------------------------------------------------------------------------------------------------------------------------------
--------------------------------------------------------------------------------------------------------------------------------------------------------------------------------------------------------
--------------------------------------------------------------------------------------------------------------------------------------------------------------------------------------------------------
--------------------------------------------------------------------------------------------------------------------------------------------------------------------------------------------------------
--------------------------------------------------------------------------------------------------------------------------------------------------------------------------------------------------------
--------------------------------------------------------------------------------------------------------------------------------------------------------------------------------------------------------
--------------------------------------------------------------------------------------------------------------------------------------------------------------------------------------------------------
---------------------------------------------------------------------------------------rky--------------------------------------------------------------------------------------------------------------
-------------------------------------------------grr----------------------------------%%%%-----------------------------------------------SCS-2S---------------------------------------------------------
-----------------------------------------------%%%%%--------------#---#---------------||||-------------------tt-Tt--------------------------------------------------------------------------------------
---------------------CCSSS2--------------------|||||-------------##---##----%%%%%-----|%%%%%-----------------tt-tt--------------#--#--------%-----------------------------------------------------------
---------------------------------------------%%%%%%|------------###---###---|||||-----||||||-----------------tt-tt-------------##--##-------|-----------------------------------------------------------
---------------------------------------------|||||||----------%%%%%---%%%%%-|g|||--g--||||||-------------%%%%%%%%%%%%%%------%%%%--%%%%%%%%%%%%%%%%%%%%%F%%%%%%%%%%%%%%%%%%%%%%%%%%%%%%%%%%%%%%%%%%%%%%%
%%%%%%%%%%%%---------g---k--%%%%--%%%%-------|||||||--%%%--%%%|||||---|||||%%%%%%%%%%-||||||-------------||||||||||||||------||||--|||||||||||||||||||||%|||||||||||||||||||||||||||||||||||||||||||||||
||||||||||||------%%%%%%%%%%||||--||||-------|||||||--|||--||||||||---|||||||||||||||%%%%%%%%%%%---------||||||||||||||------||||--|||||||||||||||||||||||||||||||||||||||||||||||||||||||||||||||||||||
||||||||||||XX--XX||||||||||||||--||||XXXXXXXXXXXXXXXX|||--||||||||---||||||||||||||||||||||||||XXX---XXX||||||||||||||XXXXXX||||--|||||||||||||||||||||||||||||||||||||||||||||||||||||||||||||||||||||
