HEIGHT=16;WIDTH=201;THEME=0;OVERRIDE=false
--------------------------------------------------------------------------------------------------------------------------------------------------------------------------------------------------------
--------------------------------------------------------------------------------------------------------------------------------------------------------------------------------------------------------
--------------------------------------------------------------------------------------------------------------------------------------------------------------------------------------------------------
--------------------------------------------------------------------------------------------------------------------------------------------------------------------------------------------------------
--------------------------------------------------------------------------------------------------------------------------------------------------------------------------------------------------------
--------------------------------------------------------------------------------------------------------------------------------------------------------------------------------------------------------
---------------------------S2SS-------------------------------------------------------------------------------------------------------------------------------------------------------------------------
--------------------------------------------------------------------------------------------------------------------------------------------------------------------------------------------------------
--------------------------------------------------------------------------------------------------------------------------------------------------------------------------------------------------------
---------------------------yg----------------------------------------------------------------------------------------------------tt---tt----------------------------------------------------------------
--------------------------%%%%%---------------------------y----------------------------------------------------------------------tt---tt----------------------------------------------------------------
--------------------------|||||---------------------------%%%%-------%%%%%------------tt-----------------------------------------tt---tt----------------------------------------------------------------
----------------------g---y|||k---------------------------||||-------|||||------%%----tt-tt--------------------%%%--%%%%%--%%%%%%%%%%%%%%---------------------------------------------------------------
%%%%%%%%%%----------%%%%%%%%%%%%%%------------------------||||------%%%%%%%%%%%%||----tt-tt--------------------|||--|||||--||||||||||||||---------------------------------------------------------------
||||||||||----------||||||||||||||-g----r-------------%%%%%%%%%%%%%%||||||||||||||%%%%%%%%%%%%%----------------|||--|||||--||||||||||||||%%%%%%%%F%%%%%%%%%%%%%%%%%%%%%%%%%%%%%%%%%%%%%%%%%%%%%%%%%%%%%%
||||||||||XXXX--XXXX||||||||||||||XXXXXXXXXXXXX---XXXX|||||||||||||||||||||||||||||||||||||||||XX--XXXXXX--XXXX|||--|||||--||||||||||||||||||||||X||||||||||||||||||||||||||||||||||||||||||||||||||||||
