HEIGHT=16;WIDTH=201;THEME=0;OVERRIDE=false
--------------------------------------------------------------------------------------------------------------------------------------------------------------------------------------------------------
--------------------------------------------------------------------------------------------------------------------------------------------------------------------------------------------------------
--------------------------------------------------------------------------------------------------------------------------------------------------------------------------------------------------------
------------------------------------------------------------g-------------------------------------------------------------------------------------------------------------------------------------------
---------------------------------------------------------%%%%-------------------------------------------------------------------------------------------------------------------------------------------
---------------------------------------------------------||||-------------------------------------------------------------------------------------------------------------------------------------------
---------------------------------------------------------||||-------------------------------------------------------------------------------------------------------------------------------------------
-----------------------------------------------------%%%%%%||-------------------------------------------------------------------------------------------------------------------------------------------
-----------------------------------------------------||||||||-------------------------------------------------------------------------------------------------------------------------------------------
-----------------------------------------------------||||||||---------------------------------------------------------UCS-------------------------------------------------------------------------------
-----------------------------------------------------||%%%|||------------------------------#--#---------------------------------------------------------------------------------------------------------
-----------------------------------------------------||||||||-----------------------------##--##--------------------------------------------------------------------------------------------------------
------------%%%%%---%%%%%--------%%%---%%%-----------|y||||||---------------------------%%%%--%%%%----------%%---%%---------------------%%%%%%%%F%%%%%%%%%%%%%%%%%%%%%%%%%%%%%%%%%%%%%%%%%%%%%%%%%%%%%%%
------------|||||---|||||%%%%%%%%|||---|||%%---%%%%%%%%%%%%%%%%-%%%---------------------||||--||||----------||---||%%%%%%%%%--%%--------||||||||%|||||||||||||||||||||||||||||||||||||||||||||||||||||||
------------|||||---||||||||||||||||---|||||---||||||||||||||||-rr|y----K-%%%%%%--------||||--||||%%%%%--%%%||---|||||||||||--||--------||||||||||||||||||||||||||||||||||||||||||||||||||||||||||||||||
XXXXXXXXXXXX|||||---||||||||||||||||---|||||---||||||||||||||||XXXXXXXXXXX||||||XXX--XXX||||--|||||||||--|||||---|||||||||||--||XXXXXXXX||||||||||||||||||||||||||||||||||||||||||||||||||||||||||||||||
