HEIGHT=16;WIDTH=201;THEME=0;OVERRIDE=false
--------------------------------------------------------------------------------------------------------------------------------------------------------------------------------------------------------
--------------------------------------------------------------------------------------------------------------------------------------------------------------------------------------------------------
--------------------------------------------------------------------------------------------------------------------------------------------------------------------------------------------------------
----------------------------------------------------------------------SSS2------------------------------------------------------------------------------------------------------------------------------
--------------------------------------------------------------------------------------------------------------------------------------------------------------------------------------------------------
--------------------------------------------------------------------------------------------------------------------------------------------------------------------------------------------------------
----------------------------------------------------------------------k----r----------------------------------------------------------------------------------------------------------------------------
----------------------------------------------------------------------%%%%%%----------------------------------------------------------------------------------------------------------------------------
----------------------------------------------------------------------||||||----------------------------------------------------------------------------------------------------------------------------
----------------------------------------------------------------------||||||k---------------------------------------------------------------------------------------------------------------------------
---------------------------------------------r------------------------|%%%%%%%--------------------------------------------------------------------------------------------------------------------------
-----------------#--#----------------------%%%%-----------------------||||||||---------------------------------------------------------#---#------------------------------------------------------------
%%%%%%%%%%%%%%--##--##--------%%%---------K||||-----------------------||||||||-------------------------------------------------------%%%---%%%----------------------------------------------------------
||||||||||||||%%%%--%%%%%%--%%|||------%%%%%%%%%%----%%---%%---------%%%%%%%%%%%%%%%%-------%%%%--%%%%%%%%%--%%%%%-------------------|||---|||----------------------------------------------------------
||||||||||||||||||--||||||--|||||------||||||||||%%%%||---||%%%---%%%||||||||||||||||-------||||--|||||||||--|||||-------------------|||---|||----------------------------------------------------------
||||||||||||||||||--||||||--|||||XX--XX||||||||||||||||---|||||---|||||||||||||||||||XX---XX||||--|||||||||--|||||XXXXX--XXXXXXX---XX|||---|||XXXXXXXXFXXXXXXXXXXXXXXXXXXXXXXXXXXXXXXXXXXXXXXXXXXXXXXXXX
