HEIGHT=16;WIDTH=201;THEME=0;OVERRIDE=false
--------------------------------------------------------------------------------------------------------------------------------------------------------------------------------------------------------
--------------------------------------------------------------------------------------------------------------------------------------------------------------------------------------------------------
--------------------------------------------------------------------------------------------------------------------------------------------------------------------------------------------------------
--------------------------------------------------------------------------------------------------------------------------------------------------------------------------------------------------------
--------------------------------------------------------------------------------------------------------------------------------------------------------------------------------------------------------
--------------------------------------------------------------------------------------------------------------------------------------------------------------------------------------------------------
--------------------------------------------------------------------------------------------------------------------------------------------------------------------------------------------------------
--------------------------------------------------------------------------------------------------------------------------------------------------------------------------------------------------------
--------------------------------y-----------------------------------------------------------------------------------------y-----------------------------------------------------------------------------
------------------------------%%%%%%%-------------------------------------------------------------------------------------%%%---------------------------------------------------------------------------
------------------------------|||||||-------------------------------------------------------------------------------------|||---------------------------------------------------------------------------
------------#---#-------------|||||||--------------------#---#----------------------------------------------------------k-|y|---------------------------------------------------------------------------
----------%%%---%%%-----------|g|||||-------------------##---##-------------------tt-------------tt-------------------%%%%%%%%%%---------------%%%%%%%%F%%%%%%%%%%%%%%%%%%%%%%%%%%%%%%%%%%%%%%%%%%%%%%%%
----------|||---|||%%%--%%%%%%%%%%%%%%%%%%%-----------%%%%---%%%%%%%%---%%%%-tt---tt-%%%%--%%%%--tt-%%%---%%%---------||||||||||----%%%%---%%%%||||||||%||||||||||||||||||||||||||||||||||||||||||||||||
%%%%%%%%%%|||---||||||--|||||||||||||||||||-----------||||---||||||||---||||-tt---tt-||||--||||--tt-|||---|||---------||||||||||----||||---|||||||||||||||||||||||||||||||||||||||||||||||||||||||||||||
|||||||||||||---||||||--|||||||||||||||||||XXXX---XXXX||||---||||||||---||||XXXXXXXXX||||--||||XXXXX|||---|||XXX---XXX||||||||||XXXX||||---|||||||||||||||||||||||||||||||||||||||||||||||||||||||||||||
