HEIGHT=16;WIDTH=201;THEME=0;OVERRIDE=false
--------------------------------------------------------------------------------------------------------------------------------------------------------------------------------------------------------
--------------------------------------------------------------------------------------------------------------------------------------------------------------------------------------------------------
--------------------------------------------------------------------------------------------------------------------------------------------------------------------------------------------------------
--------------------------------------------------------------------------------------------------------------------------------------------------------------------------------------------------------
--------------------------------------------------------------------------------------------------------------------------------------------------------------------------------------------------------
--------------------------------------------------------------------------------------------------------------------------------------------------------------------------------------------------------
--------------------------------------------------------------------------------------------------------------------------------------------------------------------------------------------------------
--------------------------------------------------------------------------------------------------------------------------------------------------------------------------------------------------------
----------------------------------------CCS2CS--------------------------------------------------------------------------SSUS--------------SSSC2CS-------------------------------------------------------
--------------------------------------------------------------------------------------------------------------------------------------------------------------------------------------------------------
--------------#--#------------------------------------------#--#----------------------------------SSC--------#---#--------------------------------------------------------------------------------------
-------------##--##------------------------Yk--------------##--##-------------------------------------------##---##-------r-------tt--------------------------------------------------------------------
------------###--###--------tt---tt----%%%%%%%-----------%%%%--%%%%---------------------%%--%%-------------###---###--%%%%%%%%%---tt---%%%%%%%%%%%------------------------------------------------------
----------%%%%%--%%%%%------tt---tt----|||||||----k----k-||||--||||%%%%%--%%%%%%%%---%%%||--||--y--------%%%%%---%%%%%|||||||||---tt---|||||||||||------------------------------------------------------
----------|||||--|||||-----%%%%%%%%%%%%%%%%%%%%%%%%%%%%%%||||--|||||||||--||||||||---|||||--||%%%%%%%%%%%|||||---||||||||||||||%%%%%%%%|||||||||||------------------------------------------------------
XXXXXXXXXX|||||--|||||XXXXX||||||||||||||||||||||||||||||||||--|||||||||--||||||||---|||||--||||||||||||||||||---|||||||||||||||||||||||||||||||||XXXXXXXXFXXXXXXXXXXXXXXXXXXXXXXXXXXXXXXXXXXXXXXXXXXXXX
