HEIGHT=16;WIDTH=201;THEME=0;OVERRIDE=false
--------------------------------------------------------------------------------------------------------------------------------------------------------------------------------------------------------
--------------------------------------------------------------------------------------------------------------------------------------------------------------------------------------------------------
-----------------------------------------------------------y--k-----------------------------------------------------------------------------------------------------------------------------------------
----------------------------------------------------------%%%%%-----------------------------------------------------------------------------------------------------------------------------------------
----------------------------------------------------------|||||-----------------------------------------------------------------------------------------------------------------------------------------
----------------------------------------------------------|||||-----------------------------------------------------------------------------------------------------------------------------------------
----------------------------------------------------------|||||--r--------------------------------------------------------------------------------------------------------------------------------------
----------------------------------------------------------|%%%%%%%--------------------------------------------------------------------------------------------------------------------------------------
----------------------------------------------------------||||||||--------------------------------------------------------------------------------------------------------------------------------------
--------------------------------------------------------%%%%||||||--------------------------------k---------------------#---#---------------------------------------------------------------------------
----------------Tt--------------------------------------||||||||||--------------------------------%%%%-----------------##---##--------------------------------------------------------------------------
----------------tt--------------------------------------||||||||||-------------------------------y||||----------------###---###-------------------------------------------------------------------------
%%%%%%%%%%%%%---tt-----------------------%%%%%--%%%%%---||k|||||||------tt----%%--%%------------%%%%%%%%%%%%%%%--%%%%%%%%---%%%%%%%--%%-----------------------------------------------------------------
|||||||||||||%%%%%%%%%-------------------|||||--|||||%%%%%%%%%%%%%%%%---tt----||--||------------|||||||||||||||--||||||||---|||||||--||%%---------------------------------------------------------------
||||||||||||||||||||||%%%---%%%%%%%--%%%%|||||--|||||||||||||||||||||---tt----||--||%%%%%--%%%%%|||||||||||||||--||||||||---|||||||--||||%%%%%%%%F%%%%%%%%%%%%%%%%%%%%%%%%%%%%%%%%%%%%%%%%%%%%%%%%%%%%%%
|||||||||||||||||||||||||---|||||||--|||||||||--|||||||||||||||||||||XXXXXXXXX||--|||||||--||||||||||||||||||||--||||||||---|||||||--||||||||||||X||||||||||||||||||||||||||||||||||||||||||||||||||||||
