HEIGHT=16;WIDTH=201;THEME=0;OVERRIDE=false
--------------------------------------------------------------------------------------------------------------------------------------------------------------------------------------------------------
--------------------------------------------------------------------------------------------------------------------------------------------------------------------------------------------------------
--------------------------------------------------------------------------------------------------------------------------------------------------------------------------------------------------------
--------------------------------------------------------------------------------------------------------------------------------------------------------------------------------------------------------
--------------------------------------------------------------------------------------------------------------------------------------------------------------------------------------------------------
------------------------------------------------------------k-------------------------------------------------------------------------------------------------------------------------------------------
------------------------------------------------------------%%%%%---------------------------------------------------------------------------------------------------------------------------------------
------------------------------------------------------------|||||--------------------------------------------------------------------SUS----------------------------------------------------------------
------------------------------------------------------------|||||---------------------------------------------------------------------------------------------------------------------------------------
------------------------------------------------------------|r|||--------------------------------------%%%%%--------------------------------------------------------------------------------------------
--------------------------2SSCSSS-------------------------%%%%%||--------------------------------------|||||--------------------------------------------------------------------------------------------
----------------------------------------------------------|||||||-----#--#-----------------------------|||||-------------------------%%%%%--------------------------------------------------------------
%%%%%%%%%%%%%%%%%--%%%%-----------------------------------|g|||k|r--%%%--%%%---------------------------||%%%%%--------------%%%--%%%-|||||--------------------------------------------------------------
|||||||||||||||||--||||-g--------------------------%%%%%%%%%%%%%%%%%|||--|||%%---%%------------------ky|||||r|--------------|||--|||%%%%%%%%%%%%%%%%%%%%%%F%%%%%%%%%%%%%%%%%%%%%%%%%%%%%%%%%%%%%%%%%%%%%
|||||||||||||||||--||||%%%%%%%%%%%%%%%---%%%%------||||||||||||||||||||--|||||---||%%---%%%%---%%%%%%%%%%%%%%%%%%%%--#---#--|||--|||||||||||||||||||||||||%|||||||||||||||||||||||||||||||||||||||||||||
|||||||||||||||||--|||||||||||||||||||---||||XX--XX||||||||||||||||||||--|||||---||||---||||---||||||||||||||||||||XXX---XXX|||--|||||||||||||||||||||||||||||||||||||||||||||||||||||||||||||||||||||||
