HEIGHT=16;WIDTH=201;THEME=0;OVERRIDE=false
--------------------------------------------------------------------------------------------------------------------------------------------------------------------------------------------------------
--------------------------------------------------------------------------------------------------------------------------------------------------------------------------------------------------------
--------------------------------------------------------------------------------------------------------------------------------------------------------------------------------------------------------
--------------------------------------------------------------------------------------------------------------------------------------------------------------------------------------------------------
--------------------------------------------------------------------------------------------------------------------------------------------------------------------------------------------------------
--------------------------------------------------------------------------------------------------------------------------------------------------------------------------------------------------------
--------------------------------------------------------------------------------------------------------------------------------------------------------------------------------------------------------
--------------------------------------------------------------------------------------------------------------------------------------------------------------------------------------------------------
--------------------------------------------------------------------------------------------------------------------------------------------------------------------------------------------------------
--------------------------------------------------------------------------------------------------------------------------------------------------------------------------------------------------------
---------------#---#-----------------------------%%%%%%%------------------#---#-------------------------------------------------------------------------------------------------------------------------
--------------##---##----------------------------|yg||||-------#--#------##---##----SS2UCS2S----------------------------------------------%%%%----------------------------------------------------------
%%%%%%%%%%%--###---###-------------------------%%%%%%%||------##--##----###---###-------------------------------------%%%%--%%%%----------||||k------%%%%%%%%F%%%%%%%%%%%%%%%%%%%%%%%%%%%%%%%%%%%%%%%%%%
|||||||||||%%%%%---%%%%%-----------------------|||||||||----%%%%--%%%%%%%%%---%%%%%-----------------------------------||||--||||-----%%%%%%%%%%%%%%%%||||||||%||||||||||||||||||||||||||||||||||||||||||
||||||||||||||||---|||||%%%---%%%%%%%%---%%%%%-|||||||||-g--||||--|||||||||---|||||------k----------------------------||||--||||-----|||||||||||||||||||||||||||||||||||||||||||||||||||||||||||||||||||
||||||||||||||||---||||||||---||||||||---|||||XXXXXXXXXXXXXX||||--|||||||||---|||||XXXXXXXXXXXXXXX--XXXXXXXXXX---XXXXX||||--||||XXXXX|||||||||||||||||||||||||||||||||||||||||||||||||||||||||||||||||||
