HEIGHT=16;WIDTH=201;THEME=0;OVERRIDE=false
--------------------------------------------------------------------------------------------------------------------------------------------------------------------------------------------------------
--------------------------------------------------------------------------------------------------------------------------------------------------------------------------------------------------------
--------------------------------------------------------------------------------------------------------------------------------------------------------------------------------------------------------
--------------------------------------------------------------------------------------------------------------------------------------------------------------------------------------------------------
--------------------------------------------------------------------------------------------------------------------------------------------------------------------------------------------------------
--------------------------------------------------------------------------------------------------------------------------------------------------------------------------------------------------------
-------------------------------------------g------------------------------------------------------------------------------------------------------------------------------------------------------------
-----------------------------------------%%%%%----------------------------------------------------------------------------------------------------------------------------------------------------------
-----------------------------------------|||||----------------------------------------------------------------------------------------------------------------------------------------------------------
-----------------------------------------|||%%%%%-------------------------------------------------------------------------------------------------------------------------------------------------------
-----------------------------------------||||||||-------------------------CC----------------------------------------------------------------------------------------------------------------------------
-----------------------------------------||||||||--------------------------------------------------------------CS2--------------------------------------------------------------------------------------
----------------------------%%%----------||||||||---%%%--%%%----------------|--------------%%---%%------------------------------------------------------------------------------------------------------
%%%%%%%%%%%%-------------r--|||---%%%%%%%%%%%%%%%%%%|||--|||----------------y--------------||---||-------------------------%%---%%----------------------------------------------------------------------
||||||||||||-----------%%%%%%%%%%%|||||||||||||||||||||--|||--%%%---%%%%%%%%%%%%-----------||---||--#---#--------r---------||---||%%%---%%%%%%%%%%%F%%%%%%%%%%%%%%%%%%%%%%%%%%%%%%%%%%%%%%%%%%%%%%%%%%%%
||||||||||||XXXX---XXXX||||||||||||||||||||||||||||||||--|||XX|||---||||||||||||XX---XXXXXX||---||XXX---XXXXXXXXXXXXXX---XX||---|||||---|||||||||||X||||||||||||||||||||||||||||||||||||||||||||||||||||
