HEIGHT=16;WIDTH=201;THEME=0;OVERRIDE=false
--------------------------------------------------------------------------------------------------------------------------------------------------------------------------------------------------------
--------------------------------------------------------------------------------------------------------------------------------------------------------------------------------------------------------
--------------------------------------------------------------------------------------------------------------------------------------------------------------------------------------------------------
----------------------------------------------------------------------------%%%%%%----------------------------------------------------------------------------------------------------------------------
----------------------------------------------------------------------------||||||----------------------------------------------------------------------------------------------------------------------
--------------------------------------------------------------------%%%-----||||||----------------------------------------------------------------------------------------------------------------------
--------------------------------------------------------------------|||-----||||||----------------------------------------------------------------------------------------------------------------------
--------------------------------------------------------------------|||-----||||||----------------------------------------------------------------------------------------------------------------------
--------------------------------------------------------------------|||-----||||||----------------------------------------------------------------------------------------------------------------------
--------------------------------------------------------------------|||---%%%%%|||----------------------------------------------------------------------------------------------------------------------
---------------------------------SSCSSC-----#---#-----Tt----Tt------|||---||||||||----------------------------------------------------------------------------------------------------------------------
-------------------------------------------##---##----tt----tt------||gg--||||||||------------------------#--#------------------------------------------------------------------------------------------
-----------------------------------------%%%%---%%%%%%%%%%%%%%%%%%%%%%%%%%%%%%%%%%%%%-------%%%%---%%%%--##--##-----------------------------------------------------------------------------------------
-------------------%%%%%--%%%%%----------||||---|||||||||||||||||||||||||||||||||||||-------||||---||||%%%%--%%%%---------------------%%--%%------------------------------------------------------------
%%%%%%%%%%%%%------|||||--|||||%%%%%%%%%%||||---|||||||||||||||||||||||||||||||||||||%%---%%||||---||||||||--||||%%%%---%%%%%%%%--%%%%||--||%%%%%%%%F%%%%%%%%%%%%%%%%%%%%%%%%%%%%%%%%%%%%%%%%%%%%%%%%%%%
|||||||||||||XX--XX|||||--|||||||||||||||||||---|||||||||||||||||||||||||||||||||||||||---||||||---||||||||--||||||||---||||||||--||||||--||||||||||X|||||||||||||||||||||||||||||||||||||||||||||||||||
