HEIGHT=16;WIDTH=201;THEME=0;OVERRIDE=false
--------------------------------------------------------------------------------------------------------------------------------------------------------------------------------------------------------
--------------------------------------------------------------------------------------------------------------------------------------------------------------------------------------------------------
--------------------------------------------------------------------------------------------------------------------------------------------------------------------------------------------------------
--------------------------------------------------------------------------------------------------------------------------------------------------------------------------------------------------------
--------------------------------------------------------------------------%%%%%%%-----------------------------------------------------------------------------------------------------------------------
-------------------------------------%%%%%%-------------------------------|||||||-----------------------------------------------------------------------------------------------------------------------
-------------------------------------||||||-------------------------------|||||||-----------------------------------------------------------------------------------------------------------------------
-------------------------------------||||||-------------------------------|||||||-----------------------------------------------------------------------------------------------------------------------
-------------------------------------||||||---------------------------%%%%%%|||||-----------------------------------------------------------------------------------------------------------------------
-------------------------------------|%%%%|---------------------------|||||||||||-----------------------------------------------------------------------------------------------------------------------
------------------------------------y||||||---------------------------|||||||||||----------------------------SSSS---------------------------------------------------------------------------------------
---------------------#---#---------%%%%%|||---------------------------|||||||||||-----------------------------------------------------------------------------------------------------------------------
-----------%%---%%--##---##--------|||||||r--r----------%%%%%---%%%%%%%%%%%%%%%%%%%----#---#----------------------------------------------%%%%%%%%F%%%%%%%%%%%%%%%%%%%%%%%%%%%%%%%%%%%%%%%%%%%%%%%%%%%%%
-----------||---||%%%%---%%%%%%%%%%%%%%%%%%%%%%%%%---%%%|||||---|||||||||||||||||||---##---##------------------g--------------------------||||||||%|||||||||||||||||||||||||||||||||||||||||||||||||||||
%%%%%%%%%%%||---||||||---|||||||||||||||||||||||||---||||||||---|||||||||||||||||||--###---###--------------%%%%%%%%%---------------------||||||||||||||||||||||||||||||||||||||||||||||||||||||||||||||
|||||||||||||---||||||---|||||||||||||||||||||||||---||||||||---|||||||||||||||||||XXXXX---XXXXXXXXXX--XXXXX|||||||||XXXX--XXXXXXXX---XXXX||||||||||||||||||||||||||||||||||||||||||||||||||||||||||||||
