HEIGHT=16;WIDTH=201;THEME=0;OVERRIDE=false
--------------------------------------------------------------------------------------------------------------------------------------------------------------------------------------------------------
--------------------------------------------------------------------------------------------------------------------------------------------------------------------------------------------------------
--------------------------------------------------------------------------------------------------------------------------------------------------------------------------------------------------------
--------------------------------------------------------------------------------------------------------------------------------------------------------------------------------------------------------
--------------------------------------------------------------------------------------------------------------------------------------------------------------------------------------------------------
--------------------------------------------------------------------------------------------------------------------------------------------------------------------------------------------------------
--------------------------------------------------------------------------------------------------------------------------------------------------------------------------------------------------------
--------------------------------------------------------------------------------------------------------------------------------------------------------------------------------------------------------
----------------------------------------------SSSS------------------------------------------------------------------------------------------------------------------------------------------------------
-------------------------------------------------------------------------------------------------------------------S2S2SSC------------------------------------------------------------------------------
------------------------------------tt------------------------------------------y-----------------------------------------------------------------------------------------------------------------------
------------------------------------tt-----------------------------------------%%%----------------------------------------------------------------------------------------------------------------------
%%%%%%%%%%%%%--------------------%%%%%%%%%---%%%%%%----------------------------|||----------------------%%%%--%%%%-----------%%%%--%%%%-----------------------------------------------------------------
|||||||||||||%%%%%--%%%%%%%%--%%%|||||||||---|||||G----------------------------|||----------------------||||--||||%%%%%%%%%%%||||--||||---------%%%%%%%%F%%%%%%%%%%%%%%%%%%%%%%%%%%%%%%%%%%%%%%%%%%%%%%%
||||||||||||||||||--||||||||--||||||||||||%%%%%%%%%%%%%%%---------------g-k----|||---%%%%---%%%%--#--#--||||--|||||||||||||||||||--||||%%%---%%%||||||||%|||||||||||||||||||||||||||||||||||||||||||||||
||||||||||||||||||--||||||||--|||||||||||||||||||||||||||XXXXX---XXXXXXXXXXXXXXXXXXXX||||---||||XXX--XXX||||--|||||||||||||||||||--|||||||---|||||||||||||||||||||||||||||||||||||||||||||||||||||||||||
