HEIGHT=16;WIDTH=201;THEME=0;OVERRIDE=false
--------------------------------------------------------------------------------------------------------------------------------------------------------------------------------------------------------
--------------------------------------------------------------------------------------------------------------------------------------------------------------------------------------------------------
--------------------------------------------------------------------------------------------------------------------------------------------------------------------------------------------------------
--------------------------------------------------------------------------------------------------------------------------------------------------------------------------------------------------------
--------------------------------------------------------------------------------------------------------------------------------------------------------------------------------------------------------
--------------------------------------------------------------------------------------------------------------------------------------------------------------------------------------------------------
--------------------------------------------------------------------------------------------------------------------------------------------------------------------------------------------------------
-------------------------------%%%%%--------------------------------------------------------------------------------------------------------------------------------------------------------------------
-------------------------------|||||--------------------------------------------------------------------------CSS---------------------------------------------------------------------------------------
-------------------------------|||||----------#--#------------------------------------------------------------------------------------k-----------------------------------------------------------------
---------------------------%%%%%%%||---------##--##----------------------------------------SSCCSSSSS-------------------------------%%%%%----------------------------------------------------------------
---------------------------|||||||||--------###--###----------SSSS----------------------------------------------Gr-----------------|G|||----------------------------------------------------------------
---------------------------|||||||||------%%%%%--%%%%%%%--%%-----------#--#---%%%%%--%%%%%------------------%%%%%%%-----------%%%%%%%%%%%%%%%%----------------------------------------------------------
%%%%%%%%%%%%%%------------k|||||||||------|||||--|||||||--||------%---##--##--|||||--|||||------------------||||y||-----------||||||||||||||||%%%%%%%%F%%%%%%%%%%%%%%%%%%%%%%%%%%%%%%%%%%%%%%%%%%%%%%%%%
||||||||||||||---------%%%%%%%%%%%%%%%%%%%|||||--|||||||--||----rg|-%%%%--%%%%|||||--|||||%%%%%%%%%%%%%%%%%%%%%%%%%%%%%-------||||||||||||||||||||||||%|||||||||||||||||||||||||||||||||||||||||||||||||
||||||||||||||XXX---XXX||||||||||||||||||||||||--|||||||--||XXXXXXXX||||--|||||||||--||||||||||||||||||||||||||||||||||XX---XX||||||||||||||||||||||||||||||||||||||||||||||||||||||||||||||||||||||||||
