HEIGHT=16;WIDTH=201;THEME=0;OVERRIDE=false
--------------------------------------------------------------------------------------------------------------------------------------------------------------------------------------------------------
--------------------------------------------------------------------------------------------------------------------------------------------------------------------------------------------------------
--------------------------------------------------------------------------------------------------------------------------------------------------------------------------------------------------------
--------------------------------------------------------------------------------------------------------------------------------------------------------------------------------------------------------
--------------------------------------------------------------------------------------------------------------------------------------------------------------------------------------------------------
--------------------------------------------------------------------------------------------------------------------------------------------------------------------------------------------------------
--------------------------------------------------------------------------------------------------------------------------------------------------------------------------------------------------------
--------------------------------------------------------------------------------------------------------------------------------------------------------------------------------------------------------
--------------------------------------------------------------------------------------------------------------------------------------------------------------------------------------------------------
--------------------------------USCU-----------------------------------------------------#--#-----------------tt----------------------------------------------------------------------------------------
----------------------------------------------------------------------------------------##--##----------------tt----tt----------r---g-------------------------------------------------------------------
----------------------------------------------------------------------------CUSCCS-----###--###---------------tt----tt----------%%%%%%------------------------------------------------------------------
-------------------------------ry---y------------------------------------------------%%%%%--%%%%%----------%%%%%%%%%%%%%--------||||||----%%%%%%%%F%%%%%%%%%%%%%%%%%%%%%%%%%%%%%%%%%%%%%%%%%%%%%%%%%%%%%
%%%%%%%%%%%-------------------%%%%%%%%%%---%%%%%---%%%--------%%--%%-----------------|||||--|||||----%%--%%|||||||||||||------k-|||||g-k--||||||||%|||||||||||||||||||||||||||||||||||||||||||||||||||||
|||||||||||%%%%--%%%%---------||||||||||---|||||---|||%%%--%%%||--||%%--%%--k--y-g---|||||--|||||----||--|||||||||||||||%%%%%%%%%%%%%%%%%%||||||||||||||||||||||||||||||||||||||||||||||||||||||||||||||
|||||||||||||||--||||XXX---XXX||||||||||---|||||---||||||--|||||--||||--||XXXXXXXXXXX|||||--|||||XXXX||--|||||||||||||||||||||||||||||||||||||||||||||||||||||||||||||||||||||||||||||||||||||||||||||||
