HEIGHT=16;WIDTH=201;THEME=0;OVERRIDE=false
--------------------------------------------------------------------------------------------------------------------------------------------------------------------------------------------------------
--------------------------------------------------------------------------------------------------------------------------------------------------------------------------------------------------------
--------------------------------------------------------------------------------------------------------------------------------------------------------------------------------------------------------
--------------------------------------------------------------------------------------------------------------------------------------------------------------------------------------------------------
--------------------------------------------------------------------------------------------------------------------------------------------------------------------------------------------------------
--------------------------------------------------------------------------------------------------------------------------------------------------------------------------------------------------------
--------------------------------------------------------------------------------------------------------------------------------------------------------------------------------------------------------
--------------------------------------------------------------------------------------------------------------------------------------------------------------------------------------------------------
--------------------------------------------------------------------------------------------------------------------------------------------------------------------------------------------------------
--------------------------------------------------------------------------------------------------------------------------------------------------------------------------------------------------------
-------------------------------------#---#--------------------------------------------------------------------------------------------------------------------------------------------------------------
------------------------------------##---##-------------------------------------------------------------------------#--#--------------------------------------------------------------------------------
------------%%--%%-----------------###---###----------------------------------------------------------%%%%%--%%%%%%%%--%%%------------------------------------------------------------------------------
------------||--||%%---%%--------%%%%%---%%%%%%%%%%--%%%%%%%%%%%---%%%%-%%%%%%%-----------------------|||||--||||||||--|||-----------%%--%%-------------------------------------------------------------
%%%%%%%%%%%%||--||||---||--#--#--|||||---||||||||||--|||||||||||---||||-||||||Gk--------%%%%%---------|||||--||||||||--|||%%%%---%%%%||--||%%%%%%%%F%%%%%%%%%%%%%%%%%%%%%%%%%%%%%%%%%%%%%%%%%%%%%%%%%%%%
||||||||||||||--||||---||XXX--XXX|||||---||||||||||--|||||||||||---||||XXXXXXXXXXXXXXXXX|||||XXX---XXX|||||--||||||||--|||||||---||||||--||||||||||X||||||||||||||||||||||||||||||||||||||||||||||||||||
