HEIGHT=16;WIDTH=201;THEME=0;OVERRIDE=false
--------------------------------------------------------------------------------------------------------------------------------------------------------------------------------------------------------
--------------------------------------------------------------------------------------------------------------------------------------------------------------------------------------------------------
--------------------------------------------------------------------------------------------------------------------------------------------------------------------------------------------------------
--------------------------------------------------------------------------------------------------------------------------------------------------------------------------------------------------------
--------------------------------------------------------------------------------------------------------------------------------------------------------------------------------------------------------
--------------------------------------------------------------------------------------------------------------------------------------------------------------------------------------------------------
--------------------------------------------------------------------------------------------------------------------------------------------------------------------------------------------------------
--------------------------------------------------------------------------------------------------------------------------------------------------------------------------------------------------------
------------------------SSUS----------------------------------------------------------------------------------------------------------------------------------------------------------------------------
--------------------------------------------------------------------------------------------------------------------------------------------------------------------------------------------------------
--------------------------------------------------------------------------------------------K-----------------2SCS--------------------------------------------------------------------------------------
------------------------------y-------------------------------------------------------------%%%%--------------------------------------------------------------------------------------------------------
----------------------%%%%%%%%%%%%%--%%%--#--#----------------------------------------------||||----------------------%%%%%---%%%%%%%--%%%%%%%%%%F%%%%%%%%%%%%%%%%%%%%%%%%%%%%%%%%%%%%%%%%%%%%%%%%%%%%%%
%%%%%%%%%%%%%%--------|||||||||||||--|||%%%--%%%-------%%---%%-----------------------------%%%%%%%%%%----------k---r--|||||---|||||||--||||||||||%||||||||||||||||||||||||||||||||||||||||||||||||||||||
||||||||||||||%%%%%%%%|||||||||||||--||||||--|||%%---%%||---||-----------------------------||||||||||--------%%%%%%%%%|||||---|||||||--|||||||||||||||||||||||||||||||||||||||||||||||||||||||||||||||||
|||||||||||||||||||||||||||||||||||--||||||--|||||---||||---||XXXXX--XXXXXXXXXXXXXX---XXXXX||||||||||XXX--XXX||||||||||||||---|||||||--|||||||||||||||||||||||||||||||||||||||||||||||||||||||||||||||||
