HEIGHT=16;WIDTH=201;THEME=0;OVERRIDE=false
--------------------------------------------------------------------------------------------------------------------------------------------------------------------------------------------------------
--------------------------------------------------------------------------------------------------------------------------------------------------------------------------------------------------------
--------------------------------------------------------------------------------------------------------------------------------------------------------------------------------------------------------
--------------------------------------------------------------------------------------------------------------------------------------------------------------------------------------------------------
--------------------------------------------------------------------------------------------------------------------------------------------------------------------------------------------------------
--------------------------------------------------------------------------------------------------------------------------------------------------------------------------------------------------------
--------------------------------------------------------------------------------------------------------------------------------------------------------------------------------------------------------
---------------------------------------------------------------------------------------%%%--------------------------------------------------------------------------------------------------------------
---------------------------------------------------------------------------------------|||--------------------------------------------------------------------------------------------------------------
---------------------------------------------------------------------------------------|||--------------------------------------------------------------------------------------------------------------
-----------------------------------------------------------------------------------%%%%%%|--------------------------------------------------------------------------------------------------------------
-------------------------------------------------------------------#---#-----------|||||||--------------------------------------------------------------------------------------------------------------
--------------------------------------------%%%%--%%-------------%%%---%%%--------g|y|||||----------------%%%%%---%%%%%------------%%--%%%%%%%%%%F%%%%%%%%%%%%%%%%%%%%%%%%%%%%%%%%%%%%%%%%%%%%%%%%%%%%%%
--------------#--#-----#---#----------------||||--||%%%%%---%%%%%|||---|||%%%%%%%%%%%%%%%%%%%-------------|||||---|||||------------||--||||||||||%||||||||||||||||||||||||||||||||||||||||||||||||||||||
------------%%%--%%%--##---##---------------||||--|||||||---||||||||---||||||||||||||||||||||%%%%%---%%%%%|||||---|||||------------||--|||||||||||||||||||||||||||||||||||||||||||||||||||||||||||||||||
XXXXXXXXXXXX|||--|||XXXX---XXXXXXXXX---XXXXX||||--|||||||---||||||||---|||||||||||||||||||||||||||---||||||||||---|||||XXXXX--XXXXX||--|||||||||||||||||||||||||||||||||||||||||||||||||||||||||||||||||
