HEIGHT=16;WIDTH=201;THEME=0;OVERRIDE=false
--------------------------------------------------------------------------------------------------------------------------------------------------------------------------------------------------------
--------------------------------------------------------------------------------------------------------------------------------------------------------------------------------------------------------
--------------------------------------------------------------------------------------------------------------------------------------------------------------------------------------------------------
--------------------------------------------------------------------------------------------------------------------------------------------------------------------------------------------------------
--------------------------------------------------------------------------------------------------------------------------------------------------------------------------------------------------------
--------------------------------------------------------------------------------------------------------------------------------------------------------------------------------------------------------
--------------------------------------------------------------------------------------------------------------------------------------------------------------------------------------------------------
--------------------------------------------------------------------------------------------------------------------------------------------------------------------------------------------------------
-------------------------------------CSCSC--------------------------------------------------------------------------------------------------------------------------------------------------------------
---------------------------------------------------------------------------------------------------y----------------------------------------------------------------------------------------------------
--------------------------------------------------------------------------------------------------%%%%%------#---#--------------------------------------------------------------------------------------
--------------------------------Tt----------------------------------------------------------------|||||-----##---##-------------------------------------------------------------------------------------
--------------------------------tt-%%%%%%%%%-------------------------------------------------%%%%%%%%%%%%--###---###------------------------------------------------------------------------------------
--------------------------------tt-|||||||||-----------------%%%%%--%%%%%--------------------||||||||||||%%%%%---%%%%%%%%%%---%%%%%---#---#---%%%%%%%%F%%%%%%%%%%%%%%%%%%%%%%%%%%%%%%%%%%%%%%%%%%%%%%%%%
------------------------------%%%%%|||||||||-----------------|||||--|||||--------------------|||||||||||||||||---||||||||||---|||||--##---##--||||||||%|||||||||||||||||||||||||||||||||||||||||||||||||
XXXXXXXXXXXXXXXXXXX--XXXXXXXXX||||||||||||||XX--XXXXXX---XXXX|||||--|||||XXXX---XXXXXXX---XXX|||||||||||||||||---||||||||||---|||||XXXX---XXXX||||||||||||||||||||||||||||||||||||||||||||||||||||||||||
