HEIGHT=16;WIDTH=201;THEME=0;OVERRIDE=false
--------------------------------------------------------------------------------------------------------------------------------------------------------------------------------------------------------
--------------------------------------------------------------------------------------------------------------------------------------------------------------------------------------------------------
--------------------------------------------------------------------------------------------------------------------------------------------------------------------------------------------------------
--------------------------------------------------------------------------------------------------------------------------------------------------------------------------------------------------------
--------------------------------------------------------------------------------------------------------------------------------------------------------------------------------------------------------
--------------------------------------------------------------------------------------------------------------------------------------------------------------------------------------------------------
----------------------------------------------------------------------------S2SCSCS---------------------------------------------------------------------------------------------------------------------
--------------------------------------------------------------------------------------------------------------------------------------------------------------------------------------------------------
--------------------------------------------------------------------------------------------------------------------------------------------------------------------------------------------------------
----------------------------------------------------------------------------r-rry-----------------------------------------------------------------------------------------------------------------------
--------------------------------------------------#--#------kg--------------%%%%%%%---------------------------------------------------------------------------------------------------------------------
-------------------------------------------------##--##----%%%%%%-----------|||||||------------#--#-----------------------------------------------------------------------------------------------------
---------------------%%%%%%---------------------###--###---||||||-k--k------|||||||----------%%%--%%%---------------------------%%%%%--%%%%%------------------------------------------------------------
-------------#---#---||||||-------------------%%%%%--%%%%%%%%%%%%%%%%%%%%%%%%%%%%%%%%--#--#--|||--|||%%%---%%%------%%%%%--%%%%%|||||--|||||%%%%%%%%F%%%%%%%%%%%%%%%%%%%%%%%%%%%%%%%%%%%%%%%%%%%%%%%%%%%
%%%%%%%%%%--##---##--||||||-------------------|||||--||||||||||||||||||||||||||||||||%%%--%%%|||--||||||---|||%%--%%|||||--||||||||||--|||||||||||||%|||||||||||||||||||||||||||||||||||||||||||||||||||
||||||||||XXXX---XXXX||||||XXXX--XXXXXXX---XXX|||||--|||||||||||||||||||||||||||||||||||--||||||--||||||---|||||--|||||||--||||||||||--|||||||||||||||||||||||||||||||||||||||||||||||||||||||||||||||||
