HEIGHT=16;WIDTH=201;THEME=0;OVERRIDE=false
--------------------------------------------------------------------------------------------------------------------------------------------------------------------------------------------------------
--------------------------------------------------------------------------------------------------------------------------------------------------------------------------------------------------------
--------------------------------------------------------------------------------------------------------------------------------------------------------------------------------------------------------
------------------------------------------------------------------------------------------------------------------------------------r-------------------------------------------------------------------
----------------------------------------------------------------------------------------------------------------------------------%%%-------------------------------------------------------------------
----------------------------------------------------------------------------------------------------------------------------------|||-------------------------------------------------------------------
----------------------------------------------------------------------------------------------------------------------------------|||-------------------------------------------------------------------
----------------------------------------------------------------------------------------------------------------------------------|||-------------------------------------------------------------------
------------------------------------------------------------------------------------------------------------------------------%%%%%||-------------------------------------------------------------------
------------------------------------------------------------------------------------------------------------------------------|||||||-------------------------------------------------------------------
------------------------------------------------------------------------------------------------------------------------------|||||||-------------------------------------------------------------------
------------------------------------------------------------------------------------------------------Gy-k---CCSCCSU----------|||||||g------------------------------------------------------------------
%%%%%%%%%%%%-------------------------------------------Tt--------%%%%%---%%%%%---------------#---#---%%%%%%-----------%%%%%%%%%%%%%%%%%%%---------------------------------------------------------------
||||||||||||----------------%%%%--%%%%%%%%%---%%%%%-tt-tt-Tt-----|||||---|||||%%%%----------##---##--||||||-----------|||||||||||||||||||%%%%%%%%F%%%%%%%%%%%%%%%%%%%%%%%%%%%%%%%%%%%%%%%%%%%%%%%%%%%%%%
||||||||||||%%%%%--%%%%%----||||--|||||||||---|||||-tt-tt-tt-----|||||---|||||||||------%%%%%%---%%%%||||||------g----|||||||||||||||||||||||||||%||||||||||||||||||||||||||||||||||||||||||||||||||||||
|||||||||||||||||--|||||XXXX||||--|||||||||---|||||XXXXXXXXXXXXXX|||||---|||||||||XX--XX||||||---||||||||||XXXXXXXXXXX||||||||||||||||||||||||||||||||||||||||||||||||||||||||||||||||||||||||||||||||||
