HEIGHT=16;WIDTH=201;THEME=0;OVERRIDE=false
--------------------------------------------------------------------------------------------------------------------------------------------------------------------------------------------------------
--------------------------------------------------------------------------------------------------------------------------------------------------------------------------------------------------------
--------------------------------------------------------------------------------------------------------------------------------------------------------------------------------------------------------
--------------------------------------------------------------------------------------------------------------------------------------------------------------------------------------------------------
--------------------------------------------------------------------------------------------------------------------------------------------------------------------------------------------------------
--------------------------------------------------------------------------------------------------------------------------------------------------------------------------------------------------------
--------------------------------------------------------------------------------------------------------------------------------------------------------------------------------------------------------
--------------------------------------------------------------------------------------------------------------------------------------------------------------------------------------------------------
--------------------------------------------------------------------------------------------------------------------------------------------------------------------------------------------------------
-----------------------k----------------------------------------------------%%%-------------------------------------------------------------------------------------------------------------------------
--------------------%%%%----------------------------------------------------|||-------------------------------------------------------------------------------------------------------------------------
--------------Y----Y||||----------------------------------------------------|||-------------------------------------------------Tt----------------------------------------------------------------------
-------------%%%%%%%%%%%%%-------------------------------------%%%--%%%-----y||-------------------------------------------------tt----------------------------------------------------------------------
-------------|||||||||||||-------------------------------------|||--|||%%%%%%%%%%%%%%%%%%%---%%%%%%%--%%%%%-------------------%%%%%%--------------------------------------------------------------------
-------------|||||||||||||%%%%--%%%%---------------------------|||--||||||||||||||||||||||---|||||||--|||||-------------------||||||-------------%%%%%%%%F%%%%%%%%%%%%%%%%%%%%%%%%%%%%%%%%%%%%%%%%%%%%%%
XXXXXXXXXXXXX|||||||||||||||||--||||XXXXX---XXXXXXXXXXXXX---XXX|||--||||||||||||||||||||||---|||||||--|||||XXXXX--XXXXXX---XXX||||||XXXXX---XXXXX||||||||X||||||||||||||||||||||||||||||||||||||||||||||
