HEIGHT=16;WIDTH=201;THEME=0;OVERRIDE=false
--------------------------------------------------------------------------------------------------------------------------------------------------------------------------------------------------------
--------------------------------------------------------------------------------------------------------------------------------------------------------------------------------------------------------
--------------------------------------------------------------------------------------------------------------------------------------------------------------------------------------------------------
--------------------------------------------------------------------------------------------------------------------------------------------------------------------------------------------------------
--------------------------------------------------------------------------------------------------------------------------------------------------------------------------------------------------------
--------------------------------------------------------------------------------------------------------------------------------------------------------------------------------------------------------
--------------------------------------------------------------------------------------------------------------------------------------------------------------------------------------------------------
--------------------------------------------------------------------------------------------------------------------------------------------------------------------------------------------------------
---------------------------------------------------------------------------------UCCS-------------------------------------------------------------------------------------------------------------------
---------------------------------------------------------------------#--#-------------------------------------------------------------------------------------------------------------------------------
----------------------------------------%%%%%%%---------------------##--##---------------#---#----------------------------------------------------------------------------------------------------------
----------------------------------------|||||||--------------------###--###---rY--r-----##---##----------------------#--#----#---#----------------------------------------------------------------------
-------------%%%%---%%%%----------------|||||||----------------%%%%%%%--%%%%%%%%%%%%%%%%%%---%%%%-g----------------%%%--%%%%%%---%%%--------------------------------------------------------------------
-------------||||---||||-----%%%%--%%%%-|||||||----------------|||||||--||||||||||||||||||---||||%%%%%%%%%%%---%%%%|||--||||||---|||--------------------------------------------------------------------
%%%%%%%%%%%%%||||---||||-----||||--||||%%%%%%%%%%%%%%%%---%%%%%|||||||--||||||||||||||||||---|||||||||||||||---|||||||--||||||---|||---------%%%%%%%%F%%%%%%%%%%%%%%%%%%%%%%%%%%%%%%%%%%%%%%%%%%%%%%%%%%
|||||||||||||||||---||||XXXXX||||--||||||||||||||||||||---||||||||||||--||||||||||||||||||---|||||||||||||||---|||||||--||||||---|||XXX---XXX||||||||X||||||||||||||||||||||||||||||||||||||||||||||||||
