HEIGHT=16;WIDTH=201;THEME=0;OVERRIDE=false
--------------------------------------------------------------------------------------------------------------------------------------------------------------------------------------------------------
--------------------------------------------------------------------------------------------------------------------------------------------------------------------------------------------------------
--------------------------------------------------------------------------------------------------------------------------------------------------------------------------------------------------------
--------------------------------------------------------------------------------------------------------------------------------------------------------------------------------------------------------
--------------------------------------------------------------------------------------------------------------------------------------------------------------------------------------------------------
--------------------------------------------------------------------------------------------------------------------------------------------------------------------------------------------------------
--------------------------------------------------------------------------------------------------------------------------------------------------------------------------------------------------------
--------------------------------------------------------------------------------------------------------------------------------------------------------------------------------------------------------
--------------------------------------------------------------------------------------------------------------------------------------------------------------------------------------------------------
--------------------------------------------------------------------------------------------------------------------------------------------------------------------------------------------------------
-------------------------%%%%%%%---------------------------SSS2UC-------------------------------------------------------------------#---#---------------------------------------------------------------
-------------------------|||||||------------#---#------------------------------------SS2-------------------------------------------##---##--------------------------------------------------------------
-------------------------|||||||---y------%%%---%%%------------------------------------------------------------------------------%%%%---%%%%------------------------------------------------------------
----------%%---%%------%%%%%%%%%%%%%%%%%%%|||---|||---------y--gy------------------------------------------------------tt--------||||---||||------------------------------------------------------------
%%%%%%%%%%||---||------||||||||||||||||||||||---|||------%%%%%%%%%%%%---%%-------------y-y-----------%%%%%-------------tt--------||||---||||%%%%%%%%F%%%%%%%%%%%%%%%%%%%%%%%%%%%%%%%%%%%%%%%%%%%%%%%%%%%
||||||||||||---||XX--XX||||||||||||||||||||||---|||XXXXXX||||||||||||---||XX---XXXXXXXXXXXXXXXXXXXXXX|||||XXX---XXXXXXXXXXXXXXXXX||||---||||||||||||X|||||||||||||||||||||||||||||||||||||||||||||||||||
