HEIGHT=16;WIDTH=201;THEME=0;OVERRIDE=false
--------------------------------------------------------------------------------------------------------------------------------------------------------------------------------------------------------
--------------------------------------------------------------------------------------------------------------------------------------------------------------------------------------------------------
--------------------------------------------------------------------------------------------------------------------------------------------------------------------------------------------------------
--------------------------------------------------------------------------------------------------------------------------------------------------------------------------------------------------------
--------------------------------------------------------------------------------------------------------------------------------------------------------------------------------------------------------
--------------------------------------------------------------------------------------------------------------------------------------------------------------------------------------------------------
--------------------------------------------------------------------------------------------------------------------------------------------------------------------------------------------------------
--------------------------------------------------------------------------------------------------------------------------------------------------------------------------------------------------------
-------------------------------------------------------------------------------------------------------------------------------------UCSSCS-------------------------------------------------------------
--------------------------S-SC-SS---------------------------------------------------------------------------------------tt------------------------------------------------------------------------------
------------------------------------------------------------------------------------------------------------2222SS------tt--tt--------------------------------------------------------------------------
---------------------------%--%-----------------------------------------------------------------------------------------tt--tt--------------------------------------------------------------------------
---------------------------|--|-------------------------%%%%---------------------------%%%--%%%%%%%-----------------%%%%%%%%%%%%%%%%%%%%%%%%%-----------------------------------------------------------
-------------------------%%%%%%%%%%%%---%%%-------------||||--------g-----%%%%%---%%%%%|||--|||||||---------r-y-----|||||||||||||||||||||||||%%%%%%%%F%%%%%%%%%%%%%%%%%%%%%%%%%%%%%%%%%%%%%%%%%%%%%%%%%%
-------------%%%%%--%%%%%||||||||||||---|||-------------||||------%%%%%%%%|||||---||||||||--|||||||%%%%%%%%%%%%%%%%%|||||||||||||||||||||||||||||||||%||||||||||||||||||||||||||||||||||||||||||||||||||
XXXXXXXXXXXXX|||||--|||||||||||||||||---|||XXXXX---XXXXX||||XX--XX|||||||||||||---||||||||--||||||||||||||||||||||||||||||||||||||||||||||||||||||||||||||||||||||||||||||||||||||||||||||||||||||||||||
