HEIGHT=16;WIDTH=201;THEME=0;OVERRIDE=false
--------------------------------------------------------------------------------------------------------------------------------------------------------------------------------------------------------
--------------------------------------------------------------------------------------------------------------------------------------------------------------------------------------------------------
--------------------------------------------------------------------------------------------------------------------------------------------------------------------------------------------------------
--------------------------------------------------------------------------------------------------------------------------------------------------------------------------------------------------------
--------------------------------------------------------------------------------------------------------------------------------------------------------------------------------------------------------
--------------------------------------------------------------------------------------------------------------------------------------------------------------------------------------------------------
--------------------------------------------------------------------------------------------------------------------------------------------------------------------------------------------------------
--------------------------------------------------------------------------------------------------------------------------------------------------------------------------------------------------------
--------------------------------------------------------------------------------------------------------------------------------------------------------------------------------------------------------
--------------------------------------------------------------------------------------------------------------------------------------------------------------------------------------------------------
---------------------------------------------------------------------------------------------------S2SCS2-----------------------------------------------------------------------------------------------
--------------------S2SS--------------------------------------------------------------------------------------------------------------------------------------------------------------------------------
----------------------------%%%%---%%%%%%%%%---#--#---%%--%%---------------------%%---%%%%%---%%%----------%%%%--%%%%---------%%%%--%%%%----------------------------------------------------------------
----------------------------||||---|||||||||--##--##--||--||%%%%%--%%%%%%%%---%%%||---|||||---|||----------||||--||||%%%---%%%||||--||||----------------------------------------------------------------
----------------------------||||---|||||||||%%%%--%%%%||--|||||||--||||||||---|||||---|||||---|||%%%%%%%%%%||||--|||||||---|||||||--||||%%%%%%%%F%%%%%%%%%%%%%%%%%%%%%%%%%%%%%%%%%%%%%%%%%%%%%%%%%%%%%%%
XXXXXXXXXXXX---XXXXXXXXXXXXX||||---|||||||||||||--||||||--|||||||--||||||||---|||||---|||||---|||||||||||||||||--|||||||---|||||||--||||||||||||X|||||||||||||||||||||||||||||||||||||||||||||||||||||||
