HEIGHT=16;WIDTH=201;THEME=0;OVERRIDE=false
--------------------------------------------------------------------------------------------------------------------------------------------------------------------------------------------------------
--------------------------------------------------------------------------------------------------------------------------------------------------------------------------------------------------------
--------------------------------------------------------------------------------------------------------------------------------------------------------------------------------------------------------
--------------------------------------------------------------------------------------------------------------------------------------------------------------------------------------------------------
--------------------------------------------------------------------------------------------------------------------------------------------------------------------------------------------------------
---------------------------------------------------------------------------------yg---------------------------------------------------------------------------------------------------------------------
---------------------------------------------------------------------------------%%%--------------------------------------------------------------------------------------------------------------------
---------------------------------------------------------------------------------|||--------------------------------------------------------------------------------------------------------------------
---------------------------------------------------------------------------------|||--------------------------------------------------------------------------------------------------------------------
--------------------------------------------tt-----------------------------------|%%%%------------------------------------------------------------------------------------------------------------------
--------------------------------------------tt------------------------SSCSSS-----|||||-----------------------r------------------------------------------------------------------------------------------
----------------------------tt--Tt----------tt-----------------------------------|||||----------------------%%%%%%%-------------------------------------------------------------------------------------
----------------------------tt--tt------%%%%%%%----------------------------------|k|||------%%%--%%%--------|||||||----------------------#---#----------------------------------------------------------
----------%%%%---%%%%-------tt--tt------|||||||------------------------------%%%%%%%%%%%%%%%|||--|||%%%%%%%-|||||||--------------------%%%---%%%%%%%%%%%F%%%%%%%%%%%%%%%%%%%%%%%%%%%%%%%%%%%%%%%%%%%%%%%
----------||||---||||%%--%%%%%%%%%%%%%%%|||||||---------------------%%%%%%%%%||||||||||||||||||--||||||||||-|||||||--------%%---%%%%%%%|||---|||||||||||%|||||||||||||||||||||||||||||||||||||||||||||||
XXXXXXXXXX||||---||||||--||||||||||||||||||||||XXXX--XXXXXXXXXXXXXXX|||||||||||||||||||||||||||--||||||||||XXXXXXXXXXXX--XX||---||||||||||---|||||||||||||||||||||||||||||||||||||||||||||||||||||||||||
