HEIGHT=16;WIDTH=201;THEME=0;OVERRIDE=false
--------------------------------------------------------------------------------------------------------------------------------------------------------------------------------------------------------
--------------------------------------------------------------------------------------------------------------------------------------------------------------------------------------------------------
--------------------------------------------------------------------------------------------------------------------------------------------------------------------------------------------------------
--------------------------------------------------------------------------------------------------------------------------------------------------------------------------------------------------------
--------------------------------------------------------------------------------------------------------------------------------------------------------------------------------------------------------
--------------------------------------------------------------------------------------------------------------------------------------------------------------------------------------------------------
--------------------------------------------------------------------------------------------------------------------------------------------------------------------------------------------------------
--------------------------------------------------------------------------------------------------------------------------------------------------------------------------------------------------------
-----------------------------------------------------------------------------SCS2SCS--------------------------------------------------------------------------------------------------------------------
--------------------------------------------------------------------------------------------------------------------------------------------------------------------------------------------------------
----------------------------------------------------------------------------------------SSCC------------------------------------y-----------------------------------------------------------------------
----------------------------------------------------------------------------y------------------------------------------------%%%%%----------------------------------------------------------------------
%%%%%%%%%%--------------%%%%%%%%-----------tt------------------------------%%%%%%%%%%%--------------------%%%--%%%-----------|k|||-----%%%%--%%%%-------------------------------------------------------
||||||||||%%%%%%%%------||||||||-----------tt--------%%%---%%%-------------|||||||||||------y-------------|||--|||---#--#---%%%%%%%%%%%||||--||||%%%%%%%%F%%%%%%%%%%%%%%%%%%%%%%%%%%%%%%%%%%%%%%%%%%%%%%
||||||||||||||||||------||||||||-----------tt--------|||---|||-----%%%--%%%|||||||||||%%%%%%%%------%%--%%|||--|||--##--##--|||||||||||||||--||||||||||||%||||||||||||||||||||||||||||||||||||||||||||||
||||||||||||||||||XX--XX||||||||XXX--XXXXXXXXXXXXXXXX|||---|||XXXXX|||--||||||||||||||||||||||XX--XX||--|||||--|||XXXX--XXXX|||||||||||||||--|||||||||||||||||||||||||||||||||||||||||||||||||||||||||||
