HEIGHT=16;WIDTH=201;THEME=0;OVERRIDE=false
--------------------------------------------------------------------------------------------------------------------------------------------------------------------------------------------------------
--------------------------------------------------------------------------------------------------------------------------------------------------------------------------------------------------------
--------------------------------------------------------------------------------------------------------------------------------------------------------------------------------------------------------
--------------------------------------------------------------------------------------------------------------------------------------------------------------------------------------------------------
--------------------------------------------------------------------------------------------------------------------------------------------------------------------------------------------------------
--------------------------------------------------------------------------------------------------------------------------------------------------------------------------------------------------------
---------------------------------------------------------------------S2US-------------------------------------------------------------------------------------------------------------------------------
--------------------------------------------------------------------------------------------------------------------------------------------------------------------------------------------------------
--------------------------------------------------------------------------------------------------------------------------------------------------------------------------------------------------------
--------------SS2CS-------------------------------------------------y---g-------------------------------------------------------------------------------------------------------------------------------
----------------------%%%------------------------------------------%%%%%%-----------------------------------#--#----------------------------------------------------------------------------------------
----------------------|||------------------------------------------||||||-------S2SSSSS--------------------##--##---------------------------------------------------------------------------------------
----------------y-----||y-----------%%---%%---------%%%%%--%%%%%---||||||--------------------%%%%%--%%%%%%%%%--%%%%------------#--#---------------------------------------------------------------------
-----------%%%%%%%%%%%%%%%%%%%%%%%--||---||%%%---%%%|||||--|||||---||||||---------------%%%%%|||||--|||||||||--||||%%%%--%%%%%%%--%%%%%%%---%%%%--------------------------------------------------------
%%%%%%%%%%%|||||||||||||||||||||||%%||---|||||---||||||||--|||||%%%%%%%%%%%%%%-------y--||||||||||--|||||||||--||||||||--|||||||--|||||||---||||--------------------------------------------------------
||||||||||||||||||||||||||||||||||||||---|||||---||||||||--|||||||||||||||||||XXXXXXXXXX||||||||||--|||||||||--||||||||--|||||||--|||||||---||||XXXXXXXXFXXXXXXXXXXXXXXXXXXXXXXXXXXXXXXXXXXXXXXXXXXXXXXX
