HEIGHT=16;WIDTH=201;THEME=0;OVERRIDE=false
--------------------------------------------------------------------------------------------------------------------------------------------------------------------------------------------------------
--------------------------------------------------------------------------------------------------------------------------------------------------------------------------------------------------------
--------------------------------------------------------------------------------------------------------------------------------------------------------------------------------------------------------
--------------------------------------------------------------------------------------------------------------------------------------------------------------------------------------------------------
--------------------------------------------------------------------------------------------------------------------------------------------------------------------------------------------------------
--------------------------------------------------------------------------------------------------------------------------------------------------------------------------------------------------------
-----------------------y---r----------------------------------------------------------------------------------------------------------------------------------------------------------------------------
---------------------%%%%%%%----------------------------------------------------------------------------------------------------------------------------------------------------------------------------
---------------------|||||||-----------------------------------------------------------SCS-SSC-----%%%--------------------------------------------------------------------------------------------------
---------------------|||||||--------------------------------------------SS22-----------------------|||--------------------------------------------------------------------------------------------------
-------------------kkgr|||||--------------------------------------------------------------%--------||k--------------------------------------------------------------------------------------------------
-------------------%%%%|||||--------------------------------------------------------------|--------||%%%%%%%--------------------------------------------------------------------------------------------
-------------------|||||||||--------------#--#-----------------------------r-%%%%%%%%%%%%%%%%%%%%--|||||||||-------#--#---------------------------------------------------------------------------------
-------------------||||g||||------------%%%--%%%%%---%%%%%%%---%%%%%%%%%%%%%%||||||||||||||||||||--|||||||||-----%%%--%%%-------------------------------------------------------------------------------
------------------%%%%%%%%%%%%%%%%%%%%%%|||--|||||---|||||||---||||||||||||||||||||||||||||||||||--g|G|||y||-----|||--|||------------------%%%%%%%%F%%%%%%%%%%%%%%%%%%%%%%%%%%%%%%%%%%%%%%%%%%%%%%%%%%%%
XXXXXXXXXXXXX---XX|||||||||||||||||||||||||--|||||---|||||||---||||||||||||||||||||||||||||||||||XXXXXXXXXXXXXXXX|||--|||XXX--XXXXXXX--XXXX||||||||X||||||||||||||||||||||||||||||||||||||||||||||||||||
