HEIGHT=16;WIDTH=201;THEME=0;OVERRIDE=false
--------------------------------------------------------------------------------------------------------------------------------------------------------------------------------------------------------
--------------------------------------------------------------------------------------------------------------------------------------------------------------------------------------------------------
--------------------------------------------------------------------------------------------------------------------------------------------------------------------------------------------------------
--------------------------------------------------------------------------------------------------------------------------------------------------------------------------------------------------------
--------------------------------------------------------------------------------------------------------------------------------------------------------------------------------------------------------
--------------------------------------------------------------------------------------------------------------------------------------------------------------------------------------------------------
--------------------------------------------------------------------------------------------------------------------------------------------------------------------------------------------------------
--------------------------k------------------------------------------------------------------------------------------------------------SCS2-------------------------------------------------------------
--------------22S---------%%%--------------------------------------------------------------------------SCS----------------------------------------------------------------------------------------------
--------------------------|||---------------------------------------------%%%%%%%-----------------------------------------------------------------------------------------------------------------------
--------------------------|||-----------------k---------------------------|||||||-----------------------------------------#---#--------g----------------------------------------------------------------
-----------------y--------|||--------------%%%%---------------------------|||||||-----------------------r----------------##---##-----%%%%%%%------------------------------------------------------------
------------%%%%%%%%%%%%%%%%%%%%%----------||||--------%%%%---%%%%--------||gg|y|--g---------------%%%%%%%%%%----------%%%%---%%%%---|||||||----%%%%%%%%F%%%%%%%%%%%%%%%%%%%%%%%%%%%%%%%%%%%%%%%%%%%%%%%
------------|||||||||||||||||||||----------||||--------||||---||||-------%%%%%%%%%%%%%%%%%%---%%%%%||||||||||----------||||---||||%%%%%%%%%%%%%%||||||||%|||||||||||||||||||||||||||||||||||||||||||||||
%%%%%%%%%%%%|||||||||||||||||||||------r---||||--------||||---||||%%---%%||||||||||||||||||---|||||||||||||||%%%%------||||---||||||||||||||||||||||||||||||||||||||||||||||||||||||||||||||||||||||||||
|||||||||||||||||||||||||||||||||XXXXXXXXXXXXXXXXXX--XX||||---||||||---||||||||||||||||||||---|||||||||||||||||||XX--XX||||---||||||||||||||||||||||||||||||||||||||||||||||||||||||||||||||||||||||||||
