HEIGHT=16;WIDTH=201;THEME=0;OVERRIDE=false
--------------------------------------------------------------------------------------------------------------------------------------------------------------------------------------------------------
--------------------------------------------------------------------------------------------------------------------------------------------------------------------------------------------------------
--------------------------------------------------------------------------------------------------------------------------------------------------------------------------------------------------------
--------------------------------------------------------------------------------------------------------------------------------------------------------------------------------------------------------
--------------------------------------------------------------------------------------------------------------------------------------------------------------------------------------------------------
--------------------------------------------------------------------------------------------------------------------------------------------------------------------------------------------------------
--------------------------------------------------------------------------------------------------------------------------------------------------------------------------------------------------------
------------------------------------------------------rg------------------------------------------------------------------------------------------------------------------------------------------------
-----------------------------------------------------%%%%%%-------------------------------------------------CSSSSCU-------------------------------------------------------------------------------------
-----------------------------------------------------||||||------Tt-------------------------------------------------------------%%%%%%%-----------------------------------------------------------------
-----------------------------------------------------||||y|------tt----tt-------------------------------------------------------|||||||-----------------------------------------------------------------
--------------#--#---------------------------------%%%%%%%|------tt----tt-----------------------------------r-------------------|||||||-----------------------------------------------------------------
%%%%%%%%%%%--##--##------------#---#---------------||||||||----%%%%%%%%%%%%%%----------%%%%%---%%%%%---k--%%%%%%%%%%%%%%%%--%%%-|||||||-----------------------------------------------------------------
|||||||||||%%%%--%%%%%%--%%---##---##-----------%%-||||||||----||||||||||||||%%%--%%%--|||||---|||||%%%%%%||||||||||||||||--|||%%%%%%%%%%%--------------------------------------------------------------
|||||||||||||||--||||||--||--###---###--%%%--%%%||-||||||||----|||||||||||||||||--|||--|||||---|||||||||||||||||||||||||||--||||||||||||||%%%%%%%%F%%%%%%%%%%%%%%%%%%%%%%%%%%%%%%%%%%%%%%%%%%%%%%%%%%%%%
|||||||||||||||--||||||--||XXXXX---XXXXX|||--|||||XXXXXXXXXXXXX|||||||||||||||||--|||XX|||||---|||||||||||||||||||||||||||--||||||||||||||||||||||X|||||||||||||||||||||||||||||||||||||||||||||||||||||
