HEIGHT=16;WIDTH=201;THEME=0;OVERRIDE=false
--------------------------------------------------------------------------------------------------------------------------------------------------------------------------------------------------------
--------------------------------------------------------------------------------------------------------------------------------------------------------------------------------------------------------
--------------------------------------------------------------------------------------------------------------------------------------------------------------------------------------------------------
--------------------------------------------------------------------------------------------------------------------------------------------------------------------------------------------------------
--------------------------------------------------------------------------------------------------------------------------------------------------------------------------------------------------------
--------------------------------------------------------------------------------------------------------------------------------------------------------------------------------------------------------
--------------------------------------------------------------------------------------------------------------------------------------------------------------------------------------------------------
-------------------------------SSS----------------------------------------------------------------------------------------------------------------------------------------------------------------------
----------------------------------------------------------------k---------------------------------------------------------------------------------------------------------------------------------------
---------------------------------------------------------------%%%----------------------------------2SSCSS----------------------------------------------------------------------------------------------
------------------------------rr----g--------------------------|||--------------------------------------------------------------------------------------------------------------------------------------
------------------------------%%%%%%%------------------------kg|||--------------------------#---#-------------------------------------------------------------------------------------------------------
%%%%%%%%%%%%%-----------------|||||||----------------------%%%%%%%%%%%%%%%%--%%%%%%%--%%%%%%%---%%%---------------#---#---------------------------------------------------------------------------------
|||||||||||||---------%%---%%-|||||||------------%%--------||||||||||||||||--|||||||--|||||||---|||%%%%%%%%%%%---##---##------------------%%%%%%%%F%%%%%%%%%%%%%%%%%%%%%%%%%%%%%%%%%%%%%%%%%%%%%%%%%%%%%
|||||||||||||%%%---%%%||---||%%%%%%%%%%----------||--------||||||||||||||||--|||||||--|||||||---||||||||||||||--###---###-----------#--#--||||||||%|||||||||||||||||||||||||||||||||||||||||||||||||||||
||||||||||||||||---|||||---||||||||||||XXXX--XXXX||XXXXXXXX||||||||||||||||--|||||||--|||||||---||||||||||||||XXXXX---XXXXXXX---XXXXX--XXX||||||||||||||||||||||||||||||||||||||||||||||||||||||||||||||
