HEIGHT=16;WIDTH=201;THEME=0;OVERRIDE=false
--------------------------------------------------------------------------------------------------------------------------------------------------------------------------------------------------------
--------------------------------------------------------------------------------------------------------------------------------------------------------------------------------------------------------
--------------------------------------------------------------------------------------------------------------------------------------------------------------------------------------------------------
--------------------------------------------------------------------------------------------------------------------------------------------------------------------------------------------------------
---------------------------------------------------------------------------------------SSSS-------------------------------------------------------------------------------------------------------------
----------------------------------------------------------------------------------------------------------------y---------------------------------------------------------------------------------------
---------------------------------------------------------------------------------------------------------------%%%%-------------------------------------------------------------------------------------
----------------------------------CUSS-------------------------------------------------------------------------||||-------------------------------------------------------------------------------------
---------------------------------------------------------------22SSCS2-----yk----------%%%%--------------------||||---r------r--------------------------------------------------------------------------
---------------------------------------------------------------------------%%%%%%------||||--------------------||%%%%%%-----%%%-------------------------------------------------------------------------
-----------------------------------ky--------tt----------------------------||||||------||||-------k------------||||||||-----|||-------------------------------------------------------------------------
---------------------------------%%%%%%------tt----#---#--------r----------||k|||------||||--%%%%%%------------||||||||-----|||-------------------------------------------------------------------------
------------------------------K--||||||------tt---##---##--%%%%%%%%%%%%%%%%%%%%%%%%%--r||g|y-||||||k-%%%%%%%%--|||y||||-----|||----%%%%-----------------------------------------------------------------
-------------------------%%%%%%%%%%%%%%%%%%%%%%%%%%%---%%%%|||||||||||||||||||||||||%%%%%%%%%%%%%%%%%||||||||%%%%%%%%%%%%%--|||----||||-----------------------------------------------------------------
%%%%%%%%%%---------------|||||||||||||||||||||||||||---|||||||||||||||||||||||||||||||||||||||||||||||||||||||||||||||||||%%%%%%%%%%%%%%%%%%%%%%%%%F%%%%%%%%%%%%%%%%%%%%%%%%%%%%%%%%%%%%%%%%%%%%%%%%%%%%
||||||||||XX---XXXXX--XXX|||||||||||||||||||||||||||---||||||||||||||||||||||||||||||||||||||||||||||||||||||||||||||||||||||||||||||||||||||||||||X||||||||||||||||||||||||||||||||||||||||||||||||||||
