HEIGHT=16;WIDTH=201;THEME=0;OVERRIDE=false
--------------------------------------------------------------------------------------------------------------------------------------------------------------------------------------------------------
--------------------------------------------------------------------------------------------------------------------------------------------------------------------------------------------------------
--------------------------------------------------------------------------------------------------------------------------------------------------------------------------------------------------------
--------------------------------------------------------------------------------------------------------------------------------------------------------------------------------------------------------
--------------------------------------------------------------------------------------------------------------------------------------------------------------------------------------------------------
--------------------------------------------------------------------------------------------------------------------------------------------------------------------------------------------------------
--------------------------------------------------------------------------------------------------------------------------------------------------------------------------------------------------------
--------------------------------------------------------------------------------------------------------------------------------------------------------------------------------------------------------
--------------------------------------------------------------SS2---------------------------------------------------------------------------------------------------------------------------------------
----------------------------------------------------------------------#---#-------------------------------S2-S------------------------------------------------------------------------------------------
---------------------------------------------------------------------##---##----------------------------------------------------------------------------------------------------------------------------
------------------------#--#----------------------------------------###---###---%%%%%%%---------------------%-------------------------------------------------------------------------------------------
----------------------%%%--%%%-----------%%%%%--%%%%%%%%%%--%%%%%%%%%%%---%%%%%-|||||||---------------------|y--%%---%%------------#--#-----------------------------------------------------------------
----------------------|||--|||-----------|||||--||||||||||--|||||||||||---|||||-|||||||---------y-------%%%%%%%%||---||-----------##--##---%%%%%%%%F%%%%%%%%%%%%%%%%%%%%%%%%%%%%%%%%%%%%%%%%%%%%%%%%%%%%
%%%%%%%%%%%%%--#---#--|||--|||-----------|||||--||||||||||--|||||||||||---|||||-|r|r|||----%%%%%%%%%%%%%||||||||||---||----------###--###--||||||||%||||||||||||||||||||||||||||||||||||||||||||||||||||
|||||||||||||XXX---XXX|||--|||XXXX---XXXX|||||--||||||||||XX|||||||||||---|||||XXXXXXXXXXXX|||||||||||||||||||||||---||XXX--XXXXXXXX--XXXXX|||||||||||||||||||||||||||||||||||||||||||||||||||||||||||||
