HEIGHT=16;WIDTH=201;THEME=0;OVERRIDE=false
--------------------------------------------------------------------------------------------------------------------------------------------------------------------------------------------------------
--------------------------------------------------------------------------------------------------------------------------------------------------------------------------------------------------------
--------------------------------------------------------------------------------------------------------------------------------------------------------------------------------------------------------
--------------------------------------------------------------------------------------------------------------------------------------------------------------------------------------------------------
--------------------------------------------------------------------------------------------------------------------------------------------------------------------------------------------------------
--------------------------------------------------------------------------------------------------------------------------------------------------------------------------------------------------------
--------------------------------------------------------------------------------------------------------------------------------------------------------------------------------------------------------
-------------------------------------------G------------------------------------------------------------------------------------------------------------------------------------------------------------
-----------------------------------------%%%%%%---------------------------------------------------------------------------------------------------------------------------------------------------------
-----------------------------------------||||||------------------------------------------------------------------------------------------#--#-----------------------------------------------------------
-----------------------------------------||||k|-------------------------------------------SCCS------------------------------------------##--##----------------------------------------------------------
---------------------------------------%%%%%%%|----------------------------------------------------------------------------------------###--###---------------------------------------------------------
---------------------------------------||||||||---%%---%%----------%%---%%-----------------------------%%%%%------------%%---%%%%--%%%%%%%--%%%%%-------------------------------------------------------
--------------%%%%--%%%%---------------||||||||---||---||%%%%%%%%%%||---||------------------g----%%--%%|||||%%%%%--%%%%%||---||||--|||||||--|||||%%%%%%%%F%%%%%%%%%%%%%%%%%%%%%%%%%%%%%%%%%%%%%%%%%%%%%%
%%%%%%%%%%%%%%||||--||||%%---%%--------|Y||||||---||---||||||||||||||---||%%%%%---%%%%%%%%%%%%%%%||--||||||||||||--|||||||---||||--|||||||--|||||||||||||%||||||||||||||||||||||||||||||||||||||||||||||
||||||||||||||||||--||||||---||XX---XXXXXXXXXXXXXX||---||||||||||||||---|||||||---|||||||||||||||||--||||||||||||--|||||||---||||--|||||||--||||||||||||||||||||||||||||||||||||||||||||||||||||||||||||
