HEIGHT=16;WIDTH=201;THEME=0;OVERRIDE=false
--------------------------------------------------------------------------------------------------------------------------------------------------------------------------------------------------------
--------------------------------------------------------------------------------------------------------------------------------------------------------------------------------------------------------
--------------------------------------------------------------------------------------------------------------------------------------------------------------------------------------------------------
--------------------------------------------------------------------------------------------------------------------------------------------------------------------------------------------------------
--------------------------------------------------------------------------------------------------------------------------------------------------------------------------------------------------------
--------------------------------------------------------------------------------------------------------------------------------------------------------------------------------------------------------
--------------------------------------------------------------------------------------------------------------------------------------------------------------------------------------------------------
--------------------------------------------------------------------------------------------------------------------------------------------------------------------------------------------------------
------------------------------------%%%%%---------------------------------------------------------------------------------------------------------------------------------------------------------------
------------------------------------|||||-------------------------------------------------------------------------------------r-------------------------------------------------------------------------
------------------------------------|||||--------2CUSS----------SC2SS-----------------------------------S2UUSSS-------------%%%%%%----------------------------------------------------------------------
------------------------------------|||||-----------------------------------------------------------------------------------||||||----------------------------------------------------------------------
------------------------------%%%%%%%||||----------------%%--%%-----------------%%%%%---%%%%%-------------------------------||||||--g-------------------------------------------------------------------
--------------------%%%%%%%---|||||||||||----------------||--||---r--k----------|||||---|||||%%%%%%%%%%---y---g------------%%%%%%%%%%%%%%%%-------------------------------------------------------------
%%%%%%%%%%%%%%%%--%%|||||||---|||r|||||||-----%%%%%%%%%%%||--||%%%%%%%%%%-------|||||---|||||||||||||||%%%%%%%%%%%%%---%%%%||||||||||||||||-------------------------------------------------------------
||||||||||||||||--|||||||||XXXXXXXXXXXXXXXXXXX|||||||||||||--||||||||||||XX---XX|||||---||||||||||||||||||||||||||||---||||||||||||||||||||XXXXXXXXFXXXXXXXXXXXXXXXXXXXXXXXXXXXXXXXXXXXXXXXXXXXXXXXXXXXX
