HEIGHT=16;WIDTH=201;THEME=0;OVERRIDE=false
--------------------------------------------------------------------------------------------------------------------------------------------------------------------------------------------------------
--------------------------------------------------------------------------------------------------------------------------------------------------------------------------------------------------------
--------------------------------------------------------------------------------------------------------------------------------------------------------------------------------------------------------
--------------------------------------------------------------------------------------------------------------------------------------------------------------------------------------------------------
--------------------------------------------------------------------------------------------------------------------------------------------------------------------------------------------------------
--------------------------------------------------------------------------------------------------------------------------------------------------------------------------------------------------------
--------------------------------------------------------------------------------------------------------------------------------------------------------------------------------------------------------
--------------------------------------------------------------------------------------------------------------------------------------------------------------------------------------------------------
--------------------------------------------------------------------------------------------------------------------------------------------------------------------------------------------------------
--------------------------------------------------------------------------------------------------#--#--------------------------------------------------------------------------------------------------
------------------------------------------------SSC22--------------------------------------------##--##------#--#---------------------------------------------------------------------------------------
--------------------------------------#---#-----------------------------------------------------###--###----##--##-----------------SCS------------------------------------------------------------------
-------------------%%%%%%------------##---##---------------------------%%%%--%%%%-------------%%%%%--%%%%%%%%%--%%%%------------------------------------------------------------------------------------
-------------------||||||-----------###---###-------g-----#---#--------||||--||||%%%%%---%%%%%|||||--|||||||||--||||------------------------------------------------------------------------------------
%%%%%%%%%%%--#--#--||||||---------%%%%%---%%%%%%%%%%%%%%%%%---%%%%%--%%||||--|||||||||---||||||||||--|||||||||--||||%%%%---%%%%-------------------------------------------------------------------------
|||||||||||XXX--XXX||||||XXX---XXX|||||---|||||||||||||||||---|||||--||||||--|||||||||---||||||||||--|||||||||--||||||||---||||XXXXXXXXXXXXXXXXXFXXXXXXXXXXXXXXXXXXXXXXXXXXXXXXXXXXXXXXXXXXXXXXXXXXXXXXX
