HEIGHT=16;WIDTH=201;THEME=0;OVERRIDE=false
--------------------------------------------------------------------------------------------------------------------------------------------------------------------------------------------------------
--------------------------------------------------------------------------------------------------------------------------------------------------------------------------------------------------------
--------------------------------------------------------------------------------------------------------------------------------------------------------------------------------------------------------
--------------------------------------------------------------------------------------------------------------------------------------------------------------------------------------------------------
------------------------------------------------------------------------------------------------%%%%------------------SSC2------------------------------------------------------------------------------
------------------------------------------------------------------------------------------------||||----------------------------------------------------------------------------------------------------
------------------------------------------------------------------------------------------------||||----kkg---------------------------------------------------------------------------------------------
------------------------------------------------------------------------------------------------||||----%%%%----------r-k-------------------------------------------------------------------------------
------------------------------------------------------------------------------------------------||||----||||--------%%%%%%------------------------------------------------------------------------------
---------------------------------------------------------------------------------------------y--k|||----||||--------||||||------------------------------------------------------------------------------
-------------------------------------------#--#---------------------------------------------%%%%%%%|----||||--------||||g|-k----------------------------------------------------------------------------
--------------tt----------------#---#-----##--##---2SS22------------------------------------||||||||----||||--------|%%%%%%%----------------------------------------------------------------------------
--------------tt--%%%%---%%%%--##---##--%%%%--%%%%-----------------------------------------%%%%%%%%%%%%%%%%%%%------||||||||---%%%%--%%%%---------------------------------------------------------------
--------------tt--||||---||||%%%%---%%%%||||--||||------|------------------%%%%--%%%%%%--%%|||||||||||||||||||------||||||g|---||||--||||---------------------------------------------------------------
%%%%%%%%%%%%%%%%%%||||---||||||||---||||||||--||||------y---%%--%%---------||||--||||||--|||||||||||||||||||||-----%%%%%%%%%%%%||||--||||---------------------------------------------------------------
||||||||||||||||||||||---||||||||---||||||||--||||XXXXXXXXXX||--||XXX---XXX||||--||||||--|||||||||||||||||||||XXXXX||||||||||||||||--||||XXXXXXXXFXXXXXXXXXXXXXXXXXXXXXXXXXXXXXXXXXXXXXXXXXXXXXXXXXXXXXX
