HEIGHT=16;WIDTH=201;THEME=0;OVERRIDE=false
--------------------------------------------------------------------------------------------------------------------------------------------------------------------------------------------------------
--------------------------------------------------------------------------------------------------------------------------------------------------------------------------------------------------------
--------------------------------------------------------------------------------------------------------------------------------------------------------------------------------------------------------
--------------------------------------------------------------------------------------------------------------------------------------------------------------------------------------------------------
--------------------------------------------------------------------------------------------------------------------------------------------------------------------------------------------------------
--------------------------------------------------------------------------------------------------------------------------------------------------------------------------------------------------------
--------------------------------------------------------------------------------------------------------------------------------------------------------------------------------------------------------
--------------------------------------------------------------------------------------------------------------------------------------------------------------------------------------------------------
--------------------------------------------------------------------------------------------------------------------------------------------------------------------------------------------------------
-----------------------------------------------------------------------------------------------------------------------CSS-------------UCC--------------------------------------------------------------
--------------------------------------------------------------------------------------------------------Tt----Tt----------------------------------------------------------------------------------------
------------------------------------------------SCS-----------------------------------------------------tt-tt-tt----------------------------------------------------------------------------------------
------------%%----------------------------------------------%%%--%%%------%%%%--------------------------tt-tt-tt----k------------------g---y-%%%%%%%%F%%%%%%%%%%%%%%%%%%%%%%%%%%%%%%%%%%%%%%%%%%%%%%%%%%
------------||%%---%%-----------#--#--%%%---%%%----------tt-|||--|||------||||--------------#--#-----%%%%%%%%%%%%%%%%%%%%%%%%%%%%%%%%%%%%%%%%||||||||%||||||||||||||||||||||||||||||||||||||||||||||||||
------------||||---||---------%%%--%%%|||---|||--yg------tt-|||--|||%%--%%||||-----#---#--%%%--%%%---|||||||||||||||||||||||||||||||||||||||||||||||||||||||||||||||||||||||||||||||||||||||||||||||||||
XXXXXXXXXXXX||||---||XXX---XXX|||--||||||---|||XXXXXXXXXXXXX|||--|||||--||||||XXXXXX---XXX|||--|||XXX|||||||||||||||||||||||||||||||||||||||||||||||||||||||||||||||||||||||||||||||||||||||||||||||||||
