HEIGHT=16;WIDTH=201;THEME=0;OVERRIDE=false
--------------------------------------------------------------------------------------------------------------------------------------------------------------------------------------------------------
--------------------------------------------------------------------------------------------------------------------------------------------------------------------------------------------------------
--------------------------------------------------------------------------------------------------------------------------------------------------------------------------------------------------------
--------------------------------------------------------------------------------------------------------------------------------------------------------------------------------------------------------
--------------------------------------------------------------------------------------------------------------------------------------------------------------------------------------------------------
--------------------------------------------------------------------------------------------------------------------------------------------------------------------------------------------------------
--------------------------------------------------------------------------------------------------------------------------------------------------------------------------------------------------------
--------------------------------------------------------------------------------------------------------------------------------------------------------------------------------------------------------
--------------------------------------------------------------------------------------------------------------------------------------------------------------------------------------------------------
--------------------------------------------------------------------------------------------------------------------------------------------------------------------------------------------------------
-------------------------------------#---#-----------------------------------------------%%%%%--------------------------------tt------------------------------------------------------------------------
------------------------------------##---##-------------------------------#--#-----------|||||--------------------------Tt----tt------------------------------------------------------------------------
%%%%%%%%%%%%%-----------%%%%--%%%%%%%%---%%%%----------------------------##--##----------|||||--------------------------tt----tt------------------------------------------------------------------------
|||||||||||||-----------||||--||||||||---||||---#--#--------------------###--###--%%%%%%%%%%%%%%%%%%-------------------%%%%%%%%%%%%%%%--%%%-------------------------------------------------------------
|||||||||||||%%%%---%%%%||||--||||||||---||||--##--##--%%%---%%%%%%%%%%%%%%--%%%%%||||||||||||||||||----------%%%---%%%|||||||||||||||--|||-------------------------------------------------------------
|||||||||||||||||---||||||||--||||||||---||||XXXX--XXXX|||---||||||||||||||--|||||||||||||||||||||||XXXX--XXXX|||---||||||||||||||||||--|||XXXXXXXXFXXXXXXXXXXXXXXXXXXXXXXXXXXXXXXXXXXXXXXXXXXXXXXXXXXXX
