HEIGHT=16;WIDTH=201;THEME=0;OVERRIDE=false
--------------------------------------------------------------------------------------------------------------------------------------------------------------------------------------------------------
--------------------------------------------------------------------------------------------------------------------------------------------------------------------------------------------------------
--------------------------------------------------------------------------------------------------------------------------------------------------------------------------------------------------------
--------------------------------------------------------------------------------------------------------------------------------------------------------------------------------------------------------
--------------------------------------------------------------------------------------------------------------------------------------------------------------------------------------------------------
--------------------------------------------------------------------------------------------------------------------------------------------------------------------------------------------------------
--------------------------------------------------------------------------------------------------------------------------------------------------------------------------------------------------------
--------------------------------------------------------------------------------------------------------------------------------------------------------------------------------------------------------
--------------------------------------------------------------------------------------------------------------------------------------------------------------------------------------------------------
--------------------------------------------------------------------------------------------------------------------------------------------------------------------------------------------------------
-----------------------tt-------------------------------------------------SS2------------------------------%%%------------------------------------------------------------------------------------------
---------------#--#----tt---------------tt----tt------tt---------------------------------------------------|||-----------------------#---#--------------------------------------------------------------
%%%%%%%%%%%%%%%%--%%%%%%%%%%%-----------tt----tt------tt-Tt-tt--%%---%%------%-----------------------------|||---------------------%%%---%%%------------------------------------------------------------
||||||||||||||||--|||||||||||%%%%--%%%%%%%%%%%%%%%%---tt-tt-tt--||---||-k----|-----------------------------|r|--kg-----------------|||---|||------------------------------------------------------------
||||||||||||||||--|||||||||||||||--||||||||||||||||%%%%%%%%%%%%%||---||%%%%%%%%%%%%--%%-------------%%%%%%%%%%%%%%%%%%%%%%%%--%%%%%|||---|||------------------------------------------------------------
||||||||||||||||--|||||||||||||||--|||||||||||||||||||||||||||||||---||||||||||||||--||XXXXX---XXXXX||||||||||||||||||||||||--||||||||---|||XXXXXXXXFXXXXXXXXXXXXXXXXXXXXXXXXXXXXXXXXXXXXXXXXXXXXXXXXXXX
