HEIGHT=16;WIDTH=201;THEME=0;OVERRIDE=false
--------------------------------------------------------------------------------------------------------------------------------------------------------------------------------------------------------
--------------------------------------------------------------------------------------------------------------------------------------------------------------------------------------------------------
--------------------------------------------------------------------------------------------------------------------------------------------------------------------------------------------------------
--------------------------------------------------------------------------------------------------------------------------------------------------------------------------------------------------------
--------------------------------------------------------------------------------------------------------------------------------------------------------------------------------------------------------
--------------------------------------------------------------------------------------------------------------------------------------------------------------------------------------------------------
--------------------------------------------------------------------------------------------------------------------------------------------------------------------------------------------------------
--------------------------------------------------------------------------------------------------------------------------------------------------------------------------------------------------------
-------------------------CSS-------------------------------------------2SSS-----------------------------------------------------------------------------------------------------------------------------
--------------------------------------------------------------------------------------------------------------------------------------------------------------------------------------------------------
-----------------------------------------------------------------------------------------%%%%%----------------------------------------------------------------------------------------------------------
-----------------tt--------r----------------------------------------k-----------#--#-----|||||----------------------------------------#--#--------------------------------------------------------------
%%%%%%%%%%%%%----tt----%%%%%%%%%%---%%-------------%%%---%%%-------%%%%%%%%%%%%%%--%%%---|||||--------%%%%%%%%%%--%%%%%%%--%%--------##--##--%%%%%%%%F%%%%%%%%%%%%%%%%%%%%%%%%%%%%%%%%%%%%%%%%%%%%%%%%%%
|||||||||||||----tt----||||||||||---||%%%%%---%%%%%|||---|||-------||||||||||||||--|||---|||||--------||||||||||--|||||||--||%%--%%%%%%--%%%%||||||||%||||||||||||||||||||||||||||||||||||||||||||||||||
|||||||||||||%%%%%%%%%%||||||||||---|||||||---||||||||---|||%%---%%||||||||||||||--|||%%%%%%%%%%%%--%%||||||||||--|||||||--||||--||||||--|||||||||||||||||||||||||||||||||||||||||||||||||||||||||||||||
|||||||||||||||||||||||||||||||||---|||||||---||||||||---|||||---||||||||||||||||--|||||||||||||||--||||||||||||--|||||||--||||--||||||--|||||||||||||||||||||||||||||||||||||||||||||||||||||||||||||||
