HEIGHT=16;WIDTH=201;THEME=0;OVERRIDE=false
--------------------------------------------------------------------------------------------------------------------------------------------------------------------------------------------------------
--------------------------------------------------------------------------------------------------------------------------------------------------------------------------------------------------------
--------------------------------------------------------------------------------------------------------------------------------------------------------------------------------------------------------
--------------------------------------------------------------------------------------------------------------------------------------------------------------------------------------------------------
--------------------------------------------------------------------------------------------------------------------------------------------------------------------------------------------------------
--------------------------------------------------------------------------------------------------------------------------------------------------------------------------------------------------------
--------------------------------------------------------------------------------------------------------------------------------------------------------------------------------------------------------
----------------------------------------------------------------------------------------------------------%%%-------------------------------------------------------------------------------------------
----------------------------------------------------------------------------------------------------------|||-------------------------------------------------------------------------------------------
----------------------------------------------------------------------------------------------------------|||-------------------------------------------------------------------------------------------
----------------#---#-------------------------------------------------------------------------------------|%%%%-------tt--------------------------------------------------------------------------------
---------------##---##-------------------------------------------------------------%%%%%------------------|||||----tt-tt--------------------------------------------------------------------------------
--------------###---###--%%%%%--%%%%%%%%---------------------tt---------y--yy------|||||------------------|||||----tt-tt-----%%%%--%%%%-----------------------------------------------------------------
------------%%%%%---%%%%%|||||--||||||||------------%%--%%---tt--------%%%%%%%%%%%%%%%%%%%-------------%%%%%%%%%%%%%%%%%%%%%%||||--||||%%%%---%%%%------------------------------------------------------
------------|||||---||||||||||--||||||||%%%%%--%%%%%||--||%%%%%%%%---%%|||||||||||||||||||-----%%%--%%%||||||||||||||||||||||||||--||||||||---||||%%%%%%%%F%%%%%%%%%%%%%%%%%%%%%%%%%%%%%%%%%%%%%%%%%%%%%
XXXXXXXXXXXX|||||---||||||||||--|||||||||||||--|||||||--||||||||||---|||||||||||||||||||||XXXXX|||--|||||||||||||||||||||||||||||--||||||||---||||||||||||X|||||||||||||||||||||||||||||||||||||||||||||
