HEIGHT=16;WIDTH=201;THEME=0;OVERRIDE=false
--------------------------------------------------------------------------------------------------------------------------------------------------------------------------------------------------------
--------------------------------------------------------------------------------------------------------------------------------------------------------------------------------------------------------
--------------------------------------------------------------------------------------------------------------------------------------------------------------------------------------------------------
--------------------------------------------------------------------------------------------------------------------------------------------------------------------------------------------------------
-----------------------------------------------------------------------------------------------------------------------------------C2USS----------------------------------------------------------------
--------------------------------------------------------------------------------------------------------------------------------------------------------------------------------------------------------
--------------------------------------------------------------------------------------------------------------------------------------------------------------------------------------------------------
----------------------------------------------------------------------------------------------------------------------------------y---------------------------------------------------------------------
----------------------------------------------------------------------------------------------------------------------------------%%%%%%----------------------------------------------------------------
----------------------------------------------------------------------------------------------------------------------------------||g|||----------------------------------------------------------------
----------------------------------------------------------------------------------------------------------------------------------||%%%%%%%-------------------------------------------------------------
----------------------------------------------------------------------------------------------------------------------------------|||||||||-------------------------------------------------------------
-----------------------------------------------%%%%%%%%%%%-----------------------------------------------#---#--------------------|||||||||-------------------------------------------------------------
--------------------%%%%%%%%--%%%%-------------|||||||||||-----------------%%--%%--#--#---------%%---%%%%%---%%%------------------|||||||y|-------------------------------------------------------------
--------------%%--%%||||||||--||||-------------|||||||||||-----------------||--||%%%--%%%-------||---|||||---|||%%---%%%%--%%----%%%%%%%%%%%%-----------------------------------------------------------
XXXXXXXXXXXXXX||--||||||||||--||||XXXXX---XXXXX|||||||||||XX---XXXXXXXXXXXX||--|||||--|||XX---XX||---|||||---|||||---||||--||XXXX||||||||||||XXXXXXXXFXXXXXXXXXXXXXXXXXXXXXXXXXXXXXXXXXXXXXXXXXXXXXXXXXX
