HEIGHT=16;WIDTH=201;THEME=0;OVERRIDE=false
--------------------------------------------------------------------------------------------------------------------------------------------------------------------------------------------------------
--------------------------------------------------------------------------------------------------------------------------------------------------------------------------------------------------------
--------------------------------------------------------------------------------------------------------------------------------------------------------------------------------------------------------
--------------------------------------------------------------------------------------------------------------------------------------------------------------------------------------------------------
--------------------------------------------------------------------------------------------------------------------------------------------------------------------------------------------------------
--------------------------------------------------------------------------------------------------------------------------------------------------------------------------------------------------------
--------------------------------------------------------------------------------------------------------------------------------------------------------------------------------------------------------
--------------------------------------------------------------------------------------------------------------------------------------------------------------------------------------------------------
--------------------------------------------------------------------------------------------------------------------------------------------------------------------------------------------------------
--------------------------------------------------------------------------------------------------------------------------------------------------------------------------------------------------------
--------------------------------------------------------------------------------------------------------------------------------------------------------------------------------------------------------
---------------------------------SSSSCS22S----------------------------------------------------Tt--------------------------------------------------------------------------------------------------------
------------------------%%%--%%%--------------#--#----------------------------%%--%%----------tt--------------------------------------------------------------------------------------------------------
--------------%%%%--%%%%|||--|||-------------##--##--%%%%---------------------||--||----g-----tt----------%%--%%---#--#-------------------------%%%%%%%%F%%%%%%%%%%%%%%%%%%%%%%%%%%%%%%%%%%%%%%%%%%%%%%%
%%%%%%%%%%%%%%||||--|||||||--|||--r-Y------%%%%--%%%%||||---------------------||--||%%%%%%%%%%%%%%%%------||--||--##--##--%%%%---%%%%-----------||||||||%|||||||||||||||||||||||||||||||||||||||||||||||
||||||||||||||||||--|||||||--|||XXXXXXXXXXX||||--||||||||XXXX--XXXXXXXX---XXXX||--||||||||||||||||||XXXXXX||--||XXXX--XXXX||||---||||XXXX---XXXX||||||||||||||||||||||||||||||||||||||||||||||||||||||||
