HEIGHT=16;WIDTH=201;THEME=0;OVERRIDE=false
--------------------------------------------------------------------------------------------------------------------------------------------------------------------------------------------------------
--------------------------------------------------------------------------------------------------------------------------------------------------------------------------------------------------------
--------------------------------------------------------------------------------------------------------------------------------------------------------------------------------------------------------
--------------------------------------------------------------------------------------------------------------------------------------------------------------------------------------------------------
--------------------------------------------------------------------------------------------------------------------------------------------------------------------------------------------------------
--------------------------------------------------------------------------------------------------------------------------------------------------------------------------------------------------------
--------------------------------------------------------------------------------------------------------------------------------------------------------------------------------------------------------
------------------------------------------------------------------------------------%%%%%---------------------------------------------------------------------------------------------------------------
------------------------------------------------------------------------------------|||||---------------------------------------------------------------------------------------------------------------
------------------------------------------------------------------------------------|||||---------------------------------------------------------------------------------------------------------------
------------------------------------------------------------------------------------|||||--y------------------------------------------------------------------------------------------------------------
-----------------------SSS----------------------------------------------------------|||||--%%%-----------------%%%--------------------------------------------------------------------------------------
-----------------------------%%%---%%%----------%%%%---%%%%-------------------------|||||--|||-------tt--------|||---------y------Tt--tt----------------------------------------------------------------
-----------------------------|||---|||%%%%--%%%%||||---||||-------------------------|||||--|||-------tt-tt---%%%%%%%%%%%%%%%%%----tt--tt----------------------------------------------------------------
-----------%%%--%%%---g------|||---|||||||--||||||||---||||%%%%---%%%%----------%%%%%%%%%%%%%%%%%%%--tt-tt---|||||||||||||||||----tt--tt----------------------------------------------------------------
XXXXXXXXXXX|||--|||XXXXXXXXXX|||---|||||||--||||||||---||||||||---||||XXXX--XXXX|||||||||||||||||||XXXXXXXXXX|||||||||||||||||XXXXXXXXXXXXXXXXXXXFXXXXXXXXXXXXXXXXXXXXXXXXXXXXXXXXXXXXXXXXXXXXXXXXXXXXXX
