HEIGHT=16;WIDTH=201;THEME=0;OVERRIDE=false
--------------------------------------------------------------------------------------------------------------------------------------------------------------------------------------------------------
--------------------------------------------------------------------------------------------------------------------------------------------------------------------------------------------------------
--------------------------------------------------------------------------------------------------------------------------------------------------------------------------------------------------------
--------------------------------------------------------------------------------------------------------------------------------------------------------------------------------------------------------
-----------------------------%%%------------------------------------------------------------------------------------------------------------------------------------------------------------------------
-----------------------------|||------------------------------------------------------------------------------------------------------------------------------------------------------------------------
-----------------------------|||------------------------------------------------------------------------------------------------------------------------------------------------------------------------
-----------------------r-----|||------------------------------------------------------------------------------------------------------------------------------------------------------------------------
----------------------%%%%%--|||------------------------------------------------------------------------------------------------------------------------------------------------------------------------
----------------------|||||--|||------------------------tt------------------------------k--kr-----------------------------------------------------------------------------------------------------------
----------------------|||||--|||------------------------tt--Tt------------------------%%%%%%%------------SSSUCSS----------------------------------------------------------------------------------------
----------------------r||||--|||------------------------tt--tt------------------------|||||||-----------------------------------------------------------------------------------------------------------
--------------------%%%%%%%%%%%%%%-------------%%--%%%%%%%%%%%%-----------------------||||%%%%%%--%%--%%-----------------%%%%%--------------------------------------------------------------------------
%%%%%%%%%%%---------||||||||||||||-------------||--||||||||||||%%%%%---%%%%%----------||||||||||--||--||--r--------#--#--|||||--------------------------------------------------------------------------
|||||||||||%%%---%%%||||||||||||||%%%%%---%%%%%||--|||||||||||||||||---|||||%%%---%%%-|||Y|||g||--||--||%%%%%%%%%%%%--%%%|||||--#--#--%%%%--%%%%--------------------------------------------------------
||||||||||||||---||||||||||||||||||||||---|||||||--|||||||||||||||||---||||||||---|||XXXXXXXXXXXXX||--||||||||||||||--||||||||XXX--XXX||||--||||XXXXXXXXFXXXXXXXXXXXXXXXXXXXXXXXXXXXXXXXXXXXXXXXXXXXXXXX
