HEIGHT=16;WIDTH=201;THEME=0;OVERRIDE=false
--------------------------------------------------------------------------------------------------------------------------------------------------------------------------------------------------------
--------------------------------------------------------------------------------------------------------------------------------------------------------------------------------------------------------
--------------------------------------------------------------------------------------------------------------------------------------------------------------------------------------------------------
--------------------------------------------------------------------------------------------------------------------------------------------------------------------------------------------------------
--------------------------------------------------------------------------------------------------------------------------------------------------------------------------------------------------------
--------------------------------------------------------------------------------------------------------------------------------------------------------------------------------------------------------
--------------------------------------------------------------------------------------------------------------------------------------------------------------------------------------------------------
--------------------------------------------------------------------------------------------------------------------------------------------------------------------------------------------------------
--------------------------------------------------------------------------------------------------------------------------------------------------------------------------------------------------------
--------------------------------------------------------------------------------------------------------------------------------------------------------------------------------------------------------
--------------------------------------------------------------------------------------------------C2S2SS------------------------------------------------------------------------------------------------
------------------------------------------------------------------------------------------------------------------------------%%%%----------------------------------------------------------------------
-----------%%%%--%%%%%%%--%%%---#---#----------------------%%-------%%--%%-------------------------------%%%---%%%------------|||r----------------------------------------------------------------------
%%%%%%%%%%%||||--|||||||--|||--##---##---------------------||----K--||--||%%%%%--%%%%%%%%----------------|||---|||%%%--%%%%%%%%%%%%%%%%%%%%%%%%%%F%%%%%%%%%%%%%%%%%%%%%%%%%%%%%%%%%%%%%%%%%%%%%%%%%%%%%%
|||||||||||||||--|||||||--|||%%%%---%%%%-------------------||%%%%%%%||--|||||||--||||||||-----%%%%%%%%%%%|||---||||||--||||||||||||||||||||||||||%||||||||||||||||||||||||||||||||||||||||||||||||||||||
|||||||||||||||--|||||||--|||||||---||||XXXXXXXXXXXX---XXXX|||||||||||--|||||||--||||||||XXXXX||||||||||||||---||||||--|||||||||||||||||||||||||||||||||||||||||||||||||||||||||||||||||||||||||||||||||
