HEIGHT=16;WIDTH=201;THEME=0;OVERRIDE=false
--------------------------------------------------------------------------------------------------------------------------------------------------------------------------------------------------------
--------------------------------------------------------------------------------------------------------------------------------------------------------------------------------------------------------
--------------------------------------------------------------------------------------------------------------------------------------------------------------------------------------------------------
--------------------------------------------------------------------------------------------------------------------------------------------------------------------------------------------------------
--------------------------------------------------------------------------------------------------------------------------------------------------------------------------------------------------------
--------------------------------------------------------------------------------------------------------------------------------------------------------------------------------------------------------
--------------------------------------------------------------------------------------------------------------------------------------------------------------------------------------------------------
--------------------------------------------------------------------------------------------------------------------------------------------------------------------------------------------------------
-------------------------------------------------SSS-S---------------------SC2SS2SS---------------------------------------------------------------------------------------------------------------------
------------------------------------------------------------SSSU----------------------------------------------------------------------------------------------------------------------------------------
----------------------SSU2--------------------------%------------------------------------------Tt-------------------------------------tt---tt-----------------------------------------------------------
----------------------------------------------------|-------------------------r--y-------------tt--Tt-----US2SU-----------------------tt---tt-----------------------------------------------------------
%%%%%%%%%%%%%%--%%%-----------------#---#------%%%%%%%-------------------%%%%%%%%%%%-----------tt--tt------------%%%---%%%%%%%--%%%%--tt---tt-%%%%%%%%F%%%%%%%%%%%%%%%%%%%%%%%%%%%%%%%%%%%%%%%%%%%%%%%%%
||||||||||||||--|||---r-----------%%%---%%%----|||||||--%%%%%%%%%%%------|||||||||||%%%%%%%%%%%%%%%%%%---------%-|||---|||||||--||||%%%%%%%%%%||||||||%|||||||||||||||||||||||||||||||||||||||||||||||||
||||||||||||||--|||%%%%%%%%-------|||---|||----|||||||--|||||||||||%%--%%|||||||||||||||||||||||||||||---------|-|||---|||||||--||||||||||||||||||||||||||||||||||||||||||||||||||||||||||||||||||||||||
||||||||||||||--|||||||||||XX---XX|||---|||XXXXXXXXXXXXX|||||||||||||--|||||||||||||||||||||||||||||||XXXXXXXXXXX|||---|||||||--||||||||||||||||||||||||||||||||||||||||||||||||||||||||||||||||||||||||
