HEIGHT=16;WIDTH=201;THEME=0;OVERRIDE=false
--------------------------------------------------------------------------------------------------------------------------------------------------------------------------------------------------------
--------------------------------------------------------------------------------------------------------------------------------------------------------------------------------------------------------
--------------------------------------------------------------------------------------------------------------------------------------------------------------------------------------------------------
--------------------------------------------------------------------------------------------------------------------------------------------------------------------------------------------------------
--------------------------------------------------------------------------------------------------------------------------------------------------------------------------------------------------------
--------------------------------------------------------------------------------------------------------------------------------------------------------------------------------------------------------
--------------------------%%%---------------------------------------------------------------------------------------------------------------------------------------------------------------------------
--------------------------|||---------------------------------------------------------------------------------------------------------------------------------------------------------------------------
--------------------------|||---------------------------------------------------------------------------------------------------------------------------------------------------------------------------
--------------------------|||-------------------------------------------------------------------------------------------------CSSS----------------------------------------------------------------------
--------------------------|%%%%------------------------------------------#---#--------------------------------------------------------------------------------------------------------------------------
-------------2S2SCS-------|||||-----------------------------------------##---##------------------#---#--------------------------------------------------------------------------------------------------
--------------------------||||k--r---------%%%%%%---------------------%%%%---%%%%--------------%%%---%%%------------------------k-----------------------------------------------------------------------
--------------------%%%%%%%%%%%%%%%--------||||||%%%---%%%------------||||---||||--------------|||---|||-------%%%%%%%%%%--%%%%%%%%%%%%%---%%%%%%%%%%%F%%%%%%%%%%%%%%%%%%%%%%%%%%%%%%%%%%%%%%%%%%%%%%%%%
%%%%%%%%%%----------|||||||||||||||--------|||||||||---|||%%%%%--%%%%%||||---||||--------------|||---|||%%%%%%%||||||||||--|||||||||||||---|||||||||||%|||||||||||||||||||||||||||||||||||||||||||||||||
||||||||||XXXXXXXXXX|||||||||||||||XXX--XXX|||||||||---||||||||--|||||||||---||||XXX--XXXXX--XX|||---||||||||||||||||||||XX|||||||||||||---|||||||||||||||||||||||||||||||||||||||||||||||||||||||||||||
