HEIGHT=16;WIDTH=201;THEME=0;OVERRIDE=false
--------------------------------------------------------------------------------------------------------------------------------------------------------------------------------------------------------
--------------------------------------------------------------------------------------------------------------------------------------------------------------------------------------------------------
--------------------------------------------------------------------------------------------------------------------------------------------------------------------------------------------------------
--------------------------------------------------------------------------------------------------------------------------------------------------------------------------------------------------------
----------------------------------------------------------------------------------SSC-------------------------------------------------------------------------------------------------------------------
--------------------------------------------------------------------------------------------------------------------------------------------------------------------------------------------------------
--------------------------------------------------------------------------------------------------------------------------------------------------------------------------------------------------------
--------------------------------------------------------------------------------------------------------------------------------------------------------------------------------------------------------
---------------------------------------------------------------------------------%%%%%%%----------------------------------------------------------------------------------------------------------------
--------------tt-----------------------------------------------------------------|||||||----------------------------------------------------------------------------------------------------------------
--------------tt--Tt-------------------------------------------------------------|||||||----------------------------------------------------------------------------------------------------------------
--------------tt--tt-------------------------------------------------------------|||||||-------#---#----------------------------------------------------------------------------------------------------
----------%%%%%%%%%%%%%%-----------------%%%%--------%%%%%---%%%%%%%%%%---------%%%%%%%%%%%---##---##-----------%%%---%%%%%%%--%%%%---------------------------------------------------------------------
----------||||||||||||||%%%%%---%%%%%----||||%%%--%%%|||||---||||||||||%%%------|||||||||||--###---###----------|||---|||||||--||||---------------------------------------------------------------------
----------|||||||||||||||||||---|||||----|||||||--||||||||---|||||||||||||%%--%%|||||||||||%%%%%---%%%%%--#--#--|||---|||||||--||||%%%%---%%%%----------------------------------------------------------
XXXXXXXXXX|||||||||||||||||||---|||||XXXX|||||||--||||||||---|||||||||||||||--||||||||||||||||||---|||||XXX--XXX|||---|||||||--||||||||---||||XXXXXXXXFXXXXXXXXXXXXXXXXXXXXXXXXXXXXXXXXXXXXXXXXXXXXXXXXX
