HEIGHT=16;WIDTH=201;THEME=0;OVERRIDE=false
--------------------------------------------------------------------------------------------------------------------------------------------------------------------------------------------------------
--------------------------------------------------------------------------------------------------------------------------------------------------------------------------------------------------------
--------------------------------------------------------------------------------------------------------------------------------------------------------------------------------------------------------
--------------------------------------------------------------------------------------------------------------------------------------------------------------------------------------------------------
--------------------------------------------------------------------------------------------------------------------------------------------------------------------------------------------------------
--------------------------------------------------------------------------------------------------------------------------------------------------------------------------------------------------------
--------------------------------------------------------------------------------------------------------------------------------------------------------------------------------------------------------
--------------------------------------------------------------------------------------------------------------------------------------------------------------------------------------------------------
--------------------------------------------------------------------------------------------------------------------------------------------------------------------------------------------------------
----------------------------------------------------------------------------------------------------------------------------------------2S-S------------------------------------------------------------
-----------------------------------------------------%%%%-----------------------------------------------------------------------------------------------------------------------------------------------
-----------------------------------------------------||||---------------------------------------------------------------------------------%-------------------------------------------------------------
-----------------g-----------------------------------k|||------------------------------------#---#--------------------------------------r-|-------------------------------------------------------------
-------------%%%%%%%%-------%%%%%%----Tt-%%---%%%%%%%%%%%%%-------------%%%%%--%%%%%-------%%%---%%%--r-----------------------%%%%%%%%%%%%%%%%%%%%%%%F%%%%%%%%%%%%%%%%%%%%%%%%%%%%%%%%%%%%%%%%%%%%%%%%%%
%%%%%%%%%%%%%||||||||-------||||||----tt-||---|||||||||||||%%%%%---%%%%%|||||--|||||-------|||---|||%%%%%%%%%%%---%%%%%%%---%%|||||||||||||||||||||||%||||||||||||||||||||||||||||||||||||||||||||||||||
|||||||||||||||||||||XXXXXXX||||||XXXXXXX||---||||||||||||||||||---||||||||||--|||||XX---XX|||---||||||||||||||---|||||||---||||||||||||||||||||||||||||||||||||||||||||||||||||||||||||||||||||||||||||
