HEIGHT=16;WIDTH=201;THEME=0;OVERRIDE=false
--------------------------------------------------------------------------------------------------------------------------------------------------------------------------------------------------------
--------------------------------------------------------------------------------------------------------------------------------------------------------------------------------------------------------
--------------------------------------------------------------------------------------------------------------------------------------------------------------------------------------------------------
--------------------------------------------------------------------------------------------------------------------------------------------------------------------------------------------------------
--------------------------------------------------------------------------------------------------------------------------------------------------------------------------------------------------------
--------------------------------------------------------------------------------------------------------------------------------------------------------------------------------------------------------
--------------------------------------------------------------------------------------------------------------------------------------------------------------------------------------------------------
--------------------------------------------------------------------------------------------------------------------------------------------------------------------------------------------------------
------------------------------------------------------------------------------------------------------------------------------------------SUS2----------------------------------------------------------
--------------------------------------------------------------------------------------------------------------------------------------------------------------------------------------------------------
-------------#---#-------#--#-------------------------------------------------------------------------------2SS---------%%%--------------%--------------------------------------------------------------
------------##---##-----##--##------------------------------------------------------------------------------------------|||--------------|--------------------------------------------------------------
----------%%%%---%%%%--###--###---------------------%%---%%%%%%%%%%%%%----%%%---%%%--------------#--#-------------------|||--%%%---%%%%%%%%%%%%---------------------------------------------------------
----------||||---||||%%%%%--%%%%%-------------#--#--||---|||||||||||||%%%%|||---|||%%%%---%%%%--##--##----y-------------|||--|||---||||||||||||---------------------------------------------------------
----------||||---|||||||||--|||||-----------%%%--%%%||---||||||||||||||||||||---|||||||---||||%%%%--%%%%%%%%%%%%%%%%%%%%%%%%%|||---||||||||||||%%%%%%%%F%%%%%%%%%%%%%%%%%%%%%%%%%%%%%%%%%%%%%%%%%%%%%%%%
XXXXXXXXXX||||---|||||||||--|||||XXXX---XXXX|||--|||||---||||||||||||||||||||---|||||||---||||||||--||||||||||||||||||||||||||||---||||||||||||||||||||X||||||||||||||||||||||||||||||||||||||||||||||||
