HEIGHT=16;WIDTH=201;THEME=0;OVERRIDE=false
--------------------------------------------------------------------------------------------------------------------------------------------------------------------------------------------------------
--------------------------------------------------------------------------------------------------------------------------------------------------------------------------------------------------------
--------------------------------------------------------------------------------------------------------------------------------------------------------------------------------------------------------
--------------------------------------------------------------------------------------------------------------------------------------------------------------------------------------------------------
--------------------------------------------------------------------------------------------------------------------------------------------------------------------------------------------------------
--------------------------------------------------------------------------------------------------------------------------------------------------------------------------------------------------------
--------------------------------------------------------------------------------------------------------------------------------------------------------------------------------------------------------
--------------------------------------------------------------------------------------------------------------------------------------------------------------------------------------------------------
----------------------------------------------------------------------------------------------USSS------------------------------------------------------------------------------------------------------
--------------------------------------------------------------------------------------------------------------------------------------------------------------------------------------------------------
-------------------------------------------------%%%%%%-----------------------------------------------------------#--#----------------------------------------------------------------------------------
-------------------------------------------------||||||--------------------------------------y-r-------#--#------##--##-----------------k---------------------------------------------------------------
-------------------------------------------------||||||------------------------------------%%%%%%%%---##--##---%%%%--%%%%-----------%%%%%%%%------------------------------------------------------------
--------------%%%%-------------------------------|g||||y-%%%%%%%%%---%%%%%%%%%-------------||||||||--###--###--||||--||||---#---#---||||||||------------------------------------------------------------
--------------||||--------------#---#---------%%%%%%%%%%%|||||||||---|||||||||%%---%%------||||||||%%%%%--%%%%%||||--||||--##---##--||||||||------------------------------------------------------------
XXXXXXXXXXXXXX||||XXXXX--XXXXXXXX---XXXXXXXXXX||||||||||||||||||||---|||||||||||---||XXXXXX|||||||||||||--|||||||||--||||XXXX---XXXX||||||||XXXXXXXXFXXXXXXXXXXXXXXXXXXXXXXXXXXXXXXXXXXXXXXXXXXXXXXXXXXX
