HEIGHT=16;WIDTH=201;THEME=0;OVERRIDE=false
--------------------------------------------------------------------------------------------------------------------------------------------------------------------------------------------------------
--------------------------------------------------------------------------------------------------------------------------------------------------------------------------------------------------------
--------------------------------------------------------------------------------------------------------------------------------------------------------------------------------------------------------
--------------------------------------------------------------------------------------------------------------------------------------------------------------------------------------------------------
--------------------------------------------------------------------------------------------------------------------------------------------------------------------------------------------------------
--------------------------------------------------------------------------------------------------------------------------------------------------------------------------------------------------------
--------------------------------------------------------------------------------------------------------------------------------------------------------------------------------------------------------
--------------------------------------------------------------------------------------------------------------------------------------------------------------------------------------------------------
--------------------------------------------------------------------------------------------------------------------------------------------------------------------------------------------------------
---------------------------------------------------------------------------------------#--#-------------------------------------------------------------------------------------------------------------
----------------------------------------------------------#--#------------------------##--##------------------------------------------------------------------------------------------------------------
--------------------S2S----------------------------------##--##----------------------###--###-------------------------------------#---#-----------------------------------------------------------------
------------%%--%%--------------------------------------###--###-------------------%%%%%--%%%%%------------%%%%%%%%%%%%%%--%%%---##---##----------------------------------------------------------------
%%%%%%%%%%%%||--||----------------------------------r-%%%%%--%%%%%----------%%---%%|||||--|||||------%%--%%||||||||||||||--|||--###---###---------------------------------------------------------------
||||||||||||||--||---k------------------%%---%%%%%%%%%|||||--|||||%%%%--%%%%||---|||||||--|||||--k---||--||||||||||||||||--|||%%%%%---%%%%%%%%%%%%%F%%%%%%%%%%%%%%%%%%%%%%%%%%%%%%%%%%%%%%%%%%%%%%%%%%%%
||||||||||||||--||XXXXXXXXXXXXXX---XXXXX||---||||||||||||||--|||||||||--||||||---|||||||--|||||XXXXXX||--||||||||||||||||--||||||||---|||||||||||||X||||||||||||||||||||||||||||||||||||||||||||||||||||
