HEIGHT=16;WIDTH=201;THEME=0;OVERRIDE=false
--------------------------------------------------------------------------------------------------------------------------------------------------------------------------------------------------------
--------------------------------------------------------------------------------------------------------------------------------------------------------------------------------------------------------
--------------------------------------------------------------------------------------------------------------------------------------------------------------------------------------------------------
--------------------------------------------------------------------------------------------------------------------------------------------------------------------------------------------------------
--------------------------------------------------------------------------------------------------------------------------------------------------------------------------------------------------------
--------------------------------------------------------------------------------------------------------------------------------------------------------------------------------------------------------
--------------------------------------------------------------------------------------------------------------------------------------------------------------------------------------------------------
--------------------------------------------------------------------------------------------------------------------------------------------------------------------------------------------------------
--------------------------------------------------------------------------------------------------------------------------------------y-y---------------------------------------------------------------
--------------------------------------------------------------------------------------------------#--#-------SSC2C--------SSUSSU------%%%%%%------------------------------------------------------------
-------------------------#---#----------------------------------------------Tt-------------------##--##-------------------------------||||||------------------------------------------------------------
------------------------##---##---------------------------------------------tt------------------###--###------------------------------||||||------------------------------------------------------------
-----------------------###---###--%%%%%---%%%%%--------%%%%%---%%%%%-------%%%%%%%%-----------%%%%%--%%%%%-----------%%%%-------------||||||-----%%%%%%%%F%%%%%%%%%%%%%%%%%%%%%%%%%%%%%%%%%%%%%%%%%%%%%%
%%%%%%%%%%%%%%-------%%%%%---%%%%%|||||---|||||--------|||||---|||||-------||||||||---#---#---|||||--|||||%%%%%%%%%%%||||%%%%%%%%%---%%%%%%%%%%%%||||||||%||||||||||||||||||||||||||||||||||||||||||||||
||||||||||||||-------|||||---||||||||||---|||||--#--#--|||||---|||||%%%%%%%||||||||--##---##--|||||--|||||||||||||||||||||||||||||---|||||||||||||||||||||||||||||||||||||||||||||||||||||||||||||||||||
||||||||||||||XX---XX|||||---||||||||||---|||||XXX--XXX|||||---||||||||||||||||||||XXXX---XXXX|||||--|||||||||||||||||||||||||||||XXX|||||||||||||||||||||||||||||||||||||||||||||||||||||||||||||||||||
