HEIGHT=16;WIDTH=201;THEME=0;OVERRIDE=false
--------------------------------------------------------------------------------------------------------------------------------------------------------------------------------------------------------
--------------------------------------------------------------------------------------------------------------------------------------------------------------------------------------------------------
--------------------------------------------------------------------------------------------------------------------------------------------------------------------------------------------------------
--------------------------------------------------------------------------------------------------------------------------------------------------------------------------------------------------------
--------------------------------------------------------------------------------------------------------------------------------------------------------------------------------------------------------
--------------------------------------------------------------------------------------------------------------------------------------------------------------------------------------------------------
--------------------------------------------------------------------------------------------------------------------------------------------------------------------------------------------------------
--------------------------------------------------------------------------------------------------------------------------------------------------------------------------------------------------------
------------------UC2S----------------------------------------------------------------------------------------------------------------------------------------------------------------------------------
--------------------------------------------------------------------------------------------------------------------------------------------------------------------------------------------------------
--------------------------------------------------------------------------------------------------------------------------------------------------------------------------------------------------------
--------------------y-------#---#-----------------------------------------------------------------------------------------------------------------------------------------------------------------------
--------------%%%%%%%%%%---##---##---------------------------%%--%%--------------------------------------------k--------------------#---#---------------------------------------------------------------
--------------||||||||||--###---###-------------%%%%%---%%%%%||--||---#--#------------------------%%%%--%%%%%%%%%%%%%%%------------##---##---%%%%%%%%F%%%%%%%%%%%%%%%%%%%%%%%%%%%%%%%%%%%%%%%%%%%%%%%%%%
%%%%%%%%%%%%%%||||||||||%%%%%---%%%%%%%%%---%%%%|||||---|||||||--||--##--##-----------------------||||--|||||||||||||||-----------###---###--||||||||%||||||||||||||||||||||||||||||||||||||||||||||||||
|||||||||||||||||||||||||||||---|||||||||---|||||||||---|||||||--||XXXX--XXXXXXX--XXXXXXXX---XXXXX||||--|||||||||||||||XXX---XXXXXXXX---XXXXX|||||||||||||||||||||||||||||||||||||||||||||||||||||||||||
