HEIGHT=16;WIDTH=201;THEME=0;OVERRIDE=false
--------------------------------------------------------------------------------------------------------------------------------------------------------------------------------------------------------
--------------------------------------------------------------------------------------------------------------------------------------------------------------------------------------------------------
--------------------------------------------------------------------------------------------------------------------------------------------------------------------------------------------------------
--------------------------------------------------------------------------------------------------------------------------------------------------------------------------------------------------------
--------------------------------------------------------------------------------------------------------------------------------------------------------------------------------------------------------
--------------------------------------------------------------------------------------------------------------------------------------------------------------------------------------------------------
------------------------------------------------------------------------------%%%%%%--------------------------------------------------------------------------------------------------------------------
------------------------------------------------------------------------------||||||--------------------------------------------------------------------------------------------------------------------
------------------------------------------------------------------------------||||||----------------------------------------2SSCSS----------------------------------------------------------------------
-----------------------------------------------S2C----------------------------||||||--------------------------------------------------------------------------------------------------------------------
----------------#--#----------------------------------------------------------|||||%%%%%%%--------------------------------------------------------------------------------------------------------------
---------------##--##-----#---#-----------------------------------------------||||||||||||--------------------------------------------------------------------------------------------------------------
-------------%%%%--%%%%--##---##--%%%%%%%%%%---r-Y------------%%---%%%%---%%--||||||||%%%%%%%-----------%%%%%--%%%%%------%%%%%%%%%%--------------------------------------------------------------------
-------------||||--||||%%%%---%%%%||||||||||%%%%%%%%%%--------||---||||---||--||||||||k||||||-----------|||||--|||||------||||||||||------%%%%%%%%F%%%%%%%%%%%%%%%%%%%%%%%%%%%%%%%%%%%%%%%%%%%%%%%%%%%%%
%%%%%%%%%%%%%||||--||||||||---||||||||||||||||||||||||--------||---||||---||%%%%%%%%%%%%%%%%%%%%%%---%%%|||||--|||||%%%%%%||||||||||------||||||||%|||||||||||||||||||||||||||||||||||||||||||||||||||||
|||||||||||||||||--||||||||---||||||||||||||||||||||||XXXXXXXX||---||||---||||||||||||||||||||||||---||||||||--|||||||||||||||||||||XX--XX||||||||||||||||||||||||||||||||||||||||||||||||||||||||||||||
