HEIGHT=16;WIDTH=201;THEME=0;OVERRIDE=false
--------------------------------------------------------------------------------------------------------------------------------------------------------------------------------------------------------
--------------------------------------------------------------------------------------------------------------------------------------------------------------------------------------------------------
--------------------------------------------------------------------------------------------------------------------------------------------------------------------------------------------------------
--------------------------------------------------------------------------------------------------------------------------------------------------------------------------------------------------------
--------------------------------------------------------------------------------------------------------------------------------------------------------------------------------------------------------
--------------------------------------------------------------------------------------------------------------------------------------------------------------------------------------------------------
--------------------------------------------------------------------------------------------------------------------------------------------------------------------------------------------------------
--------------------------------------------------------------------------------------------------------------------------------------------------------------------------------------------------------
---------------------------------------------------------------------------------S2CS-------------------------------------------------------------------------------------------------------------------
--------------------------------------------------------------------------------------------G-----------%%%%%%------------------------------------------------------------------------------------------
------------------------------------------------------------------------2SS--------------%%%%%----------||||||------------------------------------------------------------------------------------------
---------------------------------%%%%----------------------------------------------------|||||-------gk-|k||||--------S2-S------------------------------------------------------------------------------
------------------#--#-----------||||-----------------------------------------%%%%%%%%%%-|||||----%%%%%%%%%%%%%%%%------------------%%%%%---------------------------------------------------------------
----------------%%%--%%%---------||||--------#--#-----------------------------||||||||||%%%%%%%%%%||||||||||||||||------%-----#--#--|||||---------------------------------------------------------------
----------%%--%%|||--|||%%%%%%%-y||||------%%%--%%%%%%---%%%%%%%%%%%%%%%%%%%%%||||||||||||||||||||||||||||||||||||-----y|y--%%%--%%%|||||---------------------------------------------------------------
XXXXXXXXXX||--|||||--||||||||||XXXXXXXXXXXX|||--||||||---|||||||||||||||||||||||||||||||||||||||||||||||||||||||||XXXXXXXXXX|||--||||||||XXXXXXXXFXXXXXXXXXXXXXXXXXXXXXXXXXXXXXXXXXXXXXXXXXXXXXXXXXXXXXX
