HEIGHT=16;WIDTH=201;THEME=0;OVERRIDE=false
--------------------------------------------------------------------------------------------------------------------------------------------------------------------------------------------------------
--------------------------------------------------------------------------------------------------------------------------------------------------------------------------------------------------------
--------------------------------------------------------------------------------------------------------------------------------------------------------------------------------------------------------
--------------------------------------------------------------------------------------------------------------------------------------------------------------------------------------------------------
--------------------------------------------------------------------------------------------------------------------------------------------------------------------------------------------------------
--------------------------------------------------------------------------------------------------------------------------------------------------------------------------------------------------------
--------------------------------------------------------------------------------------------------------------------------------------------------------------------------------------------------------
--------------------------------------------------------------------------------------------------------------------------------------------------------------------------------------------------------
------------------------------------------------------SCCS----------------------------------------------------------------------------------------------------------------------------------------------
--------------------------------------------------------------------------------------------------------------------------------------------------------------------------------------------------------
---------------------------------------------------------------------------------------------------------------------tt-----------------k---------------------------------------------------------------
-----------------------------------------------------------k---------------------------------------------------------tt-----------------%%%%%-----------------------------------------------------------
-------------------------#--#-------------%%%--%%%%%%%%%%%%%%-------------------------Tt-----%%%--%%%----------------tt----%%--%%-k-----r||r|-----------------------------------------------------------
%%%%%%%%%%%%%----------%%%--%%%-----------|||--||||||||||||||------------#--#---tt----tt--Tt-|||--|||%%%%%--%%%%%%%%%%%%%%%||--||%%%%%%%%%%%%%%%%%%%%%%%%%%F%%%%%%%%%%%%%%%%%%%%%%%%%%%%%%%%%%%%%%%%%%%%
|||||||||||||----------|||--|||%%%%%%%%%%%|||--||||||||||||||%%%%--%%%%%%%--%%%-tt----tt--tt-|||--||||||||--|||||||||||||||||--||||||||||||||||||||||||||||%||||||||||||||||||||||||||||||||||||||||||||
|||||||||||||XXXX--XXXX|||--|||||||||||||||||--||||||||||||||||||--|||||||--|||XXXXXXXXXXXXXX|||--||||||||--|||||||||||||||||--|||||||||||||||||||||||||||||||||||||||||||||||||||||||||||||||||||||||||
