HEIGHT=16;WIDTH=201;THEME=0;OVERRIDE=false
--------------------------------------------------------------------------------------------------------------------------------------------------------------------------------------------------------
--------------------------------------------------------------------------------------------------------------------------------------------------------------------------------------------------------
--------------------------------------------------------------------------------------------------------------------------------------------------------------------------------------------------------
--------------------------------------------------------------------------------------------------------------------------------------------------------------------------------------------------------
--------------------------------------------------------------------------------------------------------------------------------------------------------------------------------------------------------
--------------------------------------------------------------------------------------------------------------------------------------------------------------------------------------------------------
--------------------------------------------------------------------------------------------------------------------------------------------------------------------------------------------------------
--------------------------------------------------------------------------------------------------------------------------------------------------------------------------------------------------------
--------------------------------------------------------------------------------------------------------------------------------------------------------------------------------------------------------
-------------------------------------------------------------------------------------------------------r-------------------------------g----------------------------------------------------------------
-----------------------------------------------------------------------------------------------------%%%%------------------------%%%%%%%----------------------------------------------------------------
-----------------------------------------------------------------------------------------------------||||---SSSSSCS2-------------||r||||----------------------------------------------------------------
%%%%%%%%%%%---------------------------------%%%%%---%%%%%%%%%%---%%%%%-------------------------------||||---------------------%%%%%%%%%%%%%%%%%%%%%F%%%%%%%%%%%%%%%%%%%%%%%%%%%%%%%%%%%%%%%%%%%%%%%%%%%%
|||||||||||%%%%--%%%%-----------------------|||||---||||||||||---|||||-------------%%%---%%%--------k||||k-----------%%%%%%%%%|||||||||||||||||||||%||||||||||||||||||||||||||||||||||||||||||||||||||||
|||||||||||||||--||||%%%---%%%%%--%%%%%--%%%|||||---||||||||||---|||||----%%%---%%%|||---|||%%%%%%%%%%%%%%%----------|||||||||||||||||||||||||||||||||||||||||||||||||||||||||||||||||||||||||||||||||||
|||||||||||||||--|||||||---|||||--|||||--||||||||---||||||||||---|||||XXXX|||---||||||---||||||||||||||||||XXXXXXXXXX|||||||||||||||||||||||||||||||||||||||||||||||||||||||||||||||||||||||||||||||||||
