HEIGHT=16;WIDTH=201;THEME=0;OVERRIDE=false
--------------------------------------------------------------------------------------------------------------------------------------------------------------------------------------------------------
--------------------------------------------------------------------------------------------------------------------------------------------------------------------------------------------------------
--------------------------------------------------------------------------------------------------------------------------------------------------------------------------------------------------------
--------------------------------------------------------------------------------------------------------------------------------------------------------------------------------------------------------
--------------------------------------------------------------------------------------------------------------------------------------------------------------------------------------------------------
--------------------------------------------------------------------------------------------------------------------------------------------------------------------------------------------------------
--------------------------------------------------------------------------------------------------------------------------------------------------------------------------------------------------------
--------------------------------------------------------------------------------------------------------------------------------------------------------------------------------------------------------
--------------------------------------------------------------------------------------------------------------------------------------------------------------------------------------------------------
----------------------------------------------kk---------------------------------------------------------------#---#------------------------------------------------------------------------------------
--------------------------------------------%%%%%------------------------------g--k---------------------------##---##-----------------------------------------------------------------------------------
------------------------------k-------------|||||-----------------------------%%%%%--------------------------###---###-------------------#---#----------------------------------------------------------
----------------------------%%%%------------|||||-----------------------------|||||----------------------%%%%%%%---%%%%%------%%---%%---##---##---------------------------------------------------------
---------------------------g|g||----------%%%%%||-----------------------------|||||---%%%--%%%%%%%---%%%%|||||||---|||||%%--%%||---||--###---###--------------------------------------------------------
-----------------------%%%%%%%%%%%%%--%%-r|||g|||y--------%%%%%--%%%%%--------||r||---|||--|||||||---|||||||||||---|||||||--||||---||%%%%%---%%%%%%%%%%%%%F%%%%%%%%%%%%%%%%%%%%%%%%%%%%%%%%%%%%%%%%%%%%%
XXXXXXXXXXXXXXXXXXXXXXX|||||||||||||--||XXXXXXXXXXXXXXXXXX|||||--|||||XXXXXXXXXXXXXXXX|||--|||||||---|||||||||||---|||||||--||||---|||||||---|||||||||||||X|||||||||||||||||||||||||||||||||||||||||||||
