HEIGHT=16;WIDTH=201;THEME=0;OVERRIDE=false
--------------------------------------------------------------------------------------------------------------------------------------------------------------------------------------------------------
--------------------------------------------------------------------------------------------------------------------------------------------------------------------------------------------------------
--------------------------------------------------------------------------------------------------------------------------------------------------------------------------------------------------------
--------------------------------------------------------------------------------------------------------------------------------------------------------------------------------------------------------
--------------------------------------------------------------------------------------------------------------------------------------------------------------------------------------------------------
--------------------------------------------------------------------------------------------------------------------------------------------------------------------------------------------------------
--------------------------------------------------------------------------------------------------------------------------------------------------------------------------------------------------------
--------------------------------------------------------------------------------------------------------------------------------------------------------------------------------------------------------
----------------------------------------------------------------------------k-y-------------------------------------------------------------------------------------------------------------------------
---------------------------------------------#---#-----2SCC-------------%%%%%%%-------------------------------------------------------------------------------------------------------------------------
--------------------------------------------##---##---------------------|||||||y------------------------------------------------------------------------------------------------------------------------
-------------------------------------------###---###--------------------|||||%%%%-----------------------------------------------------------------------------------------------------------------------
-----------------------------------------%%%%%---%%%%%------------------|||||||||-----------------------------------------------------------------------------------------------------------------------
-------------%%%%%---%%%%%---------------|||||---|||||-%%%%%%%-------%%-|||||||||-----------------------%%%---%%%---------------------------------------------------------------------------------------
%%%%%%%%%%%%%|||||---|||||%%--%%%%%---%%%|||||---|||||-||||r|r---K---||-||k||||||---%%%%%%%%%-----------|||---|||-------------%%---%%%%---%%------------------------------------------------------------
||||||||||||||||||---|||||||--|||||---||||||||---|||||XXXXXXXXXXXXXXX||XXXXXXXXXXXXX|||||||||XXXX---XXXX|||---|||XXXXX---XXXXX||---||||---||XXXXXXXXFXXXXXXXXXXXXXXXXXXXXXXXXXXXXXXXXXXXXXXXXXXXXXXXXXXX
