HEIGHT=16;WIDTH=201;THEME=0;OVERRIDE=false
--------------------------------------------------------------------------------------------------------------------------------------------------------------------------------------------------------
------------------------------------------------------------------------------------------------------------------------------------------y-------------------------------------------------------------
------------------------------------------------------------------------------------------------------------------------------------%%%%%%%-------------------------------------------------------------
------------------------------------------------------------------------------------------------------------------------------------|||||||-------------------------------------------------------------
------------------------------------------------------------------------------------------------------------------------------------|||||||-------------------------------------------------------------
------------------------------------------------------------------------------------------------------------------------------------||||K||-------------------------------------------------------------
------------------------------------------------------------------------------------------------------------------------------------||||%%%%%%----------------------------------------------------------
------------------------------------------------------------------------------------------------------------------------------------||||||||||----------------------------------------------------------
------------------------------------------------------------------------------------------------------------------------------------||||||||||----------------------------------------------------------
----------------------------------------------------------------------------------------------------------------------SSSUSSS-S-----||y|||||||----------------------------------------------------------
------------------------------------------------------------------------------------------------------------------------------------||%%%%%%%|----------------------------------------------------------
---------------------#--#----------------------------------------------------------------------------------------------------|-----r||||||g|||----------------------------------------------------------
--------------------##--##--------------%%%%%%%%----------------------------------------------------------------------------gy--%%%%%%%%%%%%%%%%%%------------------------------------------------------
------------------%%%%--%%%%------------||||||||---------------------------------------------------------------------%%%%%%%%%%%||||||||||||||||||------------------------------------------------------
%%%%%%%%%%%%%%%%%%||||--||||------------||||||||-----------------------%%%%%%%%%---%%-------------%%%%---%%%%--------|||||||||||||||||||||||||||||------------------------------------------------------
||||||||||||||||||||||--||||XXXXX--XXXXX||||||||XXXX---XXXXXXXXX--XXXXX|||||||||---||XXXXXX---XXXX||||---||||XXX--XXX|||||||||||||||||||||||||||||XXXXXXXXFXXXXXXXXXXXXXXXXXXXXXXXXXXXXXXXXXXXXXXXXXXXXX
