HEIGHT=16;WIDTH=201;THEME=0;OVERRIDE=false
--------------------------------------------------------------------------------------------------------------------------------------------------------------------------------------------------------
--------------------------------------------------------------------------------------------------------------------------------------------------------------------------------------------------------
--------------------------------------------------------------------------------------------------------------------------------------------------------------------------------------------------------
--------------------------------------------------------------------------------------------------------------------------------------------------------------------------------------------------------
--------------------------------------------------------------------------------------------------------------------------------------------------------------------------------------------------------
--------------------------------------------------------------------------------------------------------------------------------------------------------------------------------------------------------
--------------------------------------------------------------------------------------------------------------------------------------------------------------------------------------------------------
--------------------------------------k-----------------------------------------------------------------------------------------------------------------------------------------------------------------
------------------------------------%%%-----------------------------------------------------------------------------------------------------------------------------------------------------------------
------------------------------------|||-----------------------------------------------------------------------------------------------------------------------------------------------------------------
------------------------------USS---|||------------------------------------------%%%%---------------------------------------Y---------------------------------------------------------------------------
------------------tt----tt----------|r|--rg-------#---#--------------------------||||---------------------------------------%%%%------------------------------------------------------------------------
%%%%%%%%%%%%%%----tt----tt--------%%%%%%%%%%%%%--##---##--%%%%%---%%%%%----------||||------------------------#---#----------||||-----------%%%%%%%%F%%%%%%%%%%%%%%%%%%%%%%%%%%%%%%%%%%%%%%%%%%%%%%%%%%%%
||||||||||||||----tt----tt--------|||||||||||||%%%%---%%%%|||||---|||||-------rr-|y||---------%%%%%---%%%%%%%%---%%%%%--%%--||||--%%%%-----||||||||%||||||||||||||||||||||||||||||||||||||||||||||||||||
||||||||||||||%%%%%%%%%%%%%%%%%%%%|||||||||||||||||---|||||||||---|||||%%%%%%%%%%%%%%%%-------|||||---||||||||---|||||--||--||||-y||||-----|||||||||||||||||||||||||||||||||||||||||||||||||||||||||||||
|||||||||||||||||||||||||||||||||||||||||||||||||||---|||||||||---|||||||||||||||||||||XX---XX|||||---||||||||---|||||--||XXXXXXXXXXXXXXXXX|||||||||||||||||||||||||||||||||||||||||||||||||||||||||||||
