HEIGHT=16;WIDTH=201;THEME=0;OVERRIDE=false
--------------------------------------------------------------------------------------------------------------------------------------------------------------------------------------------------------
--------------------------------------------------------------------------------------------------------------------------------------------------------------------------------------------------------
--------------------------------------------------------------------------------------------------------------------------------------------------------------------------------------------------------
--------------------------------------------------------------------------------------------------------------------------------------------------------------------------------------------------------
--------------------------------------------------------------------------------------------------------------------------------------------------------------------------------------------------------
--------------------------------------------------------------------------------------------------------------------------------------------------------------------------------------------------------
------------------k-------------------------------------------------------------------------------------------------------------------------------------------------------------------------------------
---------------%%%%%------------------------------------------------------------------------------------------------------------------------------------------------------------------------------------
---------------|||||-------------------%%%%%--------------------------------------------------------------------------SCS-------------------------------------------------------------------------------
---------------|||||-k-----------------|||||-----------------------------------------------------------------------------------SSSCS--------------------------------------------------------------------
---------------||||%%%%%%--------------|||||------------------------------------------------------------------------------------------------------------------------------------------------------------
---------------||||||||||--------------|||||-----------------%%%%---------------------------------------------------------------------------------------------------------------------------------------
---------------||||||||||--%%%%%%%%----||||%%%%%%------------||||------------------------%%---%%---------------------%%%%%%%%---------------------------------------------------------------------------
------------y--||||||g|k|--||||||||----||||||||y|------------||||-----%%---%%------------||---||%%%%%--------#---#---||||||||%%%%%%%%%------------------------------------------------------------------
%%%%%%%%%%%%%%%%%%%%%%%%%%%||||||||%%%%%%%%%%%%%%%%%%%-------||||-----||---||------------||---|||||||-------##---##--|||||||||||||||||%%--%%%%%%%%%%F%%%%%%%%%%%%%%%%%%%%%%%%%%%%%%%%%%%%%%%%%%%%%%%%%%%
||||||||||||||||||||||||||||||||||||||||||||||||||||||XXXXXXXXXXXXXXXX||---||XXXXX--XXXXX||---|||||||XXXXXXXXX---XXXX|||||||||||||||||||--||||||||||X|||||||||||||||||||||||||||||||||||||||||||||||||||
