HEIGHT=16;WIDTH=201;THEME=0;OVERRIDE=false
--------------------------------------------------------------------------------------------------------------------------------------------------------------------------------------------------------
--------------------------------------------------------------------------------------------------------------------------------------------------------------------------------------------------------
--------------------------------------------------------------------------------------------------------------------------------------------------------------------------------------------------------
--------------------------------------------------------------------------------------------------------------------------------------------------------------------------------------------------------
--------------------------------------------------------------------------------------------------------------------------------------------------------------------------------------------------------
--------------------------------------------------------------------------------------------------------------------------------------------------------------------------------------------------------
--------------------------------------------------------------------------------------------------------------------------------------------------------------------------------------------------------
--------------------------------------------------------------------------------------------------------------------------------------------------------------------------------------------------------
--------------------------------------------------------------------------------------------------------------------------------------------------------------------------------------------------------
----------------------------------------------------------------------------------------------------------------#--#------------------------------------------------------------------------------------
--------------CSS----------------------------------------------------------------------------------------------##--##-----------------------------------------------------------------------------------
------------------------------------------------------------------------------------------Tt--tt--------------###--###----------------------------------------------------------------------------------
----------------------------------#---#-----------------%%---%%---------------------------tt--tt------------%%%%%--%%%%%---------------%%--%%-----------------------------------------------------------
------------------%%%---#--#-----##---##----------------||---||--------%%--%%-----------%%%%%%%%%%%%%%------|||||--|||||%%%%--%%%%-----||--||%%%%%%%%F%%%%%%%%%%%%%%%%%%%%%%%%%%%%%%%%%%%%%%%%%%%%%%%%%%
----------%%%%%%%%|||--##--##--%%%%---%%%%--------%%--%%||---||--#--#--||--||%%%%---%%%%||||||||||||||%%--%%|||||--|||||||||--||||%%%%%||--||||||||||%||||||||||||||||||||||||||||||||||||||||||||||||||
XXXXXXXXXX|||||||||||XXXX--XXXX||||---||||XXX--XXX||--||||---||XXX--XXX||--||||||---||||||||||||||||||||--|||||||--|||||||||--|||||||||||--|||||||||||||||||||||||||||||||||||||||||||||||||||||||||||||
