HEIGHT=16;WIDTH=201;THEME=0;OVERRIDE=false
--------------------------------------------------------------------------------------------------------------------------------------------------------------------------------------------------------
--------------------------------------------------------------------------------------------------------------------------------------------------------------------------------------------------------
--------------------------------------------------------------------------------------------------------------------------------------------------------------------------------------------------------
--------------------------------------------------------------------------------------------------------------------------------------------------------------------------------------------------------
--------------------------------------------------------------------------------------------------------------------------------------------------------------------------------------------------------
--------------------------------------------------------------------------------------------------------------------------------------------------------------------------------------------------------
--------------------------------------------------------------------------------------------------------------------------------------------------------------------------------------------------------
--------------------------------------------------------------------------------------------------------------------------------------------------------------------------------------------------------
--------------------------------------------------------------------------------------------------------------------------------------------------------------------------------------------------------
---------------------------------------------S2S-SS-----------------------------------------------------------------------------------------------------------------------------------------------------
---------------------------------------------------------------%%%%-----------------------------#---#---------------------------------------------------------------------------------------------------
---------------------------------%%%%%%---------%--------------||||k---------------------------##---##-------------------------tt---Tt------------------------------------------------------------------
---------------------%%%%--%%%%--||||||--------y|-----%%%%%%%%%%%%%%%%%-----------------------###---###---------------#---#----tt---tt------------------------------------------------------------------
%%%%%%%%%%%%---------||||--||||--||||||-----%%%%%%%%%%|||||||||||||||||-----------%%%%--%%%%%%%%%---%%%%%%%%%--%%%%--##---##---tt---tt------------------------------------------------------------------
||||||||||||---------||||--||||--||||||-----|||||||||||||||||||||||||||%%%%---%%%%||||--|||||||||---|||||||||--||||%%%%---%%%%%%%%%%%%%------%%%%%%%%F%%%%%%%%%%%%%%%%%%%%%%%%%%%%%%%%%%%%%%%%%%%%%%%%%%
||||||||||||XXX---XXX||||--||||XXXXXXXXXXXXX|||||||||||||||||||||||||||||||---||||||||--|||||||||---|||||||||--||||||||---|||||||||||||XXXXXX||||||||X||||||||||||||||||||||||||||||||||||||||||||||||||
