HEIGHT=16;WIDTH=201;THEME=0;OVERRIDE=false
--------------------------------------------------------------------------------------------------------------------------------------------------------------------------------------------------------
--------------------------------------------------------------------------------------------------------------------------------------------------------------------------------------------------------
--------------------------------------------------------------------------------------------------------------------------------------------------------------------------------------------------------
--------------------------------------------------------------------------------------------------------------------------------------------------------------------------------------------------------
--------------------------------------------------------------------------------------------------------------------------------------------------------------------------------------------------------
--------------------------------------------------------------------------------------------------------------------------------------------------------------------------------------------------------
--------------------------------------------------------------------------------------------------------------------------------------------------------------------------------------------------------
--------------------------------------------------------------------------------------------------------------------------------------------------------------------------------------------------------
--------------------------------------------------------------------------------------------------------------------------------------------------------------------------------------------------------
--------------------------------------------------------------------------------------------------------------------------------------------------------------------------------------------------------
----------------------------tt---------------------------%%%%%-----------------------------------------------------------------USS----------------------------------------------------------------------
----------------------------tt---------------------------|||||------------------------------------------------------------------------------------------------------------------------------------------
%%%%%%%%%%%%----------------tt--%%%--%%%-----------------|||||------------%%%%--%%%%%%---%%-------------------------%%%%%%%--------%%%%--%%%%-----------------------------------------------------------
||||||||||||--Tt-----#--#--%%%%%|||--|||%%%%---%%%%---g--|||||------------||||--||||||---||-----------------#---#---|||||||-----r--||||--||||-----------------------------------------------------------
||||||||||||--tt---%%%--%%%||||||||--|||||||---||||%%%%%%%%%%%%%----------||||--||||||---||----------------##---##--|||||||%%%%%%%%||||--||||-----------------------------------------------------------
||||||||||||XXXXXXX|||--|||||||||||--|||||||---|||||||||||||||||XXXX--XXXX||||--||||||---||XXX---XXXXXXXXXXXX---XXXX|||||||||||||||||||--||||XXXXXXXXFXXXXXXXXXXXXXXXXXXXXXXXXXXXXXXXXXXXXXXXXXXXXXXXXXX
