HEIGHT=16;WIDTH=201;THEME=0;OVERRIDE=false
--------------------------------------------------------------------------------------------------------------------------------------------------------------------------------------------------------
--------------------------------------------------------------------------------------------------------------------------------------------------------------------------------------------------------
--------------------------------------------------------------------------------------------------------------------------------------------------------------------------------------------------------
--------------------------------------------------------------------------------------------------------------------------------------------------------------------------------------------------------
--------------------------------------------------------------------------------------------------------------------------------------------------------------------------------------------------------
--------------------------------------------------------------------------------------------------------------------------------------------------------------------------------------------------------
--------------------------------------------------------------------------------------------------------------------------------------------------------------------------------------------------------
--------------------------------------------------------------------------------------------------------------------------------------------------------------------------------------------------------
---------------------------------------SSS2SSS----------------------------------------------------------------------------------------------------------------------------------------------------------
--------------------------------------------------------------------------------------------------------------------------------------------------------------------------------------------------------
------------------------------------------------------------------------------------------------------------------Tt---C-C2SSS--------------------------------------------------------------------------
--------------------------------------------r---------------------------------------------------------------------tt------------------------------------------------------------------------------------
--------------------------------------%%%%%%%%%----------------------------%%%%--%%%%-------------------------%%%%%%%---%-------%%%%%---%%%%%-----------------------------------------------------------
%%%%%%%%%%%%%%%--%%-------%%--%%------|||||||||------------------%%%%------||||--||||%%%%%---%%%%%------------|||||||---|-------|||||---|||||%%%%%%%%F%%%%%%%%%%%%%%%%%%%%%%%%%%%%%%%%%%%%%%%%%%%%%%%%%%
|||||||||||||||--||-------||--||%%--%%|||||||||%%---%%%%%--------||||%%--%%||||--|||||||||---|||||%%%%%--%%%%%|||||||%%%%%%%%%%%|||||---|||||||||||||%||||||||||||||||||||||||||||||||||||||||||||||||||
|||||||||||||||--||XX---XX||--||||--|||||||||||||---|||||XXX--XXX||||||--||||||--|||||||||---||||||||||--||||||||||||||||||||||||||||---||||||||||||||||||||||||||||||||||||||||||||||||||||||||||||||||
