HEIGHT=16;WIDTH=201;THEME=0;OVERRIDE=false
--------------------------------------------------------------------------------------------------------------------------------------------------------------------------------------------------------
--------------------------------------------------------------------------------------------------------------------------------------------------------------------------------------------------------
--------------------------------------------------------------------------------------------------------------------------------------------------------------------------------------------------------
--------------------------------------------------------------------------------------------------------------------------------------------------------------------------------------------------------
------------------------------------------------------------------------------------------------------------------------------SUS-----------------------------------------------------------------------
--------------------------------------------------------------------------------------------------------------------------------------------------------------------------------------------------------
--------------------------------------------------------------------------------------------------------------------------------------------------------------------------------------------------------
------------------------------------------------------------------------------------------------------------------------------g-------------------------------------------------------------------------
------------------------------------------------------------------------------------------------------------------------------%%%%----------------------------------------------------------------------
---------------------------------------------------------------------------------------------------------Tt-------------------||||----------------------------------------------------------------------
---------------------------------------------------------------------------------------------------------tt-------------r-----||||----------------------------------------------------------------------
----------------------------------CSS---------------------------------#---#------------------------------tt----#---#---%%%%---||||----------------------------------------------------------------------
------------%%%%--%%%%%%%%--%%%%-----------------%%--%%----#--#------##---##----------------Yr--------%%%%%%%%%%---%%%-||||---||||----------------------------------------------------------------------
------------||||--||||||||--||||-----------#--#--||--||---##--##---%%%%---%%%%-----------%%%%%%-------||||||||||---|||-||r|---|k||----------------------------------------------------------------------
------------||||--||||||||--||||---g-----%%%--%%%||--||--###--###--||||---||||%%%%---%%%%||||||-------||||||||||---|||%%%%%%%%%%%%%%%%%%%%---%%%%%%%%%%%%%F%%%%%%%%%%%%%%%%%%%%%%%%%%%%%%%%%%%%%%%%%%%%%
XXXXXXXXXXXX||||--||||||||--||||XXXXXXXXX|||--|||||--||XXXXX--XXXXX||||---||||||||---||||||||||XXXXXXX||||||||||---|||||||||||||||||||||||---|||||||||||||X|||||||||||||||||||||||||||||||||||||||||||||
