HEIGHT=16;WIDTH=201;THEME=0;OVERRIDE=false
--------------------------------------------------------------------------------------------------------------------------------------------------------------------------------------------------------
--------------------------------------------------------------------------------------------------------------------------------------------------------------------------------------------------------
--------------------------------------------------------------------------------------------------------------------------------------------------------------------------------------------------------
--------------------------------------------------------------------------------------------------------------------------------------------------------------------------------------------------------
--------------------------------------------------------------------------------------------------------------------------------------------------------------------------------------------------------
--------------------------------------------------------------------------------------------------------------------------------------------------------------------------------------------------------
--------------------------------------------------------------------------------------------------------------------------------------------------------------------------------------------------------
--------------------------------------------------------------------------------------------------------------------------------------------------------------------------------------------------------
--------------------------------------------------------------------------------------------------------------------------------------------------------------------------------------------------------
-------------------------------------------------------------------------------------SCC----------------------------------------------------------------------------------------------------------------
--------------------------------------------------------------------------------------------------------------------------------------------------------------------------------------------------------
----------------------------------------------------SS-2------------------------------------------------------------------------------------------------------------------------------------------------
%%%%%%%%%%---------------------------------------------------------------------------K-r--k-%%%%%---%%------------------------------#---#---%%%%%%%%F%%%%%%%%%%%%%%%%%%%%%%%%%%%%%%%%%%%%%%%%%%%%%%%%%%%
||||||||||%%%--%%%----------%%--%%--------------------%----%%%%%%%%--------%%---%%%%%%%%%%%%|||||---||--------%%%---%%%---#--#-----##---##--||||||||%|||||||||||||||||||||||||||||||||||||||||||||||||||
|||||||||||||--|||----------||--||%%%--%%%%%---%%-----|----||||||||--#--#--||---|||||||||||||||||---||--#--#--|||---|||--##--##--%%%%---%%%%||||||||||||||||||||||||||||||||||||||||||||||||||||||||||||
|||||||||||||--|||XXXXXXXXXX||--|||||--|||||---||XXXXXXXXXX||||||||XXX--XXX||---|||||||||||||||||---||XXX--XXX|||---|||XXXX--XXXX||||---||||||||||||||||||||||||||||||||||||||||||||||||||||||||||||||||
