HEIGHT=16;WIDTH=201;THEME=0;OVERRIDE=false
--------------------------------------------------------------------------------------------------------------------------------------------------------------------------------------------------------
--------------------------------------------------------------------------------------------------------------------------------------------------------------------------------------------------------
--------------------------------------------------------------------------------------------------------------------------------------------------------------------------------------------------------
--------------------------------------------------------------------------------------------------------------------------------------------------------------------------------------------------------
--------------------------------------------------------------------------------------------------------------------------------------------------------------------------------------------------------
--------------------------------------------------------------------------------------------------------------------------------------------------------------------------------------------------------
--------------------------------------------------------------------------------------------------------------------------------------------------------------------------------------------------------
--------------------------------------------------------------------------------------------------------------------------------------------------------------------------------------------------------
---------------------------------------------------------------------SCCSSUS2---------------------------------------------------------------------------------------------------------------------------
--------------------------------------------------------------------------------------------------------------------------------------------------------------------------------------------------------
--------------------------y------------------------------------------------------------------------------#---#------------------------------------------------------------------------------------------
-------------------------%%%%%---------Tt-------------------------------K--g----------------------------##---##-----------------------------------------------------------------------------------------
----------------#--#-----|||||---------tt--------------------#---#--%%%%%%%%%%------------%%%%%--%%%%%%%%%---%%%%----tt---------------------------------------------------------------------------------
%%%%%%%%%%%%---##--##----|||||-----%%%%%%%-----------------%%%---%%%||||||||||------%%--%%|||||--|||||||||---||||----tt---------------------------------------------------------------------------------
||||||||||||--###--###---|||||-----|||||||-------------%%%%|||---|||||||||||||------||--|||||||--|||||||||---||||----tt---------------------------------------------------------------------------------
||||||||||||XXXXX--XXXXXXXXXXXXXXXX|||||||XXXXX---XXXXX|||||||---|||||||||||||XX--XX||--|||||||--|||||||||---||||XXXXXXXXX--XXXXXX--XXXXXXXXXXXXFXXXXXXXXXXXXXXXXXXXXXXXXXXXXXXXXXXXXXXXXXXXXXXXXXXXXXXX
