HEIGHT=16;WIDTH=201;THEME=0;OVERRIDE=false
--------------------------------------------------------------------------------------------------------------------------------------------------------------------------------------------------------
--------------------------------------------------------------------------------------------------------------------------------------------------------------------------------------------------------
--------------------------------------------------------------------------------------------------------------------------------------------------------------------------------------------------------
--------------------------------------------------------------------------------------------------------------------------------------------------------------------------------------------------------
--------------------------------------------------------------------------------------------------------------------------------------------------------------------------------------------------------
--------------------------------------------------------------------------------------------------------------------------------------------------------------------------------------------------------
--------------------------------------------------------------------------------------------------------------------------------------------------------------------------------------------------------
--------------------------------------------------------------------------------------------------------------------------------------------------------------------------------------------------------
--------------------------------------------------------------------------------------------------------------------------------------------------------------------------------------------------------
---------------------------------------------%%%%%------------------------------------------------------------------------------------------------------------------------------------------------------
---------------------------------------------|||||------------------------------------------------------------------------------------------------------------------------------------------------------
---------------------------------------------|||||-----------------------Tt-Tt-------------------------------------%%%%-----SC2SCC----------------------------------------------------------------------
----------------%%%%%---%%%%%----tt---------kgr|||y-g----------#--#------tt-tt----------------------%%%%---%%%%----||||---------------------------------------------------------------------------------
%%%%%%%%%%------|||||---|||||----tt--%%%%%%%%%%%%%%%%%%------%%%--%%%%%%%%%%%%%%%%%%%%--%%%%%%%---%%||||---||||----||||---------------------------------------------------------------------------------
||||||||||------|||||---|||||%%%%%%%%||||||||||||||||||------|||--||||||||||||||||||||--|||||||---||||||---||||%%%%%%%%%%-------------#---#--%%%%%%%%F%%%%%%%%%%%%%%%%%%%%%%%%%%%%%%%%%%%%%%%%%%%%%%%%%%
||||||||||XX--XX|||||---|||||||||||||||||||||||||||||||XX--XX|||--||||||||||||||||||||--|||||||---||||||---||||||||||||||XXXXXXXXXXXXXX---XXX||||||||X||||||||||||||||||||||||||||||||||||||||||||||||||
