HEIGHT=16;WIDTH=201;THEME=0;OVERRIDE=false
--------------------------------------------------------------------------------------------------------------------------------------------------------------------------------------------------------
--------------------------------------------------------------------------------------------------------------------------------------------------------------------------------------------------------
--------------------------------------------------------------------------------------------------------------------------------------------------------------------------------------------------------
--------------------------------------------------------------------------------------------------------------------------------------------------------------------------------------------------------
--------------------------------------------------------------------------------------------------------------------------------------------------------------------------------------------------------
--------------------------------------------------------------------------------------------------------------------------------------------------------------------------------------------------------
--------------------------------------------------------------------------------------------------------------------------------------------------------------------------------------------------------
--------------------------------------------------------------------------------------------------------------------------------------------------------------------------------------------------------
--------------------------------------------------------------------------------------------------------------------------------------------------------------------------------------------------------
--------------------------------------------------------------------------------------------------------------------------------------------------------------------------------------------------------
--------------------------------------------------------------------------------------------------------------------------------------------------------------------------------------------------------
----------------------------#---#----------------------------------------------------------------------------#---#--------------------------------------------------------------------------------------
---------------------------##---##---%%%%%---%%%%%---------------------------------------------------------%%%---%%%--#---#--%%-------------------------------------------------------------------------
--------------------------###---###--|||||---|||||---------%%%%--------#---#--%%%%-------------------------|||---|||%%%---%%%||%%%%%---%%%%%------------------------------------------------------------
------------------------%%%%%---%%%%%|||||---|||||%%%---%%%||||------%%%---%%%||||------------%%%%%---%%%%%|||---||||||---||||||||||---|||||------------------------------------------------------------
XXXXXXXXXXXXXXXXX---XXXX|||||---||||||||||---||||||||---|||||||XX--XX|||---|||||||XXXXX--XXXXX|||||---||||||||---||||||---||||||||||---|||||XXXXXXXXFXXXXXXXXXXXXXXXXXXXXXXXXXXXXXXXXXXXXXXXXXXXXXXXXXXX
