HEIGHT=16;WIDTH=201;THEME=0;OVERRIDE=false
--------------------------------------------------------------------------------------------------------------------------------------------------------------------------------------------------------
--------------------------------------------------------------------------------------------------------------------------------------------------------------------------------------------------------
--------------------------------------------------------------------------------------------------------------------------------------------------------------------------------------------------------
--------------------------------------------------------------------------------------------------------------------------------------------------------------------------------------------------------
-------------------------------r---g--------------------------------------------------------------------------------------------------------------------------------------------------------------------
-----------------------------%%%%%%%--------------------------------------------------------------------------------------------------------------------------------------------------------------------
-----------------------------|||||||--------------------------------------------------------------------------------------------------------------------------------------------------------------------
-----------------------------|||||||--------------------------------------------------------------------------------------------------------------------------------------------------------------------
----------------------------y|||||||--------------------------------------------------------------------------------------------------------------------------------------------------------------------
-------------------------%%%%%%|||||---------------------------------------------y------------------r--------CCSSS--------------------------------------------------------------------------------------
-------------------------|||||||||||------------------------------------------%%%%%%%--------------%%%%%%-----------------------------------------------------------------------------------------------
-------------------------r|r|g|k||||--------y---------------------------------|||||||-----r-k------||||||-----------------------------------------------------------------------------------------------
------------------------%%%%%%%%%%%%%%%%%%%%%%--#---#---------------%%---%%---|r|||||---%%%%%%%%%%%%%%%%%%%------r----------------#---#-----------------------------------------------------------------
------------------------||||||||||||||||||||||%%%---%%%--%%%%%------||---||%%%%%%%%%%%%%|||||||||||||||||||-%%%%%%---------------##---##--%%%%%%%%F%%%%%%%%%%%%%%%%%%%%%%%%%%%%%%%%%%%%%%%%%%%%%%%%%%%%%
------------------------|||||||||||||||||||||||||---|||--|||||------||---||||||||||||||||||||||||||||||||||-||||||-yk----------%%%%---%%%%||||||||%|||||||||||||||||||||||||||||||||||||||||||||||||||||
XXXXXXXXXXXXXXXX---XXXXX|||||||||||||||||||||||||---|||XXXXXXXXXXXXX||---||||||||||||||||||||||||||||||||||XXXXXXXXXXXXXXXX--XX||||---||||||||||||||||||||||||||||||||||||||||||||||||||||||||||||||||||
