HEIGHT=16;WIDTH=201;THEME=0;OVERRIDE=false
--------------------------------------------------------------------------------------------------------------------------------------------------------------------------------------------------------
--------------------------------------------------------------------------------------------------------------------------------------------------------------------------------------------------------
--------------------------------------------------------------------------------------------------------------------------------------------------------------------------------------------------------
--------------------------------------------------------------------------------------------------------------------------------------------------------------------------------------------------------
--------------------------------------------------------------------------------------------------------------------------------------------------------------------------------------------------------
--------------------------------------------------------------------------------------------------------------------------------------------------------------------------------------------------------
--------------------------------------------------------------------------------------------------------------------------------------------------------------------------------------------------------
------------------------------------------------------------------------------------------------------------------------------------------%%%-----------------------------------------------------------
------------------------------------------------------------------------------------------------------------------------------------------|||-----------------------------------------------------------
---------------------------------------------------------------------------------------------------------------------CUCS---------------%%%%%%%---------------------------------------------------------
---------------------------SS2CSS-------------------------------------------------------------------------------------------------------|||||||---------------------------------------------------------
------------------#--#------------------------------------------------------------------------------------------------------------------|||||||---------------------------------------------------------
%%%%%%%%%%%%%%---##--##------------------------------------------------------------#--#---%%%%---%%%%----tt---tt------------%%--%%------|||||||--%%%%%%%%F%%%%%%%%%%%%%%%%%%%%%%%%%%%%%%%%%%%%%%%%%%%%%%
||||||||||||||--###--###----r-------------------%%%%%--%%%%%%%--#--#--------------##--##--||||---||||%%%-tt---tt---%%%%%%%%%||--||-----%%%%%%%%%%||||||||%||||||||||||||||||||||||||||||||||||||||||||||
||||||||||||||%%%%%--%%%%%%%%%%%%%%%%%%%---%%%%%|||||--|||||||%%%--%%%----------%%%%--%%%%||||---|||||||%%%%%%%%%%%|||||||||||--||%%%%%|||||||||||||||||||||||||||||||||||||||||||||||||||||||||||||||||
|||||||||||||||||||--|||||||||||||||||||---||||||||||--||||||||||--|||XXXX--XXXX||||--||||||||---|||||||||||||||||||||||||||||--||||||||||||||||||||||||||||||||||||||||||||||||||||||||||||||||||||||||
