HEIGHT=16;WIDTH=201;THEME=0;OVERRIDE=false
--------------------------------------------------------------------------------------------------------------------------------------------------------------------------------------------------------
--------------------------------------------------------------------------------------------------------------------------------------------------------------------------------------------------------
--------------------------------------------------------------------------------------------------------------------------------------------------------------------------------------------------------
--------------------------------------------------------------------------------------------------------------------------------------------------------------------------------------------------------
--------------------------------------------------------------------------------------------------------------------------------------------------------------------------------------------------------
--------------------------------------------------------------------------------------------------------------------------------------------------------------------------------------------------------
------------------g---------------------------------------------------------------------------------SCU2------------------------------------------------------------------------------------------------
------------------%%%%----------------------------------------------------------------------------------------------------------------------------------------------------------------------------------
------------------||||-----------------------------------------------------------------------------------------SCCSS------------------------------------------------------------------------------------
------------------||||------------------y----------------------------------------------------------gyr--------------------------------------------------------------------------------------------------
------------------||||---------------%%%%%%%------------------------------------------------tt-----%%%%%%%----------------------------------------------------------------------------------------------
----------------%%%%||-------CCCS----|||||||------------------------------------------------tt-----|||||||----------------------------------------------------------------------------------------------
----------------||||||--------------%%%%%%%%%%--------------%%%-------------------------%%%%%%%----||||k|g---%%%%%%%%%%%%%--%%%%------------------------------------------------------------------------
----------------|||y||-k------------||||||||||--------------|||-------------------------|||||||%%%%%%%%%%%%%%|||||||||||||--||||-----------%%%%%%%%F%%%%%%%%%%%%%%%%%%%%%%%%%%%%%%%%%%%%%%%%%%%%%%%%%%%%
----------%%%%%%%%%%%%%%%%----------||||||||||%%%%--%%%%---r|||---------%%%---%%%-------||||||||||||||||||||||||||||||||||--||||-----------||||||||%||||||||||||||||||||||||||||||||||||||||||||||||||||
XXXXXXXXXX||||||||||||||||XXXXXXXXXX||||||||||||||--||||XXXXXXXXXXXXXXXX|||---|||XX---XX||||||||||||||||||||||||||||||||||--||||XXXX---XXXX|||||||||||||||||||||||||||||||||||||||||||||||||||||||||||||
