HEIGHT=16;WIDTH=201;THEME=0;OVERRIDE=false
--------------------------------------------------------------------------------------------------------------------------------------------------------------------------------------------------------
--------------------------------------------------------------------------------------------------------------------------------------------------------------------------------------------------------
--------------------------------------------------------------------------------------------------------------------------------------------------------------------------------------------------------
--------------------------------------------------------------------------------------------------------------------------------------------------------------------------------------------------------
--------------------------------------------------------------------------------------------------------------------------------------------------------------------------------------------------------
--------------------------------------------------------------------------------------------------------------------------------------------------------------------------------------------------------
--------------------------------------------------------------------------------------------------------------------------------------------------------------------------------------------------------
--------------------------------------------------------------------------------------------------------------------------------------------------------------------------------------------------------
--------------------------------------------------------------------------------------------------------------------------------------------------------------------------------------------------------
---------------------------------------------------------------------------------------SSSSS------------------------------------------------------------------------------------------------------------
-------------#---#-------------------------------------%%%%%%%------------------------------------------------------------------------------------------------------------------------------------------
------------##---##----S2CU----------------------------|||||||------------------------------------------------------------------------------------------------------------------------------------------
----------%%%%---%%%%-------------------------Tt-------|||||||------%%%--%%%%%%---%%%-------------------------%%%%--%%%%--------------------------------------------------------------------------------
----------||||---||||----------%%%%%---%%%%%--tt---tt--k|k||||r--y--|||--||||||---|||%%%%%%%%----------tt-----||||--||||---------%%%---%%%--------------------------------------------------------------
%%%%%%%%%%||||---||||----y-----|||||---|||||--tt---tt-%%%%%%%%%%%%%%|||--||||||---|||||||||||----------tt-----||||--||||%%%%%%%%%|||---|||--------------------------------------------------------------
||||||||||||||---||||XXXXXXXXXX|||||---|||||XXXXXXXXXX|||||||||||||||||--||||||---|||||||||||XXX--XXXXXXXXXXXX||||--||||||||||||||||---|||XXXXXXXXFXXXXXXXXXXXXXXXXXXXXXXXXXXXXXXXXXXXXXXXXXXXXXXXXXXXXX
