HEIGHT=16;WIDTH=201;THEME=0;OVERRIDE=false
--------------------------------------------------------------------------------------------------------------------------------------------------------------------------------------------------------
--------------------------------------------------------------------------------------------------------------------------------------------------------------------------------------------------------
--------------------------------------------------------------------------------------------------------------------------------------------------------------------------------------------------------
--------------------------------------------------------------------------------------------------------------------------------------------------------------------------------------------------------
--------------------------------------------------------------------------------------------------------------------------------------------------------------------------------------------------------
--------------------------------------------------------------------------------------------------------------------------------------------------------------------------------------------------------
--------------------------------------------------------------------------------------------------------------------------------------------------------------------------------------------------------
--------------------------------------------------------------------------------------------------------------------------------------------------------------------------------------------------------
--------------------------------------------------------------------------------------------------------------------------------------------------------------------------------------------------------
--------------------------------------------------------------------------------------------------------------------------------------------------------------------------------------------------------
----------------------------------------------------------------------------------------------------------------------------g---------------------------------------------------------------------------
----------------------2C2S------------------------------------------------------------------------------------------------%%%%%-------------------------------------------------------------------------
---------------------------%%%%%---%%%%%%%%%%--%%%%%-------------%%%%--%%%%---%%%%------%%%---%%%%%%%%--%%%%%-------------|||||-------------------------------------------------------------------------
---------------------------|||||---||||||||||--|||||--------tt---||||--||||---||||------|||---||||||||--|||||--------%%%%%%%%%%%%%%--%%%%%%-----%%%%%%%%F%%%%%%%%%%%%%%%%%%%%%%%%%%%%%%%%%%%%%%%%%%%%%%%
%%%%%%%%%%%%%%-----------k-|||||---||||||||||--|||||--------tt---||||--||||---||||------|||---||||||||--|||||%%%--%%%||||||||||||||--||||||-----||||||||%|||||||||||||||||||||||||||||||||||||||||||||||
||||||||||||||XX---XXXXXXXX|||||---||||||||||--|||||XXXXXXXXXXXXX||||XX||||---||||XX--XX|||---||||||||--||||||||--|||||||||||||||||XXXXXXXXXXXXX||||||||||||||||||||||||||||||||||||||||||||||||||||||||
