HEIGHT=16;WIDTH=201;THEME=0;OVERRIDE=false
--------------------------------------------------------------------------------------------------------------------------------------------------------------------------------------------------------
--------------------------------------------------------------------------------------------------------------------------------------------------------------------------------------------------------
--------------------------------------------------------------------------------------------------------------------------------------------------------------------------------------------------------
--------------------------------------------------------------------------------------------------------------------------------------------------------------------------------------------------------
--------------------------------------------------------------------------------------------------------------------------------------------------------------------------------------------------------
--------------------------------------------------------------------------------------------------------------------------------------------------------------------------------------------------------
--------------------------------------------------------------------------------------------------------------------------------------------------------------------------------------------------------
--------------------------------------------------------------------------------------------------------------------------------------------------------------------------------------------------------
--------------------------------------------------------------------------------------------------------------------------------------------------------------------------------------------------------
--------------------------------------------------------------------------------------------------------------------------------------------------------------------------------------------------------
---------------------#--#-------------------------------------------------------------------------------------------------------------------------------------------------------------------------------
--------------------##--##---------------Y--------------------------------------------------------------------------------------------------------------------------------------------------------------
-------------------###--###-------------%%%%--------------------#--#------#--#-----------------------#---#------------------#--#------------------------------------------------------------------------
-----------------%%%%%--%%%%%--#---#----||||-----%%---%%%%%%---##--##---%%%--%%%--------%%%---%%%---##---##----------------##--##-----------------------------------------------------------------------
%%%%%%%%%%%%%%---|||||--|||||%%%---%%%--||||g----||---||||||--###--###--|||--|||--#--#--|||---|||--###---###-------------%%%%--%%%%-----%%%%%%%%F%%%%%%%%%%%%%%%%%%%%%%%%%%%%%%%%%%%%%%%%%%%%%%%%%%%%%%%
||||||||||||||XXX|||||--||||||||---|||XXXXXXXXXXX||---||||||XXXXX--XXXXX|||--|||XXX--XXX|||---|||XXXXX---XXXXXXX---XXXXXX||||--||||XXXXX||||||||X|||||||||||||||||||||||||||||||||||||||||||||||||||||||
