HEIGHT=16;WIDTH=201;THEME=0;OVERRIDE=false
--------------------------------------------------------------------------------------------------------------------------------------------------------------------------------------------------------
--------------------------------------------------------------------------------------------------------------------------------------------------------------------------------------------------------
--------------------------------------------------------------------------------------------------------------------------------------------------------------------------------------------------------
--------------------------------------------------------------------------------------------------------------------------------------------------------------------------------------------------------
--------------------------------------------------------------------------------------------------------------------------------------------------------------------------------------------------------
--------------------------------------------------------------------------------------------------------------------------------------------------------------------------------------------------------
--------------------------------------------------------------------------------------------------------------------------------------------------------------------------------------------------------
--------------------------------------------------------------------------------------------------------------------------------------------------------------------------------------------------------
----------------------------------k---------------------------------------------------------------------------------------------------------------------------------------------------------------------
-------------------------------%%%%%---------------------------------------------tt---Tt----------------------------------------------------------------------------------------------------------------
-------------------------------|||||---------------#--#--------------------------tt---tt----------------------------------------------------------------------------------------------------------------
-------------------------------|||||--------------##--##-------------------------tt---tt--------------------------------y-------------------------------------------------------------------------------
----------%%--%%-------%%--%%--||kG|------------%%%%--%%%%--------------------%%%%%%%%%%%%---------------------------%%%%%%----%%---%%%%--%%%%%%%%%%F%%%%%%%%%%%%%%%%%%%%%%%%%%%%%%%%%%%%%%%%%%%%%%%%%%%
----------||--||-------||--||%%%%%%%%%%%%%%---%%||||--||||%%%%%%%--%%%%-------||||||||||||%%--%%%%%%---%%%%%%%%--%%%%||||||%%%%||---||||--||||||||||%|||||||||||||||||||||||||||||||||||||||||||||||||||
----------||--||%%---%%||--||||||||||||||||---||||||--|||||||||||--||||-------||||||||||||||--||||||---||||||||--||||||||||||||||---||||--||||||||||||||||||||||||||||||||||||||||||||||||||||||||||||||
XXXXXXXXXX||--||||---||||--||||||||||||||||---||||||--|||||||||||--||||XX---XX||||||||||||||--||||||---||||||||--||||||||||||||||---||||--||||||||||||||||||||||||||||||||||||||||||||||||||||||||||||||
