HEIGHT=16;WIDTH=201;THEME=0;OVERRIDE=false
--------------------------------------------------------------------------------------------------------------------------------------------------------------------------------------------------------
--------------------------------------------------------------------------------------------------------------------------------------------------------------------------------------------------------
--------------------------------------------------------------------------------------------------------------------------------------------------------------------------------------------------------
--------------------------------------------------------------------------------------------------------------------------------------------------------------------------------------------------------
--------------------------------------------------------------------------------------------------------------------------------------------------------------------------------------------------------
--------------------------------------------------------------------------------------------------------------------------------------------------------------------------------------------------------
--------------------------------------------------------------------------------------------------------------------------------------------------------------------------------------------------------
--------------------------------------------------------------------------------------------------------------------------------------------------------------------------------------------------------
--------------------------------------------------------------------------------------------------------------------------------------------------------------------------------------------------------
--------------------------------------------------------------------------------------------------------------------------------------------------------------------------------------------------------
-----------------------------------------------------------------g--------------------------------------------------------------------------------------------------------------------------------------
----------------------------------------------------------------%%%-------------------------------------------------------------------------------------------------------------------------------------
-----------------------------------%%%%%%%-------Tt-------------|||--------------------%%%--%%%---------------------------------------------------------------------------------------------------------
-----------%%%%---%%%%--------%%---|||||||-------tt---%%---%%---|||-k--g--r------------|||--|||%%%%%%---------%%%--%%%------------------%%%%%%%%F%%%%%%%%%%%%%%%%%%%%%%%%%%%%%%%%%%%%%%%%%%%%%%%%%%%%%%%
%%%%%%%%%%%||||---||||%%%--%%%||-g-|||||||-------tt---||---||%%%%%%%%%%%%%%%%%---------|||--|||||||||--#---#--|||--|||----------%%%%%%%%||||||||%|||||||||||||||||||||||||||||||||||||||||||||||||||||||
|||||||||||||||---|||||||--|||||XXXXXXXXXXXXXXXXXXXXXX||---|||||||||||||||||||XXX---XXX|||--|||||||||XXX---XXX|||--|||XXXX--XXXX||||||||||||||||||||||||||||||||||||||||||||||||||||||||||||||||||||||||
