HEIGHT=16;WIDTH=201;THEME=0;OVERRIDE=false
--------------------------------------------------------------------------------------------------------------------------------------------------------------------------------------------------------
--------------------------------------------------------------------------------------------------------------------------------------------------------------------------------------------------------
--------------------------------------------------------------------------------------------------------------------------------------------------------------------------------------------------------
-----------------------------------------------------------------------2C2C-----------------------------------------------------------------------------------------------------------------------------
---------------------%%%%%------------------------------------------------------------------------------------------------------------------------------------------------------------------------------
---------------------||||k------------------y-----------------------------------------------------------------------------------------------------------------------------------------------------------
---------------------||%%%%%%--------------%%%----------------------------ygy---------------------------------------------------------------------------------------------------------------------------
---------------------||||||||--------------|||-------------------------%%%%%%%--------------------------------------------------------------------------------------------------------------------------
---------------------||||||||--------------|||-------------------------|||||||--------------------------------------------------------------------------------------------------------------------------
---------------------||||%%%|--------------|||-----r-------------------|||||||---g---k------------------------------------------------------------------------------------------------------------------
---------------------||||||||--------------|||----%%%%%%---------------|||||||--%%%%%%%-----------------------------------------------------------------------------------------------------------------
--------------------r||||||||--r---USS-----|||----||||||---------------|||||||--|||||||-----------------------------------------------------------------------------------------------------------------
-------------------%%%%%%%%%%%%%%----------|||----||||||---------------|||||||--|||||||--%%%----------------------#---#---------------------------------------------------------------------------------
---------------y---||||||||||||||-|--------||k----||||||---------------|r||k||k-|||||||--|||%%%--%%%---#---#-----##---##----------------%%%%%%%%F%%%%%%%%%%%%%%%%%%%%%%%%%%%%%%%%%%%%%%%%%%%%%%%%%%%%%%%
%%%%%%%%%%%%%%%%%%%||||||||||||||-r------%%%%%%%%%%%%%%%%%%%%%%--%%%%%%%%%%%%%%%%%%%%%%%%||||||--|||--##---##--%%%%---%%%%%%---%%---%%%%||||||||%|||||||||||||||||||||||||||||||||||||||||||||||||||||||
|||||||||||||||||||||||||||||||||XXXXXXXX||||||||||||||||||||||--||||||||||||||||||||||||||||||--|||XXXX---XXXX||||---||||||---||XXX||||||||||||||||||||||||||||||||||||||||||||||||||||||||||||||||||||
