HEIGHT=16;WIDTH=201;THEME=0;OVERRIDE=false
--------------------------------------------------------------------------------------------------------------------------------------------------------------------------------------------------------
--------------------------------------------------------------------------------------------------------------------------------------------------------------------------------------------------------
--------------------------------------------------------------------------------------------------------------------------------------------------------------------------------------------------------
--------------------------------------------------------------------------------------------------------------------------------------------------------------------------------------------------------
--------------------------------------------------------------------------------------------------------------------------------------------------------------------------------------------------------
--------------------------------------------------------------------------------------------------------------------------------------------------------------------------------------------------------
--------------------------------------------------------------------------------------------------------------------------------------------------------------------------------------------------------
--------------------------------------------------------------------------------------------------------------------------------------------------------------------------------------------------------
--------------------------------------------------------------------------------------------------------------------------------------------------------------------------------------------------------
-----------------------------------------------------------------------S-S2-----------------------------------------------------------------------------------------------------------------------------
------------------%%%%%---------------------------------------------------------------------------------------------------------------------------------------------------------------------------------
------------------|||||-------------------------------------------------|---------SSC-------------------------------------------------------------------------------------------------------------------
------------------|||y|----#---#--------------%%%%---%%%%%%%%%---%%%%%--g--y----------------------------------------------------------------------------------------------------------------------------
--------------%%%%%%%%%%%%%%---%%%------------||||---|||||||||---|||||%%%%%%%%%-------------------------------------------%%%%--%%%%%%%%--%%%%%%%%%%%%F%%%%%%%%%%%%%%%%%%%%%%%%%%%%%%%%%%%%%%%%%%%%%%%%%
%%%%%%%%%%%%%%||||||||||||||---|||------------||||---|||||||||---||||||||||||||--gg----%%%%%---%%%%%-----------%%%%---%%%%||||--||||||||--||||||||||||%|||||||||||||||||||||||||||||||||||||||||||||||||
||||||||||||||||||||||||||||---|||XXXXX--XXXXX||||---|||||||||---||||||||||||||XXXXXXXX|||||---|||||XXXX---XXXX||||---||||||||--||||||||--||||||||||||||||||||||||||||||||||||||||||||||||||||||||||||||
