HEIGHT=16;WIDTH=201;THEME=0;OVERRIDE=false
--------------------------------------------------------------------------------------------------------------------------------------------------------------------------------------------------------
--------------------------------------------------------------------------------------------------------------------------------------------------------------------------------------------------------
--------------------------------------------------------------------------------------------------------------------------------------------------------------------------------------------------------
--------------------------------------------------------------------------------------------------------------------------------------------------------------------------------------------------------
--------------------------------------------------------------------------------------------------------------------------------------------------------------------------------------------------------
--------------------------------------------------------------------------------------------------------------------------------------------------------------------------------------------------------
--------------------------------------------------------------------------------------------------------------------------------------------------------------------------------------------------------
--------------------------------------------------------------------------------------------------------------------------------------------------------------------------------------------------------
-----------------------------------------------------------------------------------------------------------------C2SSS----------------------------------------------------------------------------------
--------------------------------------------------------------------------------------------------------------------------------------------------------------------------------------------------------
----------------------------------------------------------------------------------------------------------------------------------------#---#-----------------------------------------------------------
-------------#--#---------------------------------------------------------------------#--#---------------------------------------------##---##----------------------------------------------------------
%%%%%%%%%%--##--##----------%%--%%%%%%--%%%%--#--#-------------%%---%%---------------##--##--%%%%--%%%%--------%%%%%%%%%%-------------###---###--%%%%%%%%F%%%%%%%%%%%%%%%%%%%%%%%%%%%%%%%%%%%%%%%%%%%%%%
||||||||||%%%%--%%%%%%%--%%%||--||||||--||||%%%--%%%%%---%%----||---||%%%%%---%%%%%%%%%--%%%%||||--||||--------||||||||||%%%%---%%%%%%%%%---%%%%%||||||||%||||||||||||||||||||||||||||||||||||||||||||||
||||||||||||||--|||||||--|||||--||||||--|||||||--|||||---||----||---|||||||---|||||||||--||||||||--||||--------||||||||||||||---|||||||||---||||||||||||||||||||||||||||||||||||||||||||||||||||||||||||
||||||||||||||--|||||||--|||||--||||||--|||||||--|||||---||XXXX||---|||||||---|||||||||--||||||||--||||XXX--XXX||||||||||||||---|||||||||---||||||||||||||||||||||||||||||||||||||||||||||||||||||||||||
