HEIGHT=16;WIDTH=201;THEME=0;OVERRIDE=false
--------------------------------------------------------------------------------------------------------------------------------------------------------------------------------------------------------
--------------------------------------------------------------------------------------------------------------------------------------------------------------------------------------------------------
--------------------------------------------------------------------------------------------------------------------------------------------------------------------------------------------------------
--------------------------------------------------------------------------------------------------------------------------------------------------------------------------------------------------------
--------------------------------------------------------------------------------------------------------------------------------------------------------------------------------------------------------
---------------------------------------------------------------------------------------------------------------S-CSU------------------------------------------------------------------------------------
--------------------------------------------------------------------------------------------------------------------------------------------------------------------------------------------------------
----------------------------------------CCSS--------------------------------------------------------------------%---------------------------------------------------------------------------------------
----------------------------------------------------------------------------------------------------------------|-k-----SSSSS2C2------------------------------------------------------------------------
--------------------------------------------------------------------------------------------------------------%%%%%%%-----------------------------------------------------------------------------------
----------------tt-----------------------y--------------------------------------------------------------------|||||||-----------%-----------------------------------------------------------------------
----------------tt--tt-tt--------------%%%%%%---------------------------------------------------------k------y|||||||-----------|-----#---#-------------------------------------------------------------
----------------tt--tt-tt-%%%%--%%%%---||||||-------------------%%%---%%%---#--#-----------%%%%--%%%%%%%%%%-%%%%%%|||--%%%%%%%%%%%---##---##------------------------------------------------------------
%%%%%%%%%%%%%%%%%%%%%%%%%%||||--||||---||||||---------%%%%--%%%%|||---|||--##--##----------||||--||||||||||-|||||||||--|||||||||||--###---###-----------------------------------------------------------
||||||||||||||||||||||||||||||--||||--r||||||--%%%%%%%||||--|||||||---|||%%%%--%%%%%%%--%%%||||--||||||||||-|||||||||--|||||||||||%%%%%---%%%%%%%%%%%%%F%%%%%%%%%%%%%%%%%%%%%%%%%%%%%%%%%%%%%%%%%%%%%%%%
||||||||||||||||||||||||||||||--||||XXXXXXXXXXX|||||||||||--|||||||---|||||||--|||||||--|||||||--||||||||||XXXXXXXXXXXX||||||||||||||||---|||||||||||||X||||||||||||||||||||||||||||||||||||||||||||||||
