HEIGHT=16;WIDTH=201;THEME=0;OVERRIDE=false
--------------------------------------------------------------------------------------------------------------------------------------------------------------------------------------------------------
--------------------------------------------------------------------------------------------------------------------------------------------------------------------------------------------------------
--------------------------------------------------------------------------------------------------------------------------------------------------------------------------------------------------------
--------------------------------------------------------------------------------------------------------------------------------------------------------------------------------------------------------
---------------------------------------------------------------%%%%%%-----------------------------------------------------------------------------------------------------------------------------------
---------------------------------------------------------------||||||-----------------------------------------------------------------------------------------------------------------------------------
-------------------------------------------------------------%%%%%%||-----------------------------------------------------------------------------------------------------------------------------------
-------------------------------------------------------------||||||||-----------------------------------------------------------------------------------------------------------------------------------
-------------------------------------------------------------||||||||-----------------------------------------------------------------------------------------------------------------------------------
-----------------------------------------------------------%%%%%%%|||-------------%%%%%%----------------------#---#-------------------------------------------------------------------------------------
-----------------------------------k-----------------------||||||||||-------------||||||---------------------##---##------------------------------------------------------------------------------------
---------------Tt------------------%%%---------------------||||||||||---------gr--r||r|k--------------------###---###-----------------------------------------------------------------------------------
---------------tt-----%%-----------|||-----G--------tt----y|||||||r||----g--%%%%%%%%%%%%%%----------------%%%%%---%%%%%-----------------%%%%%%%%F%%%%%%%%%%%%%%%%%%%%%%%%%%%%%%%%%%%%%%%%%%%%%%%%%%%%%%%
--------------%%%%%%%%||%%%--%%%%%%%%%%%%%%%%-tt----tt---%%%%%%%%%%%%%%%%%%%||||||||||||||----------------|||||---|||||%%%%%%%%%%%------||||||||%|||||||||||||||||||||||||||||||||||||||||||||||||||||||
--------------|||||||||||||--||||||||||||||||-tt----tt---|||||||||||||||||||||||||||||||||--#---#--%%---%%|||||---||||||||||||||||%%--%%||||||||||||||||||||||||||||||||||||||||||||||||||||||||||||||||
XXXXXXXXXXXXXX|||||||||||||--||||||||||||||||XXXXXXXXXXXX|||||||||||||||||||||||||||||||||XXX---XXX||---|||||||---||||||||||||||||||--||||||||||||||||||||||||||||||||||||||||||||||||||||||||||||||||||
