HEIGHT=16;WIDTH=201;THEME=0;OVERRIDE=false
--------------------------------------------------------------------------------------------------------------------------------------------------------------------------------------------------------
--------------------------------------------------------------------------------------------------------------------------------------------------------------------------------------------------------
--------------------------------------------------------------------------------------------------------------------------------------------------------------------------------------------------------
--------------------------------------------------------------------------------------------------------------------------------------------------------------------------------------------------------
--------------------------------------------------------------------------------------------------------------------------------------------------------------------------------------------------------
--------------------------------------------------------------------------------------------------------------------------------------------------------------------------------------------------------
--------------------------------------------------------------------------------------------------------------------------------------------------------------------------------------------------------
--------------------------------------------------------------------------------------------------------------------------------------------------------------------------------------------------------
--------------------------------------------------------------------------------------------------------------------------------------------------------------------------------------------------------
--------------------------------------------------------------------------------------------------------------------------------------------------------------------------------------------------------
--------------------------------------------------------------------------------------------------------------------------------------------------------------------------------------------------------
---------------------------------tt----Tt---------------------------------------------------------------------------------------------------------------------------------------------------------------
-----------%%%---%%%-------------tt-tt-tt------------%%%%%---%%%%%----#--#------------------------------------------------------------------------------------------------------------------------------
%%%%%%%%%%%|||---|||------%%%%---tt-tt-tt------------|||||---|||||---##--##----------------------------------%%%%%---%%%%%----------------%%%%%%%%F%%%%%%%%%%%%%%%%%%%%%%%%%%%%%%%%%%%%%%%%%%%%%%%%%%%%%
||||||||||||||---|||------||||%%%%%%%%%%%%%%%%%---%%%|||||---|||||--###--###---------------------------------|||||---|||||%%--%%----------||||||||%|||||||||||||||||||||||||||||||||||||||||||||||||||||
||||||||||||||---|||XXXXXX|||||||||||||||||||||---||||||||---|||||XXXXX--XXXXXXXXX--XXXXXXXXXXXXXXXXX---XXXXX|||||---|||||||--||XXXX--XXXX||||||||||||||||||||||||||||||||||||||||||||||||||||||||||||||
