HEIGHT=16;WIDTH=201;THEME=0;OVERRIDE=false
--------------------------------------------------------------------------------------------------------------------------------------------------------------------------------------------------------
--------------------------------------------------------------------------------------------------------------------------------------------------------------------------------------------------------
--------------------------------------------------------------------------------------------------------------------------------------------------------------------------------------------------------
--------------------------------------------------------------------------------------------------------------------------------------------------------------------------------------------------------
--------------------------------------------------------------------------------------------------------------------------------------------------------------------------------------------------------
--------------------------------------------------------------------------------------------------------------------------------------------------------------------------------------------------------
--------------------------------------------------------------------------------------------------------------------------------------------------------------------------------------------------------
--------------------------------------------------------------------------------------------------------------------------------------------------------------------------------------------------------
--------------------------------------------------------------------------------------------------------------------------------------------------------------------------------------------------------
---------------22SCCS-----------------------------------------------------------------------------------------------------------------------------------------------------------------------------------
-------------------------------S2UCCSS------------------------------------------------------------------------------------------------------------------------------------------------------------------
--------------------------------------------------------------------------------------------------------------------------------------------------------------------------------------------------------
%%%%%%%%%%%%%-----y-----%%%%%%---------%%%%--%%%%-------------------%%%--%%%---%%%%%---%%%%%%%%--%%%-----------------%%%----------------#---#--%%%%%%%%F%%%%%%%%%%%%%%%%%%%%%%%%%%%%%%%%%%%%%%%%%%%%%%%%
|||||||||||||%%%%%%%%%%%||||||---y-----||||--||||-------------------|||--|||---|||||---||||||||--|||-----------------|||--------%%--%%%%%---%%%||||||||%||||||||||||||||||||||||||||||||||||||||||||||||
||||||||||||||||||||||||||||||%%%%%%%%%||||--||||-------------------|||--|||%%%|||||---||||||||--|||------------y----|||--------||--|||||---||||||||||||||||||||||||||||||||||||||||||||||||||||||||||||
|||||||||||||||||||||||||||||||||||||||||||--||||XXXX---XXXXXXX--XXX|||--|||||||||||---||||||||--|||XX--XXXXXXXXXXXXX|||XXX--XXX||--|||||---||||||||||||||||||||||||||||||||||||||||||||||||||||||||||||
