HEIGHT=16;WIDTH=201;THEME=0;OVERRIDE=false
--------------------------------------------------------------------------------------------------------------------------------------------------------------------------------------------------------
--------------------------------------------------------------------------------------------------------------------------------------------------------------------------------------------------------
--------------------------------------------------------------------------------------------------------------------------------------------------------------------------------------------------------
--------------------------------------------------------------------------------------------------------------------------------------------------------------------------------------------------------
--------------------------------------------------------------------------------------------------------------------------------------------------------------------------------------------------------
--------------------------------------------------------------------------------------------------------------------------------------------------------------------------------------------------------
--------------------------------------------------------------------------------------------------------------------------------------------------------------------------------------------------------
--------------------------------------------------------------------------------------------------------------------------------------------------------------------------------------------------------
--------------------------------------------------------------------------------------------------------------------------------------------------------------------------------------------------------
-----------------------------------%%%----2S2SSSS-------------------------------------------------------------------------------------------------------------------------------------------------------
-----------------------------------|||-------------------------------------------------------------------------------------SSCSS------------------------------------------------------------------------
-----------------------S2S2--------|||------------------------------------------------------------------------------------------------------------------------------------------------------------------
-------------------------------gg--|y|-------------%%%%%%---------------------#--#----------------------------%%%%%-------------------------------------------------------------------------------------
----------------------------%%%%%%%%%%%%%%%%%%%%%%%||||||--------------------##--##---------#---#-------------|||||------------kg--------------%%%%%%%%F%%%%%%%%%%%%%%%%%%%%%%%%%%%%%%%%%%%%%%%%%%%%%%%%
%%%%%%%%%%%%%%%---%%--------|||||||||||||||||||||||||||||%%--%%%%%%%--%%%%%%%%%--%%%%-----%%%---%%%%%%%---%%%%|||||-------%%%%%%%%%%-----------||||||||%||||||||||||||||||||||||||||||||||||||||||||||||
|||||||||||||||---||XXXXXXXX|||||||||||||||||||||||||||||||--|||||||--|||||||||--||||XXXXX|||---|||||||---|||||||||XX---XX||||||||||XXXXXXXXXXX|||||||||||||||||||||||||||||||||||||||||||||||||||||||||
