HEIGHT=16;WIDTH=201;THEME=0;OVERRIDE=false
--------------------------------------------------------------------------------------------------------------------------------------------------------------------------------------------------------
--------------------------------------------------------------------------------------------------------------------------------------------------------------------------------------------------------
--------------------------------------------------------------------------------------------------------------------------------------------------------------------------------------------------------
--------------------------------------------------------------------------------------------------------------------------------------------------------------------------------------------------------
--------------------------------------------------------------------------------------------------------------------------------------------------------------------------------------------------------
--------------------------------------------------------------------------------------------------------------------------------------------------------------------------------------------------------
--------------------------------------------------------------------------------------------------------------------------------------------------------------------------------------------------------
----------------------------------------------------------------------------------------------------------------------------SS--------------------------------------------------------------------------
--------------------------------------------------------------------------------22CS2C------------------------------------------------------------------------------------------------------------------
-------------------------------%%%---------------------CCS-----------------------------------------------------------------%----------------------------------------------------------------------------
-------------------------------|||-----------------------------------------------------------------------------------------|--g-------------------------------------------------------------------------
-------------------------------|||----%%%%-------------------------------------------k-------------------------------------%%%%%%-----------------------------------------------------------------------
-------------------------------|||----||||--------------Gk----%%%--%%%%%%--%%%%%%%%%%%%%%------------------#---#-----------||||||-----------------------------------------------------------------------
------------%%%%---%%%%%%--%%--|||----||||------------%%%%----|||--||||||--||||||||||||||-----------%%%---##---##----------r|||||----------%%%%%%%%F%%%%%%%%%%%%%%%%%%%%%%%%%%%%%%%%%%%%%%%%%%%%%%%%%%%%
%%%%%%%%%%%%||||---||||||--||--|||---K|||y------g-----||||----|||--||||||--||||||||||||||-----------|||--###---###--%%%%%%%%%%%%%%%--------||||||||%||||||||||||||||||||||||||||||||||||||||||||||||||||
||||||||||||||||---||||||--||XXXXXXXXXXXXXXXXXXXXXXXXXXXXXXXXX|||--||||||--||||||||||||||XXXX---XXXX|||XXXXX---XXXXX|||||||||||||||XXX--XXX|||||||||||||||||||||||||||||||||||||||||||||||||||||||||||||
