HEIGHT=16;WIDTH=201;THEME=0;OVERRIDE=false
--------------------------------------------------------------------------------------------------------------------------------------------------------------------------------------------------------
--------------------------------------------------------------------------------------------------------------------------------------------------------------------------------------------------------
--------------------------------------------------------------------------------------------------------------------------------------------------------------------------------------------------------
--------------------------------------------------------------------------------------------------------------------------------------------------------------------------------------------------------
--------------------------------------------------------------------------------------------------------------------------------------------------------------------------------------------------------
--------------------------------------------------------------------------------------------------------------------------------------------------------------------------------------------------------
--------------------------------------------------------------------------------------------------------------------------------------------------------------------------------------------------------
--------------------------------------------------------------------------------------------------------------------------------------------------------------------------------------------------------
------------------------SSS-----------------------------------------------------------------------------------------------------------------------------------------------------------------------------
--------------------------------------------------------------------------------------------------------------------------------------------------------------------------------------------------------
--------------------------------------------------------------------------------------------------------#--#--------------------------------------------------------------------------------------------
-------------------------------------------------------#--#-----#--#-----------------------------------##--##------tt-----------------------------------------------------------------------------------
--------------------%%%%%%%%%%%%%---%%%%%-------------##--##--%%%--%%%----------------%%---%%--------%%%%--%%%%----tt--tt-----#---#--%%%%%--------------------------------------------------------------
--------------------|||||||||||||---|||||-----------%%%%--%%%%|||--|||----------%%--%%||---||--------||||--||||----tt--tt---%%%---%%%|||||--------------------------------------------------------------
------------%%%--%%%|||||||||||||---|||||%%%%---%%%%||||--|||||||--|||----------||--||||---||--------||||--||||%%%%%%%%%%%%%|||---||||||||%%%%%%%%F%%%%%%%%%%%%%%%%%%%%%%%%%%%%%%%%%%%%%%%%%%%%%%%%%%%%%
XXXXXXXXXXXX|||--||||||||||||||||---|||||||||---||||||||--|||||||--|||XXXX--XXXX||--||||---||XXX--XXX||||--||||||||||||||||||||---||||||||||||||||X|||||||||||||||||||||||||||||||||||||||||||||||||||||
