HEIGHT=16;WIDTH=201;THEME=0;OVERRIDE=false
--------------------------------------------------------------------------------------------------------------------------------------------------------------------------------------------------------
--------------------------------------------------------------------------------------------------------------------------------------------------------------------------------------------------------
--------------------------------------------------------------------------------------------------------------------------------------------------------------------------------------------------------
--------------------------------------------------------------------------------------------------------------------------------------------------------------------------------------------------------
--------------------------------------------------------------------------------------------------------------------------------------------------------------------------------------------------------
--------------------------------------------------------------------------------------------------------------------------------------------------------------------------------------------------------
--------------------------------------------------------------------------------------------------------------------------------------------------------------------------------------------------------
--------------------------------------------SS2CS2------------------------------------------------------------------------------------------------------------------------------------------------------
--------------------------------------------------------------------------------------------------------------------------------------------------------------------------------------------------------
--------------------------------------------------------------------------------------------------------------------------------------------------------------------------------------------------------
--------------------------------------------g---k-------------------------------------------------------------------------------------------------------------------------------------------------------
---------------#--#-------------------------%%%%%%--------#--#------------------------------------------------------------------------------------------------------------------------------------------
--------------##--##------------------------||||||--%%---##--##------------------------------%%---%%--------------------------tt------------------------------------------------------------------------
%%%%%%%%%%%--###--###-----------------------||||||--||--###--###-----------%%---%%-----------||---||--------------------------tt-------------%%%%%%%%F%%%%%%%%%%%%%%%%%%%%%%%%%%%%%%%%%%%%%%%%%%%%%%%%%%
|||||||||||%%%%%--%%%%%%%%%%--%%%%%-y-g-----Gg||||--||%%%%%--%%%%%%%%---%%%||---||-----------||---||-------------------y---%%%%%%%%%%--%%--%%||||||||%||||||||||||||||||||||||||||||||||||||||||||||||||
||||||||||||||||--||||||||||--|||||XXXXXXXXXXXXXXXXX|||||||--||||||||---|||||---||XXXX---XXXX||---||XXXX--XXXXXX--XXXXXXXXX||||||||||XX||--|||||||||||||||||||||||||||||||||||||||||||||||||||||||||||||
