HEIGHT=16;WIDTH=201;THEME=0;OVERRIDE=false
--------------------------------------------------------------------------------------------------------------------------------------------------------------------------------------------------------
--------------------------------------------------------------------------------------------------------------------------------------------------------------------------------------------------------
--------------------------------------------------------------------------------------------------------------------------------------------------------------------------------------------------------
--------------------------------------------------------------------------------------------------------------------------------------------------------------------------------------------------------
--------------------------------------------------------------------------------------------------------------------------------------------------------------------------------------------------------
--------------------------------------------------------------------------------------------------------------------------------------------------------------------------------------------------------
--------------------------------------------------------------------------------------------------------------------------------------------------------------------------------------------------------
---------------------------------------------------------------------------------------------------------------------------------------ky---------------------------------------------------------------
-----------------------SS2S-----------------------------------k--------------------------------------------------------------------%%%%%%---------------------------------------------------------------
-------------------------------------------------------------%%%------#---#--------------------------------------------------------||||||---------------------------------------------------------------
------------------------------------------y------------------|||-----##---##-------------------------------------------------------||||||---------------------------------------------------------------
-------------------------g--------------%%%%%%--------k-r----||r----###---###----------------------#---#---------------------------||||||---------------------------------------------------------------
--------------------%%%%%%%%%%%--%%%----||||||------%%%%%%%%%%%%%%%%%%%---%%%%%-------------------##---##-----------%%%%%%--------%%%%%%%%%%------------------------------------------------------------
--------------------|||||||||||--|||----||||||------|||||||||||||||||||---|||||------------------###---###----------||||||--------||||||||||------------------------------------------------------------
%%%%%%%%%%%%%%%%%%%%|||||||||||--|||----|||ky|------|||||||||||||||||||---|||||%%--%%----------%%%%%---%%%%%--------||||||--------||||||||||------------------------------------------------------------
|||||||||||||||||||||||||||||||--|||XXXXXXXXXXXXXXXX|||||||||||||||||||---|||||||--||XXXX--XXXX|||||---|||||XXXXXXXX||||||XXX--XXX||||||||||XXXXXXXXFXXXXXXXXXXXXXXXXXXXXXXXXXXXXXXXXXXXXXXXXXXXXXXXXXXX
