HEIGHT=16;WIDTH=201;THEME=0;OVERRIDE=false
--------------------------------------------------------------------------------------------------------------------------------------------------------------------------------------------------------
--------------------------------------------------------------------------------------------------------------------------------------------------------------------------------------------------------
--------------------------------------------------------------------------------------------------------------------------------------------------------------------------------------------------------
--------------------------------------------------------------------------------------------------------------------------------------------------------------------------------------------------------
--------------------------------------------------------------------------------------------------------------------------------------------------------------------------------------------------------
--------------------------------------------------------------------------------------------------------------------------------------------------------------------------------------------------------
--------------------------------------------------------------------------------------------------------------------------------------------------------------------------------------------------------
--------------------------------------------------------------------------------------------------------------------------------------------------------------------------------------------------------
----------------------------------------------------------------------------------------------------------------------------------22SS------------------------------------------------------------------
-----------222C2CS--------------------------------------------------------------------------------------------------------------------------------------------------------------------------------------
--------------------------------------------------------------------------------------------------------------------------------------------------------------------------------------------------------
--------------------------------------Tt--Tt-Tt-----------SU2S---------------------CCUSSCS--------------#--#-----------------------r--------------------------------------------------------------------
-------------g-r----------------------tt--tt-tt-------------------rg-----------------------------------##--##------------------%%%%%%%%%%%--------------------------------------------------------------
%%%%%%%%%%%%%%%%%%%------------------%%%%%%%%%%%---------------%%%%%%%-------------------------------%%%%--%%%%----------#--#--|||||||||||--------------------------------------------------------------
|||||||||||||||||||%%%--%%%----------|||||||||||%%---%%-----g--|||||||---------------------%%%%--%%%%||||--||||%%%--%%%%%%--%%%|||||||||||%%%%%%%%F%%%%%%%%%%%%%%%%%%%%%%%%%%%%%%%%%%%%%%%%%%%%%%%%%%%%%
||||||||||||||||||||||--|||XXXX--XXXX|||||||||||||---||XXXXXXXX|||||||XXXX---XXXXXXXXXXXXXX||||--||||||||--|||||||--||||||--||||||||||||||||||||||X|||||||||||||||||||||||||||||||||||||||||||||||||||||
