HEIGHT=16;WIDTH=201;THEME=0;OVERRIDE=false
--------------------------------------------------------------------------------------------------------------------------------------------------------------------------------------------------------
--------------------------------------------------------------------------------------------------------------------------------------------------------------------------------------------------------
--------------------------------------------------------------------------------------------------------------------------------------------------------------------------------------------------------
--------------------------------------------------------------------------------------------------------------------------------------------------------------------------------------------------------
--------------------------------------------------------------------------------------------------------------------------------------------------------------------------------------------------------
--------------------------------------------------------------------------------------------------------------------------------------------------------------------------------------------------------
--------------------------------------------------------------------------------------------------------------------------------------------------------------------------------------------------------
--------------------------------------------------------------------------------------------------------------------------------------------------------------------------------------------------------
--------------------------------------------------------------------------------------------------------------------------------------------------------------------------------------------------------
--------------------------------------------------------------------------------------------------------------------------------------------------------------------------------------------------------
--------------------------------------------------------------------------------------------------------------------------------------------------------------------------------------------------------
-----------------------SCCSCS----------------------------#--#-------------------------------------------------------------------------------------------------------------------------------------------
%%%%%%%%%%%%%%------------------------%%---%%----------%%%--%%%------%%---%%----------------------------------------------------------------------------------------------------------------------------
||||||||||||||------------------------||---||----------|||--|||------||---||%%%%%--%%%%%---------%%---%%---------------#--#---%%%%%---%%%%%-------------------------------------------------------------
||||||||||||||--#--#------y-----------||---||%%%%--%%%%|||--|||------||---|||||||--|||||%%%---%%%||---||%%%%%--%%%%%--##--##--|||||---|||||-------------------------------------------------------------
||||||||||||||XXX--XXXXXXXXXXXXXXXXXXX||---||||||--|||||||--|||XX--XX||---|||||||--||||||||---|||||---|||||||--|||||XXXX--XXXX|||||---|||||XXXXXXXXFXXXXXXXXXXXXXXXXXXXXXXXXXXXXXXXXXXXXXXXXXXXXXXXXXXXX
