HEIGHT=16;WIDTH=201;THEME=0;OVERRIDE=false
--------------------------------------------------------------------------------------------------------------------------------------------------------------------------------------------------------
--------------------------------------------------------------------------------------------------------------------------------------------------------------------------------------------------------
--------------------------------------------------------------------------------------------------------------------------------------------------------------------------------------------------------
--------------------------------------------------------------------------------------------------------------------------------------------------------------------------------------------------------
--------------------------------------------------------------------------------------------------------------------------------------------------------------------------------------------------------
--------------------------------------------------------------------------------------------------------------------------------------------------------------------------------------------------------
--------------------------------------------------------------------------------------------------------------------------------------------------------------------------------------------------------
--------------------------------------------------------------------------------------------------------------------------------------------------------------------------------------------------------
--------------------------------------------------------------------------------------------------------------------------------------------------------------------------------------------------------
-----------------------------------------------------------------S2S------------------------------------------------------------------------------------------------------------------------------------
------------------------------------------------------------------------------------------------------------------------------Tt------------------------------------------------------------------------
-----------------------SCS--------------------SC-S2CSSS-----------------------k-----------------------------------------tt----tt------------------------------------------------------------------------
%%%%%%%%%%%-------------------------------------------------------------------%%%----------%%%%%%%%%%---%%%%%-----------tt----tt--------#--#------------------------------------------------------------
|||||||||||%%%%---%%%%----%-----------#---#-----%-------%%---%%%%%%%%%%%------|||----------||||||||||---|||||---#--#---%%%%%%%%%%%%%---##--##-----------------------------------------------------------
|||||||||||||||---||||----|---#--#--%%%---%%%---|-------||---|||||||||||---y--kr|-r---k----||||||||||---|||||--##--##--|||||||||||||--###--###--%%%%%%%%F%%%%%%%%%%%%%%%%%%%%%%%%%%%%%%%%%%%%%%%%%%%%%%%
|||||||||||||||---||||XXXXXXXXX--XXX|||---|||XXXXXXXXXXX||---|||||||||||XXXXXXXXXXXXXXXXXXX||||||||||---|||||XXXX--XXXX|||||||||||||XXXXX--XXXXX||||||||X|||||||||||||||||||||||||||||||||||||||||||||||
