HEIGHT=16;WIDTH=201;THEME=0;OVERRIDE=false
--------------------------------------------------------------------------------------------------------------------------------------------------------------------------------------------------------
--------------------------------------------------------------------------------------------------------------------------------------------------------------------------------------------------------
--------------------------------------------------------------------------------------------------------------------------------------------------------------------------------------------------------
--------------------------------------------------------------------------------------------------------------------------------------------------------------------------------------------------------
--------------------------------------------------------------------------------------------------------------------------------------------------------------------------------------------------------
--------------------------------------------------------------------------------------------------------------------------------------------------------------------------------------------------------
--------------------------------------------------------------------------------------------------------------------------------------------------------------------------------------------------------
------------------------------------------------------------------------------------------------------------------------------r-------------------------------------------------------------------------
------------------------------------------------------------------------------------------------------------------------------%%%%%---------------------------------------------------------------------
------------------------------------------------------------------------------------------------------------------------------|||||---------------------------------------------------------------------
---------------------------------------------------------------tt-tt----------------------------------------------------------|||||---------------------------------------------------------------------
-----------------------------#---#-----------------------------tt-tt----------------------------------------------------------|||||---------------------------------------------------------------------
----------------------------##---##--%%--%%%%%%%%%%%%%%%---%%%-tt-tt-----------------------------#---#----------------%%%%%%%%%%%%%%%%------------------------------------------------------------------
%%%%%%%%%%%%%-------------%%%%---%%%%||--|||||||||||||||---|||%%%%%%%---------#---#-----#--#----##---##--------%%---%%||||||||||||||||------------------------------------------------------------------
|||||||||||||-------------||||---||||||--|||||||||||||||---||||||||||%%--%%--##---##--%%%--%%%%%%%---%%%%%%--%%||---||||||||||||||||||%%%---------------------------------------------------------------
|||||||||||||XXXXX---XXXXX||||---||||||--|||||||||||||||---||||||||||||--||XXXX---XXXX|||--|||||||---||||||--||||---|||||||||||||||||||||XXXXXXXXFXXXXXXXXXXXXXXXXXXXXXXXXXXXXXXXXXXXXXXXXXXXXXXXXXXXXXX
