HEIGHT=16;WIDTH=201;THEME=0;OVERRIDE=false
--------------------------------------------------------------------------------------------------------------------------------------------------------------------------------------------------------
--------------------------------------------------------------------------------------------------------------------------------------------------------------------------------------------------------
--------------------------------------------------------------------------------------------------------------------------------------------------------------------------------------------------------
--------------------------------------------------------------------------------------------------------------------------------------------------------------------------------------------------------
--------------------------------------------------------------------------------------------------------------------------------------------------------------------------------------------------------
-----------------------------------------------------------------------------------------------------------------------%%%%-----------------------------------------------------------------------------
-----------------------------------------------------------------------------------------------------------------------||||-----------------------------------------------------------------------------
-------------------------------------------------------------------------------------------------------------------%%%%%%%|-----------------------------------------------------------------------------
-------------------------------------------------------------------------------------------------------------------||||||||-----------------------------------------------------------------------------
-------------------------------------------------------------------------------------------------------------------||%%%%||-----------------------------------------------------------------------------
-----------------------------------------------------------------2SCC----------------------------------------------||||||||-----------------------------------------------------------------------------
-----------------SSCS2---------------------------------------------------------------------------------------------||||||||-----------------------------------------------------------------------------
----------------------------------------------------------------------------------------------------------%%---%%-g|y|G||||--%%%%%---%%%%%%%%%%%%%F%%%%%%%%%%%%%%%%%%%%%%%%%%%%%%%%%%%%%%%%%%%%%%%%%%%%%
%%%%%%%%%%%%%%---------------%%%%%---%%%%%-----------%%%%---%%%%-y-Y-y-%%%---%%%--------------------#--#--||---||%%%%%%%%%%%%|||||---|||||||||||||%|||||||||||||||||||||||||||||||||||||||||||||||||||||
||||||||||||||----------%%%%%|||||---|||||-K-----%%%%||||---||||%%%%%%%|||---|||%%%%--%%%%%%--%%%%%%%--%%%||---|||||||||||||||||||---|||||||||||||||||||||||||||||||||||||||||||||||||||||||||||||||||||
||||||||||||||XXXXXXXXXX||||||||||---|||||XXXXXXX||||||||---||||||||||||||---|||||||--||||||--|||||||--|||||---|||||||||||||||||||---|||||||||||||||||||||||||||||||||||||||||||||||||||||||||||||||||||
