HEIGHT=16;WIDTH=201;THEME=0;OVERRIDE=false
--------------------------------------------------------------------------------------------------------------------------------------------------------------------------------------------------------
--------------------------------------------------------------------------------------------------------------------------------------------------------------------------------------------------------
--------------------------------------------------------------------------------------------------------------------------------------------------------------------------------------------------------
--------------------------------------------------------------------------------------------------------------------------------------------------------------------------------------------------------
--------------------------------------------------------------------------------------------------------------------------------------------------------------------------------------------------------
--------------------------------------------------------------------------------------------------------------------------------------------------------------------------------------------------------
--------------------------------------------------------------------------------------------------------------------------------------------------------------------------------------------------------
--------------------------------------------------------------------------------------------------------------------------------------------------------------------------------------------------------
--------------------------------------------------------------------------------------------------------------------------------------------------------------------------------------------------------
------------------------------------------g--------------------------------#---#------------------------------------------------------------------------------------------------------------------------
---------------------------------------%%%%%%%----------------------------##---##-----------------------------------------------------------------------------------------------------------------------
---------------------------------------|||||||---------------------------###---###----------------------------------------------------------------------------------------------------------------------
------------%%%%---%%%%----------------|||||||-------------------------%%%%%---%%%%%%%%---------------------------------#--#----------------------------------------------------------------------------
------------||||---||||-------------%%%%%%%%%%%%%----------------------|||||---||||||||---------------%%%%----%%--%%---##--##----------------%%%%%%%%F%%%%%%%%%%%%%%%%%%%%%%%%%%%%%%%%%%%%%%%%%%%%%%%%%%
%%%%%%%%%%%%||||---||||%%%%%---%%%%%|||||||||||||--------------%%%--%%%|||||---||||||||----%%%%---%%%%||||----||--||--###--###--%%%%%---%%%%%||||||||%||||||||||||||||||||||||||||||||||||||||||||||||||
||||||||||||||||---|||||||||---||||||||||||||||||XXX--XXXXX--XX|||--||||||||---||||||||XXXX||||---||||||||XXXX||--||XXXXX--XXXXX|||||---||||||||||||||||||||||||||||||||||||||||||||||||||||||||||||||||
