HEIGHT=16;WIDTH=201;THEME=0;OVERRIDE=false
--------------------------------------------------------------------------------------------------------------------------------------------------------------------------------------------------------
--------------------------------------------------------------------------------------------------------------------------------------------------------------------------------------------------------
--------------------------------------------------------------------------------------------------------------------------------------------------------------------------------------------------------
--------------------------------------------------------------------------------------------------------------------------------------------------------------------------------------------------------
--------------------------------------------------------------------------------------------------------------------------------------------------------------------------------------------------------
--------------------------------------------------------------------------------------------------------------------------------------------------------------------------------------------------------
--------------------------------------------------------------------------------------------------------------------------------------------------------------------------------------------------------
--------------------------------------------------------------------------------------------------------------------------------------------------------------------------------------------------------
--------------------------------------------------------------------------------------------------------------------------------------------------------------------------------------------------------
--------------------------------------------------g-r-----------#--#------------------------------------------------------------------------------------------------------------------------------------
--------------------------------------------------%%%%---------##--##--------------------------------------------------CSU------------------------------------------------------------------------------
-----------------------------%%%-----------------g||||--------###--###-------------------------------------tt-------------------------------------------------------------------------------------------
%%%%%%%%%%------------#--#---||g----kr--------%%%%%%%%%%%%%%%%%%%--%%%%%%%%%---%%%%-------------------tt---tt-------------------------------------------------------------------------------------------
||||||||||%%%%%%--%%%%%--%%%%%%%%%%%%%%%%%%%%%|||||||||||||||||||--|||||||||---||||-------------------tt---tt--%%%%%%------k-%%%%%%%%---%%%%%%%%%%%%F%%%%%%%%%%%%%%%%%%%%%%%%%%%%%%%%%%%%%%%%%%%%%%%%%%%
||||||||||||||||--|||||--||||||||||||||||||||||||||||||||||||||||--|||||||||---||||------------------%%%%%%%%%%||||||%%%%%%%%||||||||---||||||||||||%|||||||||||||||||||||||||||||||||||||||||||||||||||
||||||||||||||||--|||||--||||||||||||||||||||||||||||||||||||||||--|||||||||---||||XXXXX--XXXXXXXXXXX||||||||||||||||||||||||||||||||---||||||||||||||||||||||||||||||||||||||||||||||||||||||||||||||||
