HEIGHT=16;WIDTH=201;THEME=0;OVERRIDE=false
--------------------------------------------------------------------------------------------------------------------------------------------------------------------------------------------------------
--------------------------------------------------------------------------------------------------------------------------------------------------------------------------------------------------------
--------------------------------------------------------------------------------------------------------------------------------------------------------------------------------------------------------
--------------------------------------------------------------------------------------------------------------------------------------------------------------------------------------------------------
--------------------------------------------------------------------------------------------------------------------------------------------------------------------------------------------------------
--------------------------------------------------------------------------------------------------------------------------------------------------------------------------------------------------------
--------------------------------------------------------------------------------------------------------------------------------------------------------------------------------------------------------
--------------------------------------------------------------------------------------------------------------------------------------------------------------------------------------------------------
--------------------------------------------------------------------------------------------------------------------------------------------------------------------------------------------------------
------------------------------------------------------------------------------2CSC----------------------------------------------------------------------------------------------------------------------
--------------------------------------------------------------------------------------------------------------------------------------------------------------------------------------------------------
----------------------------------------tt-----------------------------------------------------------#---#--------------------------y-------------------------------------------------------------------
----------------------------------------tt--------------%%%%%--%%%%%--#---#-------------------------##---##------------------------%%%%%%%--------------------------------------------------------------
%%%%%%%%%%------------%%%%%--%%%%%%%%%%%%%%%%%----------|||||--|||||%%%---%%%%%%%%%%%%-------------###---###-----------------------|||||||--------------------------------------------------------------
||||||||||%%%%%--%%%%%|||||--|||||||||||||||||%%%%--%%%%|||||--||||||||---||||||||||||-----------%%%%%---%%%%%---------%%%%%--%%%%%|||||||--------------------------------------------------------------
|||||||||||||||--||||||||||--|||||||||||||||||||||--|||||||||--||||||||---||||||||||||XXXX---XXXX|||||---|||||XXX---XXX|||||--||||||||||||XXXXXXXXFXXXXXXXXXXXXXXXXXXXXXXXXXXXXXXXXXXXXXXXXXXXXXXXXXXXXX
