HEIGHT=16;WIDTH=201;THEME=0;OVERRIDE=false
--------------------------------------------------------------------------------------------------------------------------------------------------------------------------------------------------------
--------------------------------------------------------------------------------------------------------------------------------------------------------------------------------------------------------
--------------------------------------------------------------------------------------------------------------------------------------------------------------------------------------------------------
--------------------------------------------------------------------------------------------------------------------------------------------------------------------------------------------------------
--------------------------------------------------------------------------------------------------------------------------------------------------------------------------------------------------------
--------------------------------------------------------------------------------------------------------------------------------------------------------------------------------------------------------
--------------------------------------------------------------------------------------------------------------------------------------------------------------------------------------------------------
--------------------------------------------------------------------------------------------------------------------------------------------------------------------------------------------------------
---------------US2--------------------------------------------------------------------------------------------------------------------------------------------------------------------------------------
-------------------------------------------------------------------------------------------------------------------------------#--#---------------------------------------------------------------------
-----------------------------------------------------------SSSSC--------------------------------------------------SUS---------##--##--------------------------------------------------------------------
---------------k-------------------------------------------------------------------------------------------------------------###--###-------------------------------------------------------------------
------------%%%%%%%%%%%%---%%-------------------%%%---%%%---------------------------------------------tt--tt---------------%%%%%--%%%%%-----------------------------------------------------------------
------------||||||||||||---||-------------------|||---|||--------g------------------------------------tt--tt-----------r-%%|||||--|||||%%%%---%%%%------------------------------------------------------
%%%%%%%%%%%%||||||||||||---||%%%%--%%%%--%%---%%|||---|||%%%%%%%%%%%%%%%%---%%%%%---------------------tt--tt---%%%%%%%%%%|||||||--|||||||||---||||%%%%%%%%F%%%%%%%%%%%%%%%%%%%%%%%%%%%%%%%%%%%%%%%%%%%%%
||||||||||||||||||||||||---||||||--||||XX||---|||||---|||||||||||||||||||---|||||XXXX--XXXXXXX---XXXXXXXXXXXXXX|||||||||||||||||--|||||||||---||||||||||||X|||||||||||||||||||||||||||||||||||||||||||||
