HEIGHT=16;WIDTH=201;THEME=0;OVERRIDE=false
--------------------------------------------------------------------------------------------------------------------------------------------------------------------------------------------------------
--------------------------------------------------------------------------------------------------------------------------------------------------------------------------------------------------------
--------------------------------------------------------------------------------------------------------------------------------------------------------------------------------------------------------
--------------------------------------------------------------------------------------------------------------------------------------------------------------------------------------------------------
--------------------------------------------------------------------------------------------------------------------------------------------------------------------------------------------------------
--------------------------------------------------------------------------------------------------------------------------------------------------------------------------------------------------------
--------------------------------------------------------------------------------------------------------------------------------------------------------------------------------------------------------
--------------------------------------------------------------------------------------------------------------------------------------------------------------------------------------------------------
----------------------SCS--------------------------------------------y----------------------------------------------------------------------------------------------------------------------------------
---------------------------------------------------------------------%%%%%%------------------------------------------------------------%%%%-------------------------------------------------------------
---------------------------------------------------------------------||||||--------------------------------------%%%%%----SU2SS--------||||-------------------------------------------------------------
---------------------------------------------------------------------||r|||--r-----------------------------------|||||-----------------||||-------------------------------------------------------------
-------------%%%--%%%%%%%%%---------------------------------------%%%%%%%%%%%%%%%--------------------------------|||||-------------%%%%%%%%%%%%%%%%%%F%%%%%%%%%%%%%%%%%%%%%%%%%%%%%%%%%%%%%%%%%%%%%%%%%%
%%%%%%%%%%%%%|||--|||||||||---g---------------------------%%%--%%%|||||||||||||||------------------------------kk|g|||----------g--||||||||||||||||||%||||||||||||||||||||||||||||||||||||||||||||||||||
||||||||||||||||--|||||||||%%%%%%-------------------------|||--||||||||||||||||||-----------------y----------%%%%%%%%%%%%%%%%%%%%%%|||||||||||||||||||||||||||||||||||||||||||||||||||||||||||||||||||||
||||||||||||||||--|||||||||||||||XXXXXXXXXXXX--XXXXXX---XX|||--||||||||||||||||||XXXXX--XXXXXXXXXXXXXXX---XXX|||||||||||||||||||||||||||||||||||||||||||||||||||||||||||||||||||||||||||||||||||||||||||
