HEIGHT=16;WIDTH=201;THEME=0;OVERRIDE=false
--------------------------------------------------------------------------------------------------------------------------------------------------------------------------------------------------------
--------------------------------------------------------------------------------------------------------------------------------------------------------------------------------------------------------
--------------------------------------------------------------------------------------------------------------------------------------------------------------------------------------------------------
--------------------------------------------------------------------------------------------------------------------------------------------------------------------------------------------------------
--------------------------------------------------------------------------------------------------------------------------------------------------------------------------------------------------------
--------------------------------------------------------------------------------------------------------------------------------------------------------------------------------------------------------
--------------------------------------------------------------------------------------------------------------------------------------------------------------------------------------------------------
--------------------------------------------------------------------------------------------------------------------------------------------------------------------------------------------------------
--------------------------------------------------------------------------------------------------------------------------------------------------------------------------------------------------------
--------------------------------------------------------------------------------------------------------------------------------------------------------------------------------------------------------
-------------------------------------------------------------------#--#---------------------------------------------------------------------------------------------------------------------------------
----------------------------S2S-----------------------------------##--##-------------#---#--------------------------------------------------------------------------------------------------------------
---------------------%%%%%----------------------%%--%%----------%%%%--%%%%----------##---##----------------------------tt-Tt-----#--#-----#---#---------------------------------------------------------
-------------%%%--%%%|||||--------%%---%%-------||--||----------||||--||||%%---%%--###---###--------%%%%%--------------tt-tt---%%%--%%%--##---##--%%%%%%%%F%%%%%%%%%%%%%%%%%%%%%%%%%%%%%%%%%%%%%%%%%%%%%
%%%%%%%%%%%%%|||--||||||||-kr-----||---||%%---%%||--||----------||||--||||||---||%%%%%---%%%%%%%--%%|||||%%%%--%%%%%%%%%%%%%%%%|||--|||%%%%---%%%%||||||||%|||||||||||||||||||||||||||||||||||||||||||||
||||||||||||||||--||||||||XXXXXXXX||---||||---||||--||XXXX--XXXX||||--||||||---|||||||---|||||||--|||||||||||--|||||||||||||||||||--|||||||---||||||||||||||||||||||||||||||||||||||||||||||||||||||||||
