HEIGHT=16;WIDTH=201;THEME=0;OVERRIDE=false
--------------------------------------------------------------------------------------------------------------------------------------------------------------------------------------------------------
--------------------------------------------------------------------------------------------------------------------------------------------------------------------------------------------------------
--------------------------------------------------------------------------------------------------------------------------------------------------------------------------------------------------------
--------------------------------------------------------------------------------------------------------------------------------------------------------------------------------------------------------
--------------------------------------------------------------------------------------------------------------------------------------------------------------------------------------------------------
--------------------------------------------------------------------------------------------------------------------------------------------------------------------------------------------------------
--------------------------------------------------------------------------------------------------------------------------------------------------------------------------------------------------------
--------------------------------------------------------------------------------------------------------------------------------------------------------------------------------------------------------
--------------------------------------------------------------------------------------------------------------------------------------------------------------------------------------------------------
-----------------------------------------------------------------------------------------------------------#--#-----------------------------------------------------------------------------------------
--------------------------------------------------------------------------------------------#---#---------##--##--------%%%%%%--------------------------------------------------------------------------
-------------------------------------------------------------------------#--#--------------##---##-------###--###-------||||||--------------------------------------------------------------------------
-----------------------------%%--%%---------%%---%%--------------------%%%--%%%-----------###---###--%%%%%%%--%%%%%-----||||||----%%%%%--%%%%%%%%%%%%%F%%%%%%%%%%%%%%%%%%%%%%%%%%%%%%%%%%%%%%%%%%%%%%%%%
------------%%--%%---#---#---||--||%%---%%--||---||%%%---%%%-------%%%%|||--|||--#---#--%%%%%---%%%%%|||||||--|||||-----||||||--r-|||||--|||||||||||||%|||||||||||||||||||||||||||||||||||||||||||||||||
%%%%%%%%%%%%||--||--##---##--||--||||---||--||---|||||---|||-------|||||||--|||%%%---%%%|||||---||||||||||||--|||||%%%%%%%%%%%%%%%|||||--|||||||||||||||||||||||||||||||||||||||||||||||||||||||||||||||
||||||||||||||--||XXXX---XXXX||--||||---||XX||---|||||---|||XX---XX|||||||--||||||---||||||||---||||||||||||--|||||||||||||||||||||||||--|||||||||||||||||||||||||||||||||||||||||||||||||||||||||||||||
