HEIGHT=16;WIDTH=201;THEME=0;OVERRIDE=false
--------------------------------------------------------------------------------------------------------------------------------------------------------------------------------------------------------
--------------------------------------------------------------------------------------------------------------------------------------------------------------------------------------------------------
--------------------------------------------------------------------------------------------------------------------------------------------------------------------------------------------------------
--------------------------------------------------------------------------------------------------------------------------------------------------------------------------------------------------------
--------------------------------------------------------------------------------------------------------------------------------------------------------------------------------------------------------
--------------------------------------------------------------------------------------------------------------------------------------------------------------------------------------------------------
--------------------------------------------------------------------------------------------------------------------------------------------------------------------------------------------------------
----------------------------------------------------%%%%%%%---------------------------------------------------------------------------------------------------------------------------------------------
--------------%%%%%%--------------------------------|||||||---------------------------------------------------------------------------------------------------------------------------------------------
--------------||||||--------------------------------||y||||---------------------------------------------------------------------------------------------------------------------------------------------
--------------||||||--------------------------------||%%%||--------------------------------------------------%%%%%%%------------------------------------------------------------------------------------
--------------|%%%%|--------------------------------|||||||--------------------------------------------------|||||||------------------------------------------------------------------------------------
--------------||||||--------------------------------|K|||||--%%%%%%------%%%%%--%%%%%---%%%%%----------------|||||||------------------------------------------------------------------------------------
%%%%%%%%%%%%--||||||-------------%%---%%-----------%%%%%%%%%%||||||------|||||--|||||---|||||%%%%%--%%%%%--g-|||k|||----------------%%%--%%%------------------------------------------------------------
||||||||||||--||||||-----------g-||---||-----------||||||||||||||||------||ry|--|||||---||||||||||--|||||%%%%%%%%%%%%%%%%%%%%%--%%%%|||--|||%%%%%%%%F%%%%%%%%%%%%%%%%%%%%%%%%%%%%%%%%%%%%%%%%%%%%%%%%%%%
||||||||||||XXXXXXXXXXXXXXXXXXXXX||---||XXXX---XXXX||||||||||||||||XXXXXXXXXXXXX|||||---||||||||||--||||||||||||||||||||||||||--|||||||--|||||||||||X|||||||||||||||||||||||||||||||||||||||||||||||||||
