HEIGHT=16;WIDTH=201;THEME=0;OVERRIDE=false
--------------------------------------------------------------------------------------------------------------------------------------------------------------------------------------------------------
--------------------------------------------------------------------------------------------------------------------------------------------------------------------------------------------------------
--------------------------------------------------------------------------------------------------------------------------------------------------------------------------------------------------------
--------------------------------------------------------------------------------------------------------------------------------------------------------------------------------------------------------
--------------------------------------------------------------------------------------------------------------------------------------------------------------------------------------------------------
--------------------------------------------------------------------------------------------------------------------------------------------------------------------------------------------------------
--------------------------------------------------------------------------------------------------------------------------------------------------------------------------------------------------------
--------------------------------------------------------------------------------------------------------------------------------------------------------------------------------------------------------
--------------------------------------------------------------------------------------------------------------------------------------------------------------------------------------------------------
---------------------------------------------------------------SSUS-------------------------------------------------------------------------------------------------------------------------------------
---------------------------------------------------------------------SSS2--------------------------------K----------------------------------------------------------------------------------------------
------------------------------------------------%%%%------------------------------------------------%%%%%%-------#--#-----------------------------------------------------------------------------------
------------y-k-%%%%%--%%%%%-----------------g--||||------------------------------------------------||||||-----%%%--%%%---#--#-----#--#-----------------------------------------------------------------
----------%%%%%%|||||--|||||------------%%%%%%%%%%%%%%%------%%%%%%%-------k------------------------g|||k|---r-|||--|||--##--##--%%%--%%%---------------------------------------------------------------
----------|||||||||||--|||||%%%%%-------|||||||||||||||%%--%%|||||||%%%%%%%%%-----%%%%%--%%%%%%%%%%%%%%%%%%%%%%|||--|||%%%%--%%%%|||--|||%%%%%%%%F%%%%%%%%%%%%%%%%%%%%%%%%%%%%%%%%%%%%%%%%%%%%%%%%%%%%%%
XXXXXXXXXX|||||||||||--||||||||||XX---XX|||||||||||||||||--||||||||||||||||||XXXXX|||||--|||||||||||||||||||||||||--|||||||--|||||||--|||||||||||X||||||||||||||||||||||||||||||||||||||||||||||||||||||
