HEIGHT=16;WIDTH=201;THEME=0;OVERRIDE=false
--------------------------------------------------------------------------------------------------------------------------------------------------------------------------------------------------------
--------------------------------------------------------------------------------------------------------------------------------------------------------------------------------------------------------
--------------------------------------------------------------------------------------------------------------------------------------------------------------------------------------------------------
--------------------------------------------------------------------------------------------------------------------------------------------------------------------------------------------------------
--------------------------------------------------------------------------------------------------------------------------------------------------------------------------------------------------------
--------------------------------------------------------------------------------------------------------------------------------------------------------------------------------------------------------
--------------------------------------------------------------------------------------------------------------------------------------------------------------------------------------------------------
-----------------------------------------------------------------------------------------------------------------------%%%%%----------------------------------------------------------------------------
-----------------------------------------------------------------------------------------------------------------------|||||----------------------------------------------------------------------------
-----------------------------------------------------------------------------------------------------------------------|||||---k------------------------------------------------------------------------
----------------------------------------------------------------------------------------------------------SSUCCC-------|||%%%%%%%-----------------------------------------------------------------------
-----------------------------------------------------------------------------------------------------------------------|||k||||||K----------------------------------------------------------------------
--------------------------%%%%%--%%%%%-----%%-----------------------%%%%%---%%%%%----#--#---------------------------%%%%%%%%%%%%%%%%---------%%%%%%%%F%%%%%%%%%%%%%%%%%%%%%%%%%%%%%%%%%%%%%%%%%%%%%%%%%%
--------------------------|||||--|||||-----||%%%%%--%%%%%%%%%%%%%%%%|||||---|||||---##--##--------------------r-----||||||||||||||||---------||||||||%||||||||||||||||||||||||||||||||||||||||||||||||||
%%%%%%%%%%%%%%------------|||||--|||||%%%%%|||||||--|||||||||||||||||||||---|||||--###--###--%%%%%--%%%%%%%%%%%%%%--||||||||||||||||---------|||||||||||||||||||||||||||||||||||||||||||||||||||||||||||
||||||||||||||XXXXX--XXXXX|||||--|||||||||||||||||--|||||||||||||||||||||---|||||XXXXX--XXXXX|||||--||||||||||||||XX||||||||||||||||XXX---XXX|||||||||||||||||||||||||||||||||||||||||||||||||||||||||||
