HEIGHT=16;WIDTH=201;THEME=0;OVERRIDE=false
--------------------------------------------------------------------------------------------------------------------------------------------------------------------------------------------------------
--------------------------------------------------------------------------------------------------------------------------------------------------------------------------------------------------------
--------------------------------------------------------------------------------------------------------------------------------------------------------------------------------------------------------
--------------------------------------------------------------------------------------------------------------------------------------------------------------------------------------------------------
--------------------------------------------------------------------------------------------------------------------------------------------------------------------------------------------------------
--------------------------------------------------------------------------------------------------------------------------------------------------------------------------------------------------------
--------------------------------------------------------------------------------------------------------------------------------------------------------------------------------------------------------
--------------------------------------------------------------------------------------------------------------------------------------------------------------------------------------------------------
--------------------------------------------------------------------------------------------------------------------------------------------------------------------------------------------------------
---------------------------------------------------------------------------------------------------------------------S2S2-------------------------------------------------------------------------------
------------------------------------------------------------------------------------#---#---------------------------------------------------------------------------------------------------------------
-------------SCSS------------------------------------------------------------------##---##--------------------------------------------------------------------------------------------------------------
-------------------------------------r-----------------------%%%%%%--------------%%%%---%%%%--------------k-----------g-----%%-------------%%%%%%%%F%%%%%%%%%%%%%%%%%%%%%%%%%%%%%%%%%%%%%%%%%%%%%%%%%%%%
------------------------------------%%%%%%%%%--%%%-----------||||yr-g---g-%%---%%||||---||||---------%%%%%%%-------%%%%%%%%%||-------------||||||||%||||||||||||||||||||||||||||||||||||||||||||||||||||
%%%%%%%%%%%%------------------%%--%%|||||||||--|||----------%%%%%%%%%%%%%%||---||||||---||||%%%---%%%|||||||-------|||||||||||------%%---%%|||||||||||||||||||||||||||||||||||||||||||||||||||||||||||||
||||||||||||XXXXXXXXXXXX---XXX||--|||||||||||--|||XXXX--XXXX||||||||||||||||---||||||---|||||||---||||||||||XX---XX|||||||||||XX--XX||---|||||||||||||||||||||||||||||||||||||||||||||||||||||||||||||||
