HEIGHT=16;WIDTH=201;THEME=0;OVERRIDE=false
--------------------------------------------------------------------------------------------------------------------------------------------------------------------------------------------------------
--------------------------------------------------------------------------------------------------------------------------------------------------------------------------------------------------------
--------------------------------------------------------------------------------------------------------------------------------------------------------------------------------------------------------
--------------------------------------------------------------------------------------------------------------------------------------------------------------------------------------------------------
--------------------------------------------------------------------------------------------------------------------------------------------------------------------------------------------------------
--------------------------------------------------------------------------------------------------------------------------------------------------------------------------------------------------------
--------------------------------------------------------------------------------------------------------------------------------------------------------------------------------------------------------
------------------------------------S2CC----------------------------------------------------------------------------------------------------------------------------------------------------------------
--------------------------------------------------------------------------------------------------------------------------------------------------------------------------------------------------------
----------------------------------------------SSSSSSS---------------------------------------------------------------------------#--#--------------------------------------------------------------------
------------------------------------k-K----------------------------------------------------------------------------------------##--##-------------------------------------------------------------------
------------------------------------%%%%%%------------------y-----------------------------------------------------------------###--###------------------------------------------------------------------
%%%%%%%%%%%%%%%%--%%%%%--%%%--------||||||---------r-----%%%%-------------------------------------%%%%%---%%%%%-----#---#---%%%%%--%%%%%----------------------------------------------------------------
||||||||||||||||--|||||--|||--------|g|rg|---%%%%%%%%%%%-||||-------------------------------------|||||---|||||%%--##---##--|||||--|||||----------------------------------------------------------------
||||||||||||||||--|||||--|||%%---%%%%%%%%%%%%|||||||||||-||||------y-%%--%%-----------%%%%%--%%%%%|||||---|||||||%%%%---%%%%|||||--|||||----------------------------------------------------------------
||||||||||||||||--|||||--|||||---|||||||||||||||||||||||XXXXXXXXXXXXX||--||XXXX---XXXX|||||--||||||||||---|||||||||||---|||||||||--|||||XXXXXXXXFXXXXXXXXXXXXXXXXXXXXXXXXXXXXXXXXXXXXXXXXXXXXXXXXXXXXXXX
