HEIGHT=16;WIDTH=201;THEME=0;OVERRIDE=false
--------------------------------------------------------------------------------------------------------------------------------------------------------------------------------------------------------
--------------------------------------------------------------------------------------------------------------------------------------------------------------------------------------------------------
--------------------------------------------------------------------------------------------------------------------------------------------------------------------------------------------------------
--------------------------------------------------------------------------------------------------------------------------------------------------------------------------------------------------------
--------------------------------------------------------------------------------------------------------------------------------------------------------------------------------------------------------
--------------------------------------------------------------------------------------------------------------------------------------------------------------------------------------------------------
--------------------------------------------------------------------------------------------------------------------------------------------------------------------------------------------------------
--------------------------------------------------------------------------------------------------------------------------------------------------------------------------------------------------------
--------------------------------%%%%%%%-----------------------------------------------------------------------------------------------------------------------------------------------------------------
--------------------------------|||||||-----------------------------------------------------------------------------------------------------------------------------------------------------------------
--------------------------------|||||||--------------------------------------#---#----------------------------------------------------------------------------------------------------------------------
--------------------------ky----|||||||g------------------------------------##---##----------------------------------r----------------------------------------------------------------------------------
----------------------%%%%%%%%%%%%%%%%%%%----------------------------------###---###-----------%%%%--%%%%-------%%%%%%------------------%%%%%%%%F%%%%%%%%%%%%%%%%%%%%%%%%%%%%%%%%%%%%%%%%%%%%%%%%%%%%%%%
%%%%%%%%%%%%%%--------|||||||||||||||||||--------------------------------%%%%%---%%%%%%%%---%%%||||--||||-------y|||||--gy--%%%%%-------||||||||%|||||||||||||||||||||||||||||||||||||||||||||||||||||||
||||||||||||||%%%--%%%|||||||||||||||||||%%--%%----------%%--%%------%%%%|||||---||||||||---|||||||--||||%%%%%%%%%%%%%%%%%%%|||||%%---%%||||||||||||||||||||||||||||||||||||||||||||||||||||||||||||||||
|||||||||||||||||--||||||||||||||||||||||||--||XXXXXXXXXX||--||XX--XX|||||||||---||||||||---|||||||--||||||||||||||||||||||||||||||---||||||||||||||||||||||||||||||||||||||||||||||||||||||||||||||||||
