HEIGHT=16;WIDTH=201;THEME=0;OVERRIDE=false
--------------------------------------------------------------------------------------------------------------------------------------------------------------------------------------------------------
--------------------------------------------------------------------------------------------------------------------------------------------------------------------------------------------------------
--------------------------------------------------------------------------------------------------------------------------------------------------------------------------------------------------------
--------------------------------------------------------------------------------------------------------------------------------------------------------------------------------------------------------
--------------------------------------------------------------------------------------------------------------------------------------------------------------------------------------------------------
--------------------------------------------------------------------------------------------------------------------------------------------------------------------------------------------------------
--------------------------------------------------------------------------------------------------------------------------------------------------------------------------------------------------------
--------------------------------------------------------------------------------------------------------------------------------------------------------------------------------------------------------
--------------------------------------------------------------------------------------------------------------------------------------------------------------------------------------------------------
-----------------------------%%%-----------------------------------------------------------------------------------------------------------SS2SSS-------------------------------------------------------
-----------------------------|||-------------------------------------------------------------------#--#-------------------------------------------------------------------------------------------------
---------------------k-------|||------------------------------------------------------------------##--##------------------------------------------------------------------------------------------------
%%%%%%%%%%%%%------%%%%%%%%%%%%%%%%%-------------------------%%%%--%%%%------%%%%%--%%%%%-------%%%%--%%%%-----------------#---#-----------g------------------------------------------------------------
|||||||||||||%%--%%|||||||||||||||||-------%%%%---%%%%-------||||--||||%%--%%|||||--|||||-------||||--||||----------------##---##------%%%%%%%%%%%------------------------------------------------------
|||||||||||||||--|||||||||||||||||||-------||||---||||-------||||--||||||--|||||||--|||||-------||||--||||---------------###---###-----|||||||||||------------------------------------------------------
|||||||||||||||--|||||||||||||||||||XXXXXXX||||---||||XX---XX||||--||||||--|||||||--|||||XX---XX||||--||||XXXX--XXXXXXXXXXXX---XXXXXXXX|||||||||||XXXXXXXXFXXXXXXXXXXXXXXXXXXXXXXXXXXXXXXXXXXXXXXXXXXXXX
