HEIGHT=16;WIDTH=201;THEME=0;OVERRIDE=false
--------------------------------------------------------------------------------------------------------------------------------------------------------------------------------------------------------
--------------------------------------------------------------------------------------------------------------------------------------------------------------------------------------------------------
--------------------------------------------------------------------------------------------------------------------------------------------------------------------------------------------------------
--------------------------------------------------------------------------------------------------------------------------------------------------------------------------------------------------------
--------------------------------------------------------------------------------------------------------------------------------------------------------------------------------------------------------
--------------------------------------------------------------------------------------------------------------------------------------------------------------------------------------------------------
--------------------------------------------------------------------------------------------------------------------------------------------------------------------------------------------------------
--------------------------------------------------------------------------------------------------------------------------------------------------------------------------------------------------------
----------------------------------------------------------y---------------------------------------------------------------------------------------------------------------------------------------------
----------------------------------------------------------%%%%------------------------------------------------------------------------------------------------------------------------------------------
------------------------------#---#-----------------------||||------------------------------------------------------------------------------------------------------------------------------------------
-----------------------------##---##----------------------||||--%%%-----------------------------------------------------------------tt------------------------------------------------------------------
----------------------------###---###---------------------||||--|||-----k-%%%%%---%%%%%---#--#--------------------------------------tt------------------------------------------------------------------
%%%%%%%%%%%%%-------------%%%%%---%%%%%-----------------%%%%%%%%%%%%%%%%%%|||||---|||||--##--##-----------------------------%%--%%%%%%%%----------------------------------------------------------------
|||||||||||||%%%%%---%%%%%|||||---|||||-----------------|||||||||||||||||||||||---|||||%%%%--%%%%-------%%%%---%%%%%%%---%%%||--||||||||----------------------------------------------------------------
||||||||||||||||||---||||||||||---|||||XX---XXXXXX--XXXX|||||||||||||||||||||||---|||||||||--||||XX---XX||||---|||||||---|||||--||||||||XXXXXXXXFXXXXXXXXXXXXXXXXXXXXXXXXXXXXXXXXXXXXXXXXXXXXXXXXXXXXXXX
