HEIGHT=16;WIDTH=201;THEME=0;OVERRIDE=false
--------------------------------------------------------------------------------------------------------------------------------------------------------------------------------------------------------
--------------------------------------------------------------------------------------------------------------------------------------------------------------------------------------------------------
--------------------------------------------------------------------------------------------------------------------------------------------------------------------------------------------------------
--------------------------------------------------------------------------------------------------------------------------------------------------------------------------------------------------------
--------------------------------------------------------------------------------------------------------------------------------------------------------------------------------------------------------
--------------------------------------------------------------------------------------------------------------------------------------------------------------------------------------------------------
--------------------------------------------------------------------------------------------------------------------------------------------------------------------------------------------------------
---------------------------------------------------------------------------------------------------------------------------%%%--------------------------------------------------------------------------
----------------------------------------------------------------------S2SSS--------------------------k-------------------y-g||--------------------------------------------------------------------------
----------------------------------------------------------------------------------------------------%%%%%%%-------------%%%%||--------------------------------------------------------------------------
----------------------------------------------------------------------------------------------------|||||||-------------||||||--------------------------------------------------------------------------
--------------------%%%%%%------------2SCS---------------------------------y----2SS--------#--#-----yr|||||-------------||||||--------------------------------------------------------------------------
--------------------||||||----#---#----------------------------%%%%%%%%%%%%%%%------------##--##---%%%%%%%%%%%%%%%%-----g|||||----------%%%%%%%%F%%%%%%%%%%%%%%%%%%%%%%%%%%%%%%%%%%%%%%%%%%%%%%%%%%%%%%%
%%%%%%%%%%%%%%----g-||||||--%%%---%%%--------------------%%--%%|||||||||||||||-----------###--###--||||||||||||||||%%%%%%%%%%%%%%%%--%%%||||||||%|||||||||||||||||||||||||||||||||||||||||||||||||||||||
||||||||||||||%%%%%%%%%%%%%%|||---|||-k------------------||--|||||||||||||||||---------%%%%%--%%%%%||||||||||||||||||||||||||||||||--|||||||||||||||||||||||||||||||||||||||||||||||||||||||||||||||||||
|||||||||||||||||||||||||||||||---|||XXXXXXXXXXXX---XXXXX||--|||||||||||||||||XXXXXXXXX|||||--|||||||||||||||||||||||||||||||||||||--|||||||||||||||||||||||||||||||||||||||||||||||||||||||||||||||||||
