HEIGHT=16;WIDTH=201;THEME=0;OVERRIDE=false
--------------------------------------------------------------------------------------------------------------------------------------------------------------------------------------------------------
--------------------------------------------------------------------------------------------------------------------------------------------------------------------------------------------------------
--------------------------------------------------------------------------------------------------------------------------------------------------------------------------------------------------------
--------------------------------------------------------------------------------------------------------------------------------------------------------------------------------------------------------
--------------------------------------------------------------------------------------------------------------------------------------------------------------------------------------------------------
--------------------------------------------------------------------------------------------------------------------------------------------------------------------------------------------------------
--------------------------------------------------------------------------------------------------------------------------------------------------------------------------------------------------------
--------------------------------------------------------------------------------------------------------------------------------------------------------------------------------------------------------
--------------------------------------------------------------------------------------------------------------------------------------------------------------------------------------------------------
----------------------------------------------------------------------------------------------------------------------------SSSU------------------------------------------------------------------------
------------------------#--#----------------------------------------------------------------------------------------------------------------------------------------------------------------------------
-----------------------##--##---------------------------------------------------------------------------------------------------------------------------------------------------------------------------
---------------------%%%%--%%%%-----------------------------------%%%%%---%%%%%---#---#---%%%%%--%%%%%%%%%%%%%%------------------r-%%%%%%%%%%%%%%%%%%%F%%%%%%%%%%%%%%%%%%%%%%%%%%%%%%%%%%%%%%%%%%%%%%%%%
%%%%%%%%%%%%%%%%--%%%||||--||||----------------------%%%%---------|||||---|||||--##---##--|||||--||||||||||||||----------%%%%%%%%%%|||||||||||||||||||%|||||||||||||||||||||||||||||||||||||||||||||||||
||||||||||||||||--|||||||--||||---------#---#----g-r-||||---------|||||---|||||%%%%---%%%%|||||--||||||||||||||----------|||||||||||||||||||||||||||||||||||||||||||||||||||||||||||||||||||||||||||||||
||||||||||||||||--|||||||--||||XX---XXXXX---XXXXXXXXX||||XXX---XXX|||||---|||||||||---|||||||||--||||||||||||||XXXX--XXXX|||||||||||||||||||||||||||||||||||||||||||||||||||||||||||||||||||||||||||||||
