HEIGHT=16;WIDTH=201;THEME=0;OVERRIDE=false
--------------------------------------------------------------------------------------------------------------------------------------------------------------------------------------------------------
--------------------------------------------------------------------------------------------------------------------------------------------------------------------------------------------------------
--------------------------------------------------------------------------------------------------------------------------------------------------------------------------------------------------------
--------------------------------------------------------------------------------------------------------------------------------------------------------------------------------------------------------
--------------------------------------------------------------------------------------------------------------------------------------------------------------------------------------------------------
--------------------------------------------------------------------------------------------------------------------------------------------------------------------------------------------------------
--------------------------------------------------------------------------------------------------------------------------------------------------------------------------------------------------------
--------------------------------------------------------------------------------------------------------------------------------------------------------------------------------------------------------
--------------------------------------------------------------------------------------------------------------------------------------------------------------------------------------------------------
-------------------k------------------SSSS-----------------------------------------------k--k-----------------------------------------------------------------------------------------------------------
------------------%%%%%-----------------------------------------------------------------%%%%%%----------------------------------------------------------------------------------------------------------
------------------|||||-----------------------------------------------------------------||||||---------------------------------SCS----------------------------------------------------------------------
------------------|||||---------------y------------%%%--%%%%%--%%--------%%%%%-----k---g||||||----------------------------------------------------------------------------------------------------------
%%%%%%%%%%%%-----yr||||--------------%%%%%%%-------|||--|||||--||--#--#--|||||%%%%%%%%%%%%%%%%%%%%%%%--%%%%%%---%%-------------------%%%----------------------------------------------------------------
||||||||||||%%%%%%%%%%%%%%%%%%-------|||||||-------|||--|||||--||%%%--%%%||||||||||||||||||||||||||||--||||||---||%%%%%%%%%-----r----|||----------------------------------------------------------------
||||||||||||||||||||||||||||||XX---XX|||||||XX---XX|||--|||||--|||||--|||||||||||||||||||||||||||||||--||||||---|||||||||||XXXXXXXXXX|||XXXXXXXXFXXXXXXXXXXXXXXXXXXXXXXXXXXXXXXXXXXXXXXXXXXXXXXXXXXXXXXX
