HEIGHT=16;WIDTH=201;THEME=0;OVERRIDE=false
--------------------------------------------------------------------------------------------------------------------------------------------------------------------------------------------------------
--------------------------------------------------------------------------------------------------------------------------------------------------------------------------------------------------------
--------------------------------------------------------------------------------------------------------------------------------------------------------------------------------------------------------
--------------------------------------------------------------------------------------------------------------------------------------------------------------------------------------------------------
--------------------------------------------------------------------------------------------------------------------------------------------------------------------------------------------------------
--------------------------------------------------------------------------------------------------------------------------------------------------------------------------------------------------------
--------------------------------------------------------------------------------------------------------------------------------------------------------------------------------------------------------
--------------------------------------------------------------------------------------------------------------------------------------------------------------------------------------------------------
------------SSSC----------------------------y--------------------SC2SUU---------------------------------------------------------------------------------------------------------------------------------
----------------------------------------%%%%%%-----------USC----------------------------Y---------------------------------------------------------------------------------------------------------------
----------------------------------------||||||------------------------------------------%%%%------------------------------------------------------------------------------------------------------------
-----------y--------------------#--#----||||||------------------------------------------||||------------------------------------------------------------------------------------------------------------
----------%%%%%%%%%%---#--#---%%%--%%%%%%%%%%%%%%%-------------%%%%%%%%%%%%%%%%%%%%%----||||-------------------------------------%%%%%--%%%%%-----------------------------------------------------------
%%%%%%%%%%||||||||||--##--##--|||--|||||||||||||||%%%%%%%%%%%%%|||||||||||||||||||||----|||y---%%--%%----------------------------|||||--|||||-----------------------------------------------------------
||||||||||||||||||||%%%%--%%%%|||--|||||||||||||||||||||||||||||||||||||||||||||||||%%%%%%%%%%%||--||----------------------------|||||--|||||-----------------------------------------------------------
||||||||||||||||||||||||--|||||||--||||||||||||||||||||||||||||||||||||||||||||||||||||||||||||||--||XXXX---XXXXXX---XXXXXX--XXXX|||||--|||||XXXXXXXXFXXXXXXXXXXXXXXXXXXXXXXXXXXXXXXXXXXXXXXXXXXXXXXXXXX
