HEIGHT=16;WIDTH=201;THEME=0;OVERRIDE=false
--------------------------------------------------------------------------------------------------------------------------------------------------------------------------------------------------------
--------------------------------------------------------------------------------------------------------------------------------------------------------------------------------------------------------
--------------------------------------------------------------------------------------------------------------------------------------------------------------------------------------------------------
--------------------------------------------------------------------------------------------------------------------------------------------------------------------------------------------------------
--------------------------------------------------------------------------------------------------------------------------------------------------------------------------------------------------------
--------------------------------------------------------------------------------------------------------------------------------------------------------------------------------------------------------
-----------------------%%%%%--------------------------------------------------------------------------------------SSS-----------------------------------------------------------------------------------
-----------------------|||||----------------------------------------------------------------------------------------------------------------------------------------------------------------------------
-----------------------|||||----------------------------------------------------------------------------------------------------------------------------------------------------------------------------
----------------%%%----|||||-------------------------------------------------------------------------------------r--------------------------------------------------------------------------------------
----------------|||----|||||-----------------------------------------------------------------------Tt-----------%%%%%%%---------------------------------------------------------------------------------
----------------|||----|||||-y---------------------------#---#-------------------------------Tt----tt-----------|||||||---------------------------------------------------------------------------------
--------------%%%%%%%%%%%%%%%%%--------------%%%%--%%%%%%%---%%%-----------------%%%--%%%----tt----tt-----------|||||||--------------%%%%---------------------------------------------------------------
%%%%%%%%%%%%%%|||||||||||||||||--------------||||--|||||||---|||-------%%%%--%%%%|||--|||%%%%%%%%%%%%%----------|||k||yG-------%%%%%%||||---------------------------------------------------------------
|||||||||||||||||||||||||||||||--------------||||--|||||||---|||--g----||||--|||||||--||||||||||||||||%%--%%%%%%%%%%%%%%%%%%%%%||||||||||%%%%%%%%F%%%%%%%%%%%%%%%%%%%%%%%%%%%%%%%%%%%%%%%%%%%%%%%%%%%%%%
|||||||||||||||||||||||||||||||XX---XXXX---XX||||--|||||||---|||XXXXXXX||||--|||||||--||||||||||||||||||--|||||||||||||||||||||||||||||||||||||||X||||||||||||||||||||||||||||||||||||||||||||||||||||||
