HEIGHT=16;WIDTH=201;THEME=0;OVERRIDE=false
--------------------------------------------------------------------------------------------------------------------------------------------------------------------------------------------------------
--------------------------------------------------------------------------------------------------------------------------------------------------------------------------------------------------------
--------------------------------------------------------------------------------------------------------------------------------------------------------------------------------------------------------
--------------------------------------------------------------------------------------------------------------------------------------------------------------------------------------------------------
--------------------------------------------------------------------------------------------------------------------------------------------------------------------------------------------------------
--------------------------------------------------------------------------------------------------------------------------------------------------------------------------------------------------------
--------------------------------------------------------------------------%%%%%-------------------------------------------------------------------------------------------------------------------------
-------------------------------------------------------------------------ky||||-------------------------------------------------------------------------------------------------------------------------
------------------------------------------------------------------------%%%||||-------------------------------------------------------------------------------------------------------------------------
------------------------------------------------------------------------|||||||-------------------------------------------------------------------------------------------------------------------------
------------------------------------------------------------------------|||||||-------------------------------------------------------------------------------------------------------------------------
----------------------------------------------------------------------y-|||||||----------------------------tt-----------------------r-y-----------------------------------------------------------------
--------------%%%---%%%--------------------------------------------%%%%%%%%%%%%%%--------------------------tt---tt--------#---#---%%%%%%----------------------------------------------------------------
%%%%%%%%%%%%%%|||---|||---#---#-------------------%%%--%%%---------||||||||||||||--------------------------tt---tt-------##---##--||||||----------------------------------------------------------------
|||||||||||||||||---|||--##---##--%%%--%%%%%%--%%%|||--|||%%%---%%%||||||||||||||------------------------%%%%%%%%%%%%%%%%%%---%%%%||||||----------------------------------------------------------------
|||||||||||||||||---|||XXXX---XXXX|||--||||||--||||||--||||||---|||||||||||||||||XX---XXXXXXXXXXXXXXX--XX||||||||||||||||||---||||||||||XXXXXXXXFXXXXXXXXXXXXXXXXXXXXXXXXXXXXXXXXXXXXXXXXXXXXXXXXXXXXXXX
