HEIGHT=16;WIDTH=201;THEME=0;OVERRIDE=false
--------------------------------------------------------------------------------------------------------------------------------------------------------------------------------------------------------
--------------------------------------------------------------------------------------------------------------------------------------------------------------------------------------------------------
--------------------------------------------------------------------------------------------------------------------------------------------------------------------------------------------------------
--------------------------------------------------------------------------------------------------------------------------------------------------------------------------------------------------------
--------------------------------------------------------------------------------------------------------------------------------------------------------------------------------------------------------
--------------------------------------------------------------------------------------------------------------------------------------------------------------------------------------------------------
--------------------------------------------------------------------------------------------------------------------------------------------------------------------------------------------------------
---------------------------------g----------------------------------------------------------------------------yr----------------------------------------------------------------------------------------
--------------------------------%%%---------------------------------------------------------------------------%%%%--------------------------------------------------------------------------------------
-----------------------2UCS2----|||----r------------------------------------------SCC-------------------------||||--------------------------------------------------------------------------------------
--------------------------------|||--%%%%---------------------------SCS-------------------------------------%%%%%|--------------------------------------------------------------------------------------
-------------------------------k|||--||||g-------------------------------------------%----------------------||||||--------------------------------------------------------------------------------------
------------------------------%%%%%%%%%%%%%-----------------------------%%---%%-r--r-|----#--#--------------||||||--------------------------------------------------------------------------------------
-----------%%%%--%%%%%%%%%%%%%|||||||||||||---%%---%%----------------Gr-||---||%%%%%%%%%%%%--%%%%%%%---%%%%-|||y|r-y---------------------------%%%%%%%%F%%%%%%%%%%%%%%%%%%%%%%%%%%%%%%%%%%%%%%%%%%%%%%%%
-----------||||--||||||||||||||||||||||||||---||---||------%%--%%%%%%%%%||---||||||||||||||--|||||||---||||%%%%%%%%%%%%%---%%%-----------------||||||||%||||||||||||||||||||||||||||||||||||||||||||||||
XXXXXXXXXXX||||--||||||||||||||||||||||||||XXX||---||XX--XX||--|||||||||||---||||||||||||||--|||||||---|||||||||||||||||---|||XX---XXXXXX--XXXX|||||||||||||||||||||||||||||||||||||||||||||||||||||||||
