HEIGHT=16;WIDTH=201;THEME=0;OVERRIDE=false
--------------------------------------------------------------------------------------------------------------------------------------------------------------------------------------------------------
--------------------------------------------------------------------------------------------------------------------------------------------------------------------------------------------------------
--------------------------------------------------------------------------------------------------------------------------------------------------------------------------------------------------------
--------------------------------------------------------------------------------------------------------------------------------------------------------------------------------------------------------
------------------------yy------------------------------------------------------------------------------------------------------------------------------------------------------------------------------
-----------------------%%%%%%---------------------------------------------------------------------------------------------------------------------------------------------------------------------------
-----------------------||||||---------------------------------------------------------------------------------------------------------------------------------------------------------------------------
---------------------r-||||||---------------------------------------------------------------------------------------------------------------------------------------------------------------------------
---------------------%%%%%%%|-------------------------------------------------------------2SSS2CS-------------------------------------------------------------------------------------------------------
---------------------||||||||----------------------------------------------------#--#---------------------------------------------------%%%%%%%---------------------------------------------------------
---------------------||||||||---------------------------------------------------##--##-----------------------CSS2C----------------------|||||||---------------------------------------------------------
---------------------|||||g||--------------------------------------#---#-------###--###-----y-------------------------------------------|||y|||-k-------------------------------------------------------
%%%%%%%%%%%%%%---%%%%%%%%%%%%%%%%%--%%---------------------------%%%---%%%%%%%%%%%--%%%%%%%%%%%%%%------------------%%%%%%%----#--#-----|||%%%%%%%------------------------------------------------------
||||||||||||||---|||||||||||||||||--||%%%--%%%%%---%%%%%%%--%%%%%|||---|||||||||||--||||||||||||||----------------g-|||||||---##--##----||||||||||------%%%%%%%%F%%%%%%%%%%%%%%%%%%%%%%%%%%%%%%%%%%%%%%%
||||||||||||||---|||||||||||||||||--|||||--|||||---|||||||--||||||||---|||||||||||--||||||||||||||%%---%%%%%%%%%%%%%|||||||--###--###---|Y||||||||------||||||||%|||||||||||||||||||||||||||||||||||||||
||||||||||||||---|||||||||||||||||--|||||--|||||---|||||||--||||||||---|||||||||||--||||||||||||||||---||||||||||||||||||||XXXXX--XXXXXXXXXXXXXXXXXXXXXX||||||||||||||||||||||||||||||||||||||||||||||||
