HEIGHT=16;WIDTH=201;THEME=0;OVERRIDE=false
--------------------------------------------------------------------------------------------------------------------------------------------------------------------------------------------------------
--------------------------------------------------------------------------------------------------------------------------------------------------------------------------------------------------------
--------------------------------------------------------------------------------------------------------------------------------------------------------------------------------------------------------
--------------------------------------------------------------------------------------------------------------------------------------------------------------------------------------------------------
--------------------------------------------------------------------------------------------------------------------------------------------------------------------------------------------------------
--------------------------------------------------------------------------------------------------------------------------------------------------------------------------------------------------------
---------------------------------------------------------Y----------------------------------------------------------------------------------------------------------------------------------------------
--------------------------------------------------------%%%%--------------------------------------------------------------------------------------------------------------------------------------------
--------------------------------------------------------||||-----------SS2------------------------------------------------------------------------------------------------------------------------------
---------------------------------%%%%%------------------||||-------------------------CCS----------------------------------------------------------------------------------------------------------------
---------------------------------|||||------------------||||-------------------------------------------------------------------------CS-----------------------------------------------------------------
---------------------------------||||%%%%-------------%%%|||----------------------------------#---#-----------------------------------------------------------------------------------------------------
%%%%%%%%%%%----------------------||||||||-------------||||||---------%%%%%%%-------yr--g----%%%---%%%--------%%---%%----------------%-----%%%%%%%%F%%%%%%%%%%%%%%%%%%%%%%%%%%%%%%%%%%%%%%%%%%%%%%%%%%%%%
|||||||||||----------------------||||||||-----%%%%%%--||||||---------|||||||-----%%%%%%%%%%%|||---|||--#--#--||---||----------------|-r---||||||||%|||||||||||||||||||||||||||||||||||||||||||||||||||||
|||||||||||%%%--%%%%%%---%%%---y-||||||r|-----||||||--y|y|||---------|||||||%%%%%||||||||||||||---|||%%%--%%%||---||%%%%%%%%--%%%%%%%%%%%%||||||||||||||||||||||||||||||||||||||||||||||||||||||||||||||
||||||||||||||--||||||---|||XXXXXXXXXXXXXXXXXXXXXXXXXXXXXXXXXXXX---XX||||||||||||||||||||||||||---||||||--|||||---||||||||||--||||||||||||||||||||||||||||||||||||||||||||||||||||||||||||||||||||||||||
