HEIGHT=16;WIDTH=201;THEME=0;OVERRIDE=false
--------------------------------------------------------------------------------------------------------------------------------------------------------------------------------------------------------
--------------------------------------------------------------------------------------------------------------------------------------------------------------------------------------------------------
--------------------------------------------------------------------------------------------------------------------------------------------------------------------------------------------------------
--------------------------------------------------------------------------------------------------------------------------------------------------------------------------------------------------------
--------------------------------------------------------------------------------------------------------------------------------------------------------------------------------------------------------
--------------------------------------------------------------------------------------------------------------------------------------------------------------------------------------------------------
--------------------------------------------------------------------------------------------------------------------------------------------------------------------------------------------------------
--------------------------------------------------------------------------------------------------------------------------------------------------------------------------------------------------------
--------------------------------------------------------------------------------------------------------------------------------------------------------------------------------------------------------
--------------------------------------------------------------S2SC------#---#---------------------------------------------------------------------------------------------------------------------------
-----------------------------------------------------------------------##---##--------------------------------------------------------------------------------------------------------------------------
----------------------------------------------------------------------###---###---------------------------tt--------------------------------------------------------------------------------------------
-----------%%--%%--------%%%%---------------------------------------%%%%%---%%%%%-----%%%%--#---#---------tt-tt---Tt-%%%%--%%%%%%%%--%%%%---------------------------------------------------------------
-----------||--||--------||||-----------------#---#----------%%%%%%%|||||---|||||-----||||%%%---%%%-------tt-tt---tt-||||--||||||||--||||%%%%%%%%F%%%%%%%%%%%%%%%%%%%%%%%%%%%%%%%%%%%%%%%%%%%%%%%%%%%%%%
%%%%%%%%%%%||--||%%%%%%%%%%%%%%%-------------##---##----g----||||||||||||---|||||%%%%%|||||||---|||%%%%%%%%%%%%%%%%%%||||--||||||||--||||||||||||%||||||||||||||||||||||||||||||||||||||||||||||||||||||
|||||||||||||--|||||||||||||||||XXXX---XXXXXXXX---XXXXXXXXXXX||||||||||||---|||||||||||||||||---|||||||||||||||||||||||||--||||||||--|||||||||||||||||||||||||||||||||||||||||||||||||||||||||||||||||||
