HEIGHT=16;WIDTH=201;THEME=0;OVERRIDE=false
--------------------------------------------------------------------------------------------------------------------------------------------------------------------------------------------------------
--------------------------------------------------------------------------------------------------------------------------------------------------------------------------------------------------------
--------------------------------------------------------------------------------------------------------------------------------------------------------------------------------------------------------
--------------------------------------------------------------------------------------------------------------------------------------------------------------------------------------------------------
--------------------------------------------------------------------------------------------------------------------------------------------------------------------------------------------------------
--------------------------------------------------------------------------------------------------------------------------------------------------------------------------------------------------------
--------------------------------------------------------------------------------------------------------------------------------------------------------------------------------------------------------
--------------------------------------------------------------------------------------------------------------------------------------------------------------------------------------------------------
-----------------------------------------------SCC------------------------------------------------------------------------------------------------------------------------------------------------------
-----------------------#--#--------------------------------#---#----------------------------Tt--Tt------------------------------------------------------------------------------------------------------
----------------------##--##------------------------------##---##---------------------------tt--tt------------------------------------------------------------------------------------------------------
--------------2C2----###--###-----#---#------------------###---###--------------------------tt--tt------S-2USSC-----------------------------------------------------------------------------------------
-------------------%%%%%--%%%%%--##---##------%%%%%%%--%%%%%---%%%%%--------------------%%%%%%%%%%%%%%------------------------------------%%%%%%%%F%%%%%%%%%%%%%%%%%%%%%%%%%%%%%%%%%%%%%%%%%%%%%%%%%%%%%
%%%%%%%%%%%%%----%-|||||--|||||%%%%---%%%%%%%%|||||||%%|||||---|||||--------------------||||||||||||||---%-------%%%%%%---%%%-------%%--%%||||||||%|||||||||||||||||||||||||||||||||||||||||||||||||||||
|||||||||||||-y-k|-|||||--|||||||||---||||||||||||||||||||||---|||||%%---%%-------------||||||||||||||-r-|--g----||||||---|||%%---%%||--||||||||||||||||||||||||||||||||||||||||||||||||||||||||||||||||
|||||||||||||XXXXXX|||||--|||||||||---||||||||||||||||||||||---|||||||---||XXXXX---XXXXX||||||||||||||XXXXXXXXXXX||||||---|||||---||||--||||||||||||||||||||||||||||||||||||||||||||||||||||||||||||||||
