HEIGHT=16;WIDTH=201;THEME=0;OVERRIDE=false
--------------------------------------------------------------------------------------------------------------------------------------------------------------------------------------------------------
--------------------------------------------------------------------------------------------------------------------------------------------------------------------------------------------------------
--------------------------------------------------------------------------------------------------------------------------------------------------------------------------------------------------------
--------------------------------------------------------------------------------------------------------------------------------------------------------------------------------------------------------
--------------------------------------------------------------------------------------------------------------------------------------------------------------------------------------------------------
--------------------------------------------------------------------------------------------------------------------------------------------------------------------------------------------------------
--------------------------------------------------------------------------------------------------------------------------------------------------------------------------------------------------------
--------------------------------------------------------------------------------------------------------------------------------------------------------------------------------------------------------
--------------------------------------------------------------------------------------------------------------------------------------------------------------------------------------------------------
--------------------------------------------------------------------------------------------------#--#--------------------------------------------------------------------------------------------------
-----------------------------r-------------------------------------------------------------------##--##--------------------#---#-------#--#-------------------------------------------------------------
------------------------%%%%%%------------------------------------------------------------------###--###------------------##---##-----##--##------------------------------------------------------------
%%%%%%%%%%%%%---%%%-----||||||----------------------------------------------------------------%%%%%--%%%%%%%%-----------%%%%---%%%%--###--###-----------------------------------------------------------
|||||||||||||---|||-----||||||-----------------%%--%%-----------------------------------------|||||--||||||||-----------||||---||||%%%%%--%%%%%%%%%%%%%F%%%%%%%%%%%%%%%%%%%%%%%%%%%%%%%%%%%%%%%%%%%%%%%%
|||||||||||||---|||%%---||||||-------%%%%--%%%%||--||------%%%%---%%%%------------------------|||||--||||||||-----------||||---|||||||||--|||||||||||||%||||||||||||||||||||||||||||||||||||||||||||||||
|||||||||||||---|||||XXXXXXXXXXXXXXXX||||--||||||--||XX--XX||||---||||XXXX---XXXXXXXXXXXXXXXXX|||||--||||||||XXXX---XXXX||||---|||||||||--||||||||||||||||||||||||||||||||||||||||||||||||||||||||||||||
