HEIGHT=16;WIDTH=201;THEME=0;OVERRIDE=false
--------------------------------------------------------------------------------------------------------------------------------------------------------------------------------------------------------
--------------------------------------------------------------------------------------------------------------------------------------------------------------------------------------------------------
--------------------------------------------------------------------------------------------------------------------------------------------------------------------------------------------------------
--------------------------------------------------------------------------------------------------------------------------------------------------------------------------------------------------------
--------------------------------------------------------------------------------------------------------------------------------------------------------------------------------------------------------
--------------------------------------------------------------------------------------------------------------------------------------------------------------------------------------------------------
--------------------------------------------------------------------------------------------------------------------------------------------------------------------------------------------------------
--------------------------------------------------------------------------------------------------------------------------------------------------------------------------------------------------------
--------------------------------------------------------------------------------------------------------------------------------------------------------------------------------------------------------
--------------------------------------------------------------------------------------------------------------------------------------------------------------------------------------------------------
--------------------------------------------------------------------------CSC-----------------------------------------------------------#---#-----------------------------------------------------------
---------------------------------------------------------------------------------------------#--#--------------------------------------##---##----------------------------------------------------------
%%%%%%%%%%%%%%---k--------------------------------------------------------------------------##--##-----------%%--%%----------#--#-----###---###--%%%%%%%%F%%%%%%%%%%%%%%%%%%%%%%%%%%%%%%%%%%%%%%%%%%%%%%
||||||||||||||%%%%%%---------------------------%%%%%---%%%%%--%%%------------y-------------###--###----#--#--||--||%%---%%--##--##--%%%%%---%%%%%||||||||%||||||||||||||||||||||||||||||||||||||||||||||
||||||||||||||||||||----y----g-----------------|||||---|||||%%|||------%%%%%%%%%%--------%%%%%--%%%%%%%%--%%%||--||||---||%%%%--%%%%|||||---||||||||||||||||||||||||||||||||||||||||||||||||||||||||||||
||||||||||||||||||||XXXXXXXXXXXXXXXXXXXXXXX--XX|||||---||||||||||XX--XX||||||||||XXX--XXX|||||--||||||||--|||||--||||---||||||--|||||||||---||||||||||||||||||||||||||||||||||||||||||||||||||||||||||||
