HEIGHT=16;WIDTH=201;THEME=0;OVERRIDE=false
--------------------------------------------------------------------------------------------------------------------------------------------------------------------------------------------------------
--------------------------------------------------------------------------------------------------------------------------------------------------------------------------------------------------------
--------------------------------------------------------------------------------------------------------------------------------------------------------------------------------------------------------
--------------------------------------------------------------------------------------------------------------------------------------------------------------------------------------------------------
--------------------------------------------------------------------------------------------------------------------------------------------------------------------------------------------------------
--------------------------------------------------------------------------------------------------------------------------------------------------------------------------------------------------------
--------------------------------------------------------------------------------------------------------------------------------------------------------------------------------------------------------
--------------------------------------------------------------------------------------------------------------------------------------------------------------------------------------------------------
--------------------------------------------------------------------------------------------------------------------------------------------------------------------------------------------------------
-----------------------------------------------------------tt-------tt----------------------------------------------------------------------------------------------------------------------------------
-----------------------------------------------------------tt----tt-tt-----#--#-------------------------------------------------------------------------------------------------------------------------
--------------------------------SCCCSS---------------------tt----tt-tt----##--##------------------------------------------------------------------------------------------------------------------------
%%%%%%%%%%%%%%%%--%%%--------------------%%%---%%%--------%%%%%%%%%%%%%%%%%%--%%%%%%%--%%%-tt---Tt-----------%%%------------------------%%%%%%%%F%%%%%%%%%%%%%%%%%%%%%%%%%%%%%%%%%%%%%%%%%%%%%%%%%%%%%%%
||||||||||||||||--|||---#--#-------------|||---|||--------||||||||||||||||||--|||||||--|||-tt---tt-----------|||%%---%%---------%%%--%%%||||||||%|||||||||||||||||||||||||||||||||||||||||||||||||||||||
||||||||||||||||--|||--##--##------------|||---|||--#--#--||||||||||||||||||--|||||||--|||-tt---tt-----------|||||---||---------|||--|||||||||||||||||||||||||||||||||||||||||||||||||||||||||||||||||||
||||||||||||||||--|||XXXX--XXXXXXXXXXXXXX|||---|||XXX--XXX||||||||||||||||||--|||||||--|||XXXXXXXXXXXXXX---XX|||||---||XXX---XXX|||--|||||||||||||||||||||||||||||||||||||||||||||||||||||||||||||||||||
