HEIGHT=16;WIDTH=201;THEME=0;OVERRIDE=false
--------------------------------------------------------------------------------------------------------------------------------------------------------------------------------------------------------
--------------------------------------------------------------------------------------------------------------------------------------------------------------------------------------------------------
--------------------------------------------------------------------------------------------------------------------------------------------------------------------------------------------------------
--------------------------------------------------------------------------------------------------------------------------------------------------------------------------------------------------------
--------------------------------------------------------------------------------------------------------------------------------------------------------------------------------------------------------
--------------------------------------------------------------------------------------------------------------------------------------------------------------------------------------------------------
--------------------------------------------------------------------------------------------------------------------------------------------------------------------------------------------------------
--------------------------------------------------------------------------------------------------------------------------------------------------------------------------------------------------------
--------------------------------------------------------------K------------------------CSSS-------------------------------------------------------------------------------------------------------------
-------------------------------------------------------------%%%%---------------------------------------------------------------------------------------------------------------------------------------
-------------------------------------------------------------||||---------------------------------------------------------------------------------------------------------------------------------------
----------------------------%%%%-----------------------------||||---------------------r-----------------------------------------------------------------------------------------------------------------
----------------------------||||----------------------------y||||----g-k---%%%%--%%%%%%%%%%%%---------------------%%%%--%%%%----#--#--------------------------------------------------------------------
---------------#--#--%%%%%--||||-----%%%%%%%%---#---#---%%%%%%%%%%%%%%%%%--||||--||||||||||||---#--#--------------||||--||||---##--##-------------------------------------------------------------------
-------------%%%--%%%|||||--||||-r-K-||||||||--##---##--|||||||||||||||||--||||--||||||||||||--##--##-------------||||--||||--###--###--%%%%%%%%F%%%%%%%%%%%%%%%%%%%%%%%%%%%%%%%%%%%%%%%%%%%%%%%%%%%%%%%
XXXXXXXXXXXXX|||--||||||||XXXXXXXXXXX||||||||XXXX---XXXX|||||||||||||||||XX||||--||||||||||||XXXX--XXXXXXXX---XXXX||||--||||XXXXX--XXXXX||||||||X|||||||||||||||||||||||||||||||||||||||||||||||||||||||
