HEIGHT=16;WIDTH=201;THEME=0;OVERRIDE=false
--------------------------------------------------------------------------------------------------------------------------------------------------------------------------------------------------------
--------------------------------------------------------------------------------------------------------------------------------------------------------------------------------------------------------
--------------------------------------------------------------------------------------------------------------------------------------------------------------------------------------------------------
--------------------------------------------------------------------------------------------------------------------------------------------------------------------------------------------------------
--------------------------------------------------------------------------------------------------------------------------------------------------------------------------------------------------------
--------------------------------------------------------------------------------------------------------------------------------------------------------------------------------------------------------
--------------------------------------------------------------------------------------------------------------------------------------------------------------------------------------------------------
--------------------------------------------------------------------------------------------------------------------------------------------------------------------------------------------------------
----------------------------------------------------------------------------------------------------------------------SSSSSS----------------------------------------------------------------------------
--------------------------------------------------------------------------------------------------------SCC2--------------------------------------------------------------------------------------------
------------tt---tt-------------------------------------------------------tt-tt-------------------------------------------------------------------------------------------------------------------------
------------tt---tt--------------------------------Tt-----------------Tt--tt-tt-------------------------------------------k-----------------------------------------------------------------------------
%%%%%%%%%%%%%%%%%%%%%%-------------------tt---tt---tt----tt-----------tt--tt-tt-------------------------------------%%%%%%%%%%%-------------------------------------------------------------------------
||||||||||||||||||||||---------%%%--%%%--tt---tt---tt----tt---------%%%%%%%%%%%%%%%%%---%%%%%%%%--%%%%%%%%%%%%%---%%|||||||||||-------------------%%%%%%%%F%%%%%%%%%%%%%%%%%%%%%%%%%%%%%%%%%%%%%%%%%%%%%
||||||||||||||||||||||%%%------|||--|||%%%%%%%%%%%%%%%%%%%%%%%%---%%|||||||||||||||||---||||||||--|||||||||||||---|||||||||||||-------------------||||||||%|||||||||||||||||||||||||||||||||||||||||||||
|||||||||||||||||||||||||XX--XX|||--|||||||||||||||||||||||||||---|||||||||||||||||||---||||||||--|||||||||||||---|||||||||||||XX--XXXXXXX---XXXXX||||||||||||||||||||||||||||||||||||||||||||||||||||||
