HEIGHT=16;WIDTH=201;THEME=0;OVERRIDE=false
--------------------------------------------------------------------------------------------------------------------------------------------------------------------------------------------------------
--------------------------------------------------------------------------------------------------------------------------------------------------------------------------------------------------------
--------------------------------------------------------------------------------------------------------------------------------------------------------------------------------------------------------
--------------------------------------------------------------------------------------------------------------------------------------------------------------------------------------------------------
--------------------------------------------------------------------------------------------------------------------------------------------------------------------------------------------------------
--------------------------------------------------------------------------------------------------------------------------------------------------------------------------------------------------------
----------------------------------------------g----------------------------------------------------------r----------------------------------------------------------------------------------------------
---------------------------------------------%%%---------------------------------------------------------%%%--------------------------------------------------------------------------------------------
---------------------------------------------|||---------------------------------------------------------|||--------------------------------------------------------------------------------------------
---------------------------------------------|g|---------------------------------------------------------|||--------------------------------------------------------------------------------------------
---------------------------------------------|%%%%%------------------------------------------------------|||--------------------------------------------------------------------------------------------
---------------------------------------------||||||-----------------g------------------------------------||%%%%-----------------------------------------------------------------------------------------
---------------------------------------------||||||-----------------%%%%--------------%%%--%%%-----------||||||---%%--%%--------#---#-------------------------------------------------------------------
%%%%%%%%%%%%%%------------------------k------||||||-----------------|k||--------------|||--|||-----------|||||g-y-||--||-------##---##---%%%%%%%%F%%%%%%%%%%%%%%%%%%%%%%%%%%%%%%%%%%%%%%%%%%%%%%%%%%%%%%
||||||||||||||%%%%---%%%%%%%%%--%%%%%%%%%%%%%%%%%%%%%--------%%%%%%%%%%%%%------------|||--|||%%---%%%%%%%%%%%%%%%||--||%%%%--###---###--||||||||%||||||||||||||||||||||||||||||||||||||||||||||||||||||
||||||||||||||||||---|||||||||--|||||||||||||||||||||XXXXXXXX|||||||||||||XXXXX--XXXXX|||--|||||---|||||||||||||||||--||||||XXXXX---XXXXX|||||||||||||||||||||||||||||||||||||||||||||||||||||||||||||||
