HEIGHT=16;WIDTH=201;THEME=0;OVERRIDE=false
--------------------------------------------------------------------------------------------------------------------------------------------------------------------------------------------------------
--------------------------------------------------------------------------------------------------------------------------------------------------------------------------------------------------------
--------------------------------------------------------------------------------------------------------------------------------------------------------------------------------------------------------
--------------------------------------------------------------------------------------------------------------------------------------------------------------------------------------------------------
--------------------------------------------------------------------------------------------------------------------------------------------------------------------------------------------------------
--------------------------------------------------------------------------------------------------------------------------------------------------------------------------------------------------------
---------------------------------------------------------------------------------------g----------------y---k-------------------------------------------------------------------------------------------
-------------------------------------------------------------------------------------%%%----------------%%%%%%------------------------------------------------------------------------------------------
-------------------------------------------------------------------------------------|||----------------||||||------------------------------------------------------------------------------------------
---------------------------------------------------------------------------------%%%%%||----------------||||||------------------------------------------------------------------------------------------
---------------------------------------------------------------------------------|||||||----------------||||||------------------------------------------------------------------------------------------
-----------------%%%%%--------------------------------#--#-----------------------|||||||----------------|||||%%%-------------#--#-----------------------------------------------------------------------
-----------------|||||--------%%%%%%%--%%%%%---%%%%%%%%--%%%-tt--------#---#----%%%%%%%%%%%%%%%%%--%%%%-||||||||------------##--##----------------------------------------------------------------------
------------%%%--|||||--------|y|||kk--|||||---||||||||--|||-tt-------##---##---|||||||||||||||||--||||-||||||||----------%%%%--%%%%--------------------------------------------------------------------
%%%%%%%%%%--r|r--||r||----%%%%%%%%%%%%%|||||---||||||||--|||%%%%%%%--###---###--|||||||||||||||||--||||-||||||||----g-%%%%||||--||||%%%%%%%%%%%%%F%%%%%%%%%%%%%%%%%%%%%%%%%%%%%%%%%%%%%%%%%%%%%%%%%%%%%%
||||||||||XXXXXXXXXXXXXXXX||||||||||||||||||---||||||||--||||||||||XXXXX---XXXXX|||||||||||||||||--||||XXXXXXXXXXXXXXX||||||||--|||||||||||||||||X||||||||||||||||||||||||||||||||||||||||||||||||||||||
