HEIGHT=16;WIDTH=201;THEME=0;OVERRIDE=false
--------------------------------------------------------------------------------------------------------------------------------------------------------------------------------------------------------
--------------------------------------------------------------------------------------------------------------------------------------------------------------------------------------------------------
--------------------------------------------------------------------------------------------------------------------------------------------------------------------------------------------------------
--------------------------------------------------------------------------------------------------------------------------------------------------------------------------------------------------------
--------------------------------------------------------------------------------------------------------------------------------------------------------------------------------------------------------
--------------------------------------------------------------------------------------------------------------------------------------------------------------------------------------------------------
--------------------------------------------------------------------------------------------------------------------------------------------------------------------------------------------------------
--------------------------------------------------------------------------------------------------------------------------------------------------------------------------------------------------------
--------------------------------------------------------------------------------------------------------------------------------------------------------------------------------------------------------
-------------------------------------------------------------SCS2---------------------------------------------------------------------------------------------------------------------------------------
--------------------------------------------------------------------------------------------------------------------------------------------------------------------------------------------------------
--------------------------------------------------------------------------------------------------------------------------------------------------------------------------------------------------------
%%%%%%%%%%----------------------------------------------------------------------------------------------%%%%%---%%%%%%%%%--%%%%%%--%%-------------------------------------------------------------------
||||||||||---#---#----------------%%%%%%%%-----------#---#--%%%%%%%%%%%---%%%---------------------------|||||---|||||||||--||||||--||-------------------------------------------------------------------
||||||||||--##---##---------------||||||||%%%---%%%%%%---%%%|||||||||||---|||%%%%--%%%%%%%%--%%%%-------|||||---|||||||||--||||||--||------%%%%%%%%F%%%%%%%%%%%%%%%%%%%%%%%%%%%%%%%%%%%%%%%%%%%%%%%%%%%%
||||||||||XXXX---XXXXXXXXXXXX---XX|||||||||||---||||||---||||||||||||||---|||||||--||||||||--||||XX---XX|||||---|||||||||--||||||--||XX--XX||||||||X||||||||||||||||||||||||||||||||||||||||||||||||||||
