HEIGHT=16;WIDTH=201;THEME=0;OVERRIDE=false
--------------------------------------------------------------------------------------------------------------------------------------------------------------------------------------------------------
--------------------------------------------------------------------------------------------------------------------------------------------------------------------------------------------------------
--------------------------------------------------------------------------------------------------------------------------------------------------------------------------------------------------------
--------------------------------------------------------------------------------------------------------------------------------------------------------------------------------------------------------
--------------------------------------------------------------------------------------------------------------------------------------------------------------------------------------------------------
--------------------------------------------------------------------------------------------------------------------------------------------------------------------------------------------------------
--------------------------------------------------------------------------------------------------------------------------------------------------------------------------------------------------------
--------------------------------------------------------------------------------------------------------------------------------------------------------------------------------------------------------
--------------------------------------------------------------------------------------------------------------------------------------------------------------------------------------------------------
--------------------------------------------------------------------------------------------------------------------------------------------------------------------------------------------------------
---------------#--#-------------------------------------------------------------------------------------------------------------------------------------------------------------------------------------
--------------##--##---------------------------------------------------SSS2-----------------------------------------------------------------------------------------------------------------------------
------------%%%%--%%%%%%%%%%--------------------------------------------------------------------------------------------%%%--%%%-------------Tt-Tt-%%%%%%%%F%%%%%%%%%%%%%%%%%%%%%%%%%%%%%%%%%%%%%%%%%%%%
%%%%%%%%%%%%||||--||||||||||%%%%%---%%%%%--tt-------%%---%%--#---#---------%--------------------------%%%%---%%%%-------|||--|||------Tt--tt-tt-tt-||||||||%||||||||||||||||||||||||||||||||||||||||||||
||||||||||||||||--|||||||||||||||---|||||--tt-------||---||%%%---%%%-y-k---|-------------------%%%%%%%||||---||||%%---%%|||--|||------tt--tt-tt-tt-|||||||||||||||||||||||||||||||||||||||||||||||||||||
||||||||||||||||--|||||||||||||||---|||||XXXXXXXXXXX||---|||||---|||XXXXXXXXXXXXXXXXXXX---XXXXX|||||||||||---||||||---|||||--|||XXXXXXXXXXXXXXXXXXX|||||||||||||||||||||||||||||||||||||||||||||||||||||
