HEIGHT=16;WIDTH=201;THEME=0;OVERRIDE=false
--------------------------------------------------------------------------------------------------------------------------------------------------------------------------------------------------------
--------------------------------------------------------------------------------------------------------------------------------------------------------------------------------------------------------
--------------------------------------------------------------------------------------------------------------------------------------------------------------------------------------------------------
--------------------------------------------------------------------------------------------------------------------------------------------------------------------------------------------------------
--------------------------------------------------------------------------------------------------------------------------------------------------------------------------------------------------------
--------------------------------------------------------------------------------------------------------------------------------------------------------------------------------------------------------
------------------------------------------------------------------------S2SS----------------------------------------------------------------------------------------------------------------------------
--------------------------------------------------------------------------------------------------------------------------------------------------------------------------------------------------------
--------------------------------------------------------------------------------------------------------------------------------------------------------------------------------------------------------
------------------------------------------------------------------------r--g----------------------------------------------------------------------------------------------------------------------------
------------------------------------------g-Y---------------------------%%%%------------------------------------------SSU-------------------------------------------------------------------------------
-------------------------#--#------------%%%%----------------------g---k||||r---------------------------------------------------------------------------------------------------------------------------
-----------------------%%%--%%%----Tt----||||-----%%---%%-------%%%%%%%%%%%%%%%%%%----------------y---%%%%%---%%%%%--------------------%%%%%%-----------------------------------------------------------
----------%%--%%-------|||--|||----tt----||||-----||---||%%---%%||||||||||||||||||-------------%%%%%%%|||||---|||||--------%%%%%--%%%%%||||||-----------------------------------------------------------
----------||--||-------|||--|||----tt----|Yg|-r---||---||||---||||||||||||||||||||%%%%%---%%%%%||||||||||||---|||||%%%%%%%%|||||--|||||||||||%%%%%%%%F%%%%%%%%%%%%%%%%%%%%%%%%%%%%%%%%%%%%%%%%%%%%%%%%%%
XXXXXXXXXX||--||XXXXXXX|||--|||XXXXXXXXXXXXXXXXXXX||---||||---|||||||||||||||||||||||||---|||||||||||||||||---||||||||||||||||||--|||||||||||||||||||X||||||||||||||||||||||||||||||||||||||||||||||||||
