HEIGHT=16;WIDTH=201;THEME=0;OVERRIDE=false
--------------------------------------------------------------------------------------------------------------------------------------------------------------------------------------------------------
--------------------------------------------------------------------------------------------------------------------------------------------------------------------------------------------------------
--------------------------------------------------------------------------------------------------------------------------------------------------------------------------------------------------------
--------------------------------------------------------------------------------------------------------------------------------------------------------------------------------------------------------
--------------------------------------------------------------------------------------------------------------------------------------------------------------------------------------------------------
--------------------------------------------------------------------------------------------------------------------------------------------------------------------------------------------------------
--------------------------------------------------------------------------------------------------------------------------------------------------------------------------------------------------------
--------------------------------------------------------------------------------------------------------------------------------------------------------------------------------------------------------
--------------------------------------------------------------------------------------------------------------------------------------------------------------------------------------------------------
-----------------------------------------------------------------------------yr------------------------------------------SSS2------%%%%%%%--------------------------------------------------------------
-------------------------------------------------------------------------%%%%%%%---------------------------------------------------|||||||--------------------------------------------------------------
--------------------------y----------------------------------------------y||||||--g----------------------------------------------%%%%%%|||--------------------------------------------------------------
-------------------------%%%%%%------#---#------------#--#---%%%%---%%%%%%%%%%%%%%%%%---------------------------------g----g-----||||g|r||--------------------------------------------------------------
%%%%%%%%%%%%-------%%--%%||||||%%%--##---##--%%--%%--##--##--||||---|||||||||||||||||--------------------------------%%%%%%%%%%%%%%%%%%%%%%%%-----------------------------------------------------------
||||||||||||-------||--|||||||||||%%%%---%%%%||--||%%%%--%%%%||||---|||||||||||||||||%%%---%%%-k---------------------||||||||||||||||||||||||%%%%%%%%F%%%%%%%%%%%%%%%%%%%%%%%%%%%%%%%%%%%%%%%%%%%%%%%%%%
||||||||||||XX---XX||--|||||||||||||||---||||||--||||||--||||||||---||||||||||||||||||||---|||XXXXXXXX--XXXXXX---XXXX||||||||||||||||||||||||||||||||X||||||||||||||||||||||||||||||||||||||||||||||||||
