HEIGHT=16;WIDTH=201;THEME=0;OVERRIDE=false
--------------------------------------------------------------------------------------------------------------------------------------------------------------------------------------------------------
--------------------------------------------------------------------------------------------------------------------------------------------------------------------------------------------------------
--------------------------------------------------------------------------------------------------------------------------------------------------------------------------------------------------------
--------------------------------------------------------------------------------------------------------------------------------------------------------------------------------------------------------
--------------------------------------------------------------------------------------------------------------------------------------------------------------------------------------------------------
--------------------------------------------------------------------------------------------------------------------------------------------------------------------------------------------------------
--------------------------------------------------------------------------------------------------------------------------------------------------------------------------------------------------------
--------------------------------------------------------------------------------------------------------------------------------------------------------------------------------------------------------
--------------------------------------------------------------------------------------------------------------------------------------------------------------------------------------------------------
-----------------------------------------------------------------------------------SCS--------SCC--------------------------------------Tt---------------------------------------------------------------
------------------------------------------------------------------------------------------------------------------k--------#---#-------tt---------------------------------------------------------------
---------------------------------------------------------------------------CCU------------------------------%%%%%%%-------##---##------tt---------------------------------------------------------------
%%%%%%%%%%%%%%%%%%%-------------------------------------------------------------------k---------------------|||||||-----%%%%---%%%%%%%%%%%%%%%%%%%%%%%%F%%%%%%%%%%%%%%%%%%%%%%%%%%%%%%%%%%%%%%%%%%%%%%%%
|||||||||||||||||||-------------%%%%%----------%%%%%---%%%%%----------------------%%%%%%%%%%%%%%%%%%%-------|||||||-----||||---||||||||||||||||||||||||%||||||||||||||||||||||||||||||||||||||||||||||||
|||||||||||||||||||%%%%%---%%%%%|||||%%%%--%%%%|||||---|||||-----------------r----|||||||||||||||||||-------|||||||-----||||---|||||||||||||||||||||||||||||||||||||||||||||||||||||||||||||||||||||||||
||||||||||||||||||||||||---||||||||||||||--|||||||||---|||||XXXXX---XXXXXXXXXXXXXX|||||||||||||||||||XXXXXXXXXXXXXXXXXXX||||---|||||||||||||||||||||||||||||||||||||||||||||||||||||||||||||||||||||||||
