HEIGHT=16;WIDTH=201;THEME=0;OVERRIDE=false
--------------------------------------------------------------------------------------------------------------------------------------------------------------------------------------------------------
--------------------------------------------------------------------------------------------------------------------------------------------------------------------------------------------------------
--------------------------------------------------------------------------------------------------------------------------------------------------------------------------------------------------------
--------------------------------------------------------------------------------------------------------------------------------------------------------------------------------------------------------
--------------------------------------------------------------------------------------------------------------------------------------------------------------------------------------------------------
--------------------------------------------------------------------------------------------------------------------------------------------------------------------------------------------------------
-----------------------------------------------------------------------------------------------------------------------------------SUCC-----------------------------------------------------------------
--------------------------------------------------------------------------------------------------------------------------------------------------------------------------------------------------------
--------------------------------------------------------------------------------------------------------------------------------------------------------------------------------------------------------
--------------------------------------------------------------------------------------------------------------------------------------------------------------------------------------------------------
-----------------------------------------------------------------------------------------------r-------------------tt-tt-----------%%%%%%---------------------------------------------------------------
------------------#--#--------------------------------------------------------------------%%%%%%-------------------tt-tt-----------||||||---------------------------------------------------------------
-----------------##--##---------%%%--%%%-----------------------%%---%%%%---%%%%-----------||||||----------------%%%%%%%%%%%%-------||||yr---%%%%%%%%F%%%%%%%%%%%%%%%%%%%%%%%%%%%%%%%%%%%%%%%%%%%%%%%%%%%
----------------###--###--%%--%%|||--|||-------------%%%%--%%%%||---||||---||||---------r-|G|||k----------------||||||||||||%%--%%%%%%%%%%%%||||||||%|||||||||||||||||||||||||||||||||||||||||||||||||||
%%%%%%%%%%%%%%%%%%%--%%%%%||--|||||--|||-------------||||--||||||---||||---||||-----g-%%%%%%%%%%%%%%%%----------||||||||||||||--||||||||||||||||||||||||||||||||||||||||||||||||||||||||||||||||||||||||
|||||||||||||||||||--|||||||--|||||--|||XXXXX---XXXXX||||--||||||---||||---||||XXXXXXX||||||||||||||||XXXX--XXXX||||||||||||||--||||||||||||||||||||||||||||||||||||||||||||||||||||||||||||||||||||||||
