HEIGHT=16;WIDTH=201;THEME=0;OVERRIDE=false
--------------------------------------------------------------------------------------------------------------------------------------------------------------------------------------------------------
--------------------------------------------------------------------------------------------------------------------------------------------------------------------------------------------------------
---------------------------------------------------------------------------------------------y----------------------------------------------------------------------------------------------------------
----------------------------------------------------------------------------------------%%%%%%%---------------------------------------------------------------------------------------------------------
----------------------------------------------------------------------------------------|||||||---------------------------------------------------------------------------------------------------------
----------------------------------------------------------------------------------------|||||||---------------------------------------------------------------------------------------------------------
----------------------------------------------------------------------------------------|||||||---------------------------------------------------------------------------------------------------------
-------------------------------------------------------------------------------------%%%%%%||||---------------------------------------------------------------------------------------------------------
-------------------------------------------------------------------------------------||||||||||---------------------------------------------------------------------------------------------------------
-------------------------------------------------------------------------------------||||r|||||---------------------------------------------------------------------------------------------------------
-------------------------------------#--#--------------------------------------------||||%%%%||---------------------------------------------------------------------------------------------------------
------------------------------------##--##-------------------------------------------||||||||||------SCC2-----------------------------------------------------------------------------------------------
%%%%%%%%%%%%%-----------%%%%--%%%%%%%%--%%%%---------------------------%%%%%---%%%%%-||||||Gk||g-------------%%--%%-------------------------------------------------------------------------------------
|||||||||||||%%%%---%%%%||||--||||||||--||||%%%%--%%%%-----%%%%--------|||||---|||||%%%%%%%%%%%%%%-----------||--||--------------r---------------%%%%%%%%F%%%%%%%%%%%%%%%%%%%%%%%%%%%%%%%%%%%%%%%%%%%%%%
|||||||||||||||||---||||||||--||||||||--||||||||--||||-----|r||y-yr----|||||---|||||||||||||||||||-g---k-----||--||------------%%%%%%%-----------||||||||%||||||||||||||||||||||||||||||||||||||||||||||
|||||||||||||||||---||||||||--||||||||--||||||||--||||XXXXXXXXXXXXXXXXX|||||---|||||||||||||||||||XXXXXXXXXXX||--||XXXXX--XXXXX|||||||XXXX---XXXX|||||||||||||||||||||||||||||||||||||||||||||||||||||||
