HEIGHT=16;WIDTH=201;THEME=0;OVERRIDE=false
--------------------------------------------------------------------------------------------------------------------------------------------------------------------------------------------------------
--------------------------------------------------------------------------------------------------------------------------------------------------------------------------------------------------------
--------------------------------------------------------------------------------------------------------------------------------------------------------------------------------------------------------
-----------------------------------------------------------------------------------------------------------------------------------------r---r----------------------------------------------------------
---------------------------------------------------------------------------------------------------------------------------------------%%%%%%%----------------------------------------------------------
---------------------------------------------------------------------------------------------------------------------------------------|||||||---g------------------------------------------------------
---------------------------------------------------------------------------------------------------------------------------------------|||||||--%%%-----------------------------------------------------
---------------------------------------------------------------------------------------------------------------------------------------|||||||--|||-----------------------------------------------------
---------------------------------------------------------------------------------------------------------------------------------------|||||||--|||-----------------------------------------------------
---------------------------------------------------------------------------------------------------------------------------------------|||||||--|||-----------------------------------------------------
-------------------------------------------------------------------------------------------------------------------------------------%%%%%%%||--|||-----------------------------------------------------
----------------------#--#------------------------------------------------------------------------------------------------#---#------|||||||||--|||-----------------------------------------------------
---------------------##--##-------------------------%%%--%%%%%%%%--%%%%%-------------------------------------------------##---##-----|r|||||||-k||rr----------------------------------------------------
-------------------%%%%--%%%%-----------------------|||--||||||||--|||||-------------------------------------#---#--%%--###---###--%%%%%%%%%%%%%%%%%%---------------------------------------------------
-------------------||||--||||-------------%%%%--%%%%|||--||||||||--|||||--------%%%%---%%%%-------%%%---%%%%%%---%%%||%%%%%---%%%%%||||||||||||||||||---------------------------------------------------
XXXXXXXXXXXXXX--XXX||||--||||XX---XXXX--XX||||--|||||||--||||||||--|||||XXX--XXX||||---||||XXXXXXX|||---||||||---||||||||||---|||||||||||||||||||||||XXXXXXXXFXXXXXXXXXXXXXXXXXXXXXXXXXXXXXXXXXXXXXXXXXX
