HEIGHT=16;WIDTH=201;THEME=0;OVERRIDE=false
--------------------------------------------------------------------------------------------------------------------------------------------------------------------------------------------------------
--------------------------------------------------------------------------------------------------------------------------------------------------------------------------------------------------------
--------------------------------------------------------------------------------------------------------------------------------------------------------------------------------------------------------
--------------------------------------------------------------------------------------------------------------------------------------------------------------------------------------------------------
--------------------------------------------------------------------------------------------------------------------------------------------------------------------------------------------------------
--------------------------------------------------------------------------------------------------------------------------------------------------------------------------------------------------------
--------------------------------------------------------------------------------------------------------------------------------------------------------------------------------------------------------
--------------------------------------------------------------------------------------------------------------------------------------------------------------------------------------------------------
--------------------------------------------------------------------------------------------------------------------------------------------------------------------------------------------------------
--------------------------------#--#----------------------------------------------------------------------------------------------S-S-------------------------------------------------------------------
-------------------------------##--##-----------------------------------------------%%%%----------------------------------------------------------------------------------------------------------------
------------------------------###--###------------------------------g--g------------||||----------------------%%%%%%---------------%--------------------------------------------------------------------
----------%%%---%%%---------%%%%%--%%%%%----------------------------%%%%%-----------||||----------------------||||||-----g--------k|----%%%%%%%%F%%%%%%%%%%%%%%%%%%%%%%%%%%%%%%%%%%%%%%%%%%%%%%%%%%%%%%%
%%%%%%%%%%|||---|||-r-------|||||--|||||%%%%%--%%%%%%%--%%----------|||||-------%%%%%%%%%%%%%--r------#--#--%%%%%%%%%%%%%%%------%%%%%%%||||||||%|||||||||||||||||||||||||||||||||||||||||||||||||||||||
|||||||||||||---|||%%%%%%%%%|||||--||||||||||--|||||||--||----g---gK|g|||-------|||||||||||||%%%%%%%%%%--%%%|||||||||||||||------|||||||||||||||||||||||||||||||||||||||||||||||||||||||||||||||||||||||
|||||||||||||---|||||||||||||||||--||||||||||--|||||||--||XXXXXXXXXXXXXXXXXXXXXX|||||||||||||||||||||||--||||||||||||||||||XX--XX|||||||||||||||||||||||||||||||||||||||||||||||||||||||||||||||||||||||
