HEIGHT=16;WIDTH=201;THEME=0;OVERRIDE=false
--------------------------------------------------------------------------------------------------------------------------------------------------------------------------------------------------------
--------------------------------------------------------------------------------------------------------------------------------------------------------------------------------------------------------
--------------------------------------------------------------------------------------------------------------------------------------------------------------------------------------------------------
--------------------------------------------------------------------------------------------------------------------------------------------------------------------------------------------------------
--------------------------------------------------------------------------------------------------------------------------------------------------------------------------------------------------------
--------------------------------------------------------------------------------------------------------------------------------------------------------------------------------------------------------
--------------------------------------------------------------------------------------------------------------------------------------------------------------------------------------------------------
--------------------------------------------------------------------------------------------------------------------------------------------------------------------------------------------------------
--------------------------------------------------------------------------------------------------------------------------------------------------------------------------------------------------------
------------------#--#--------------------------------------------------------------------------------------------------------------------k-------------------------------------------------------------
-----------------##--##------------------SSS-------CCSCSS------------------------------------------------------------------------------%%%%-------------------------------------------------------------
----------------###--###---------------------------------------------------------------------------------------------------------------||||r----K-------------------------------------------------------
%%%%%%%%%%%%%%%%%%%--%%%%%---------------------------------------------------------------%%%--%%%%%%%%---%%%%%-----y--------------%%%%%%%%%%%%%%%%%%----------------------------------------------------
|||||||||||||||||||--|||||------------------k------r----------#---#---%%%--%%%-----------|||--||||||||---|||||%%%%%%%----Tt---Tt--||||||||||||||||||%%%%%%%%F%%%%%%%%%%%%%%%%%%%%%%%%%%%%%%%%%%%%%%%%%%%
|||||||||||||||||||--|||||%%%%%---%%%%%%%%%%%%%%%%%%%%%%%%%--##---##--|||--|||%%%%---%%%%|||--||||||||---||||||||||||----tt---tt--||||||||||||||||||||||||||%|||||||||||||||||||||||||||||||||||||||||||
|||||||||||||||||||--||||||||||---|||||||||||||||||||||||||XXXX---XXXX|||--|||||||---|||||||--||||||||---||||||||||||XXXXXXXXXXXXX||||||||||||||||||||||||||||||||||||||||||||||||||||||||||||||||||||||
