HEIGHT=16;WIDTH=201;THEME=0;OVERRIDE=false
--------------------------------------------------------------------------------------------------------------------------------------------------------------------------------------------------------
--------------------------------------------------------------------------------------------------------------------------------------------------------------------------------------------------------
--------------------------------------------------------------------------------------------------------------------------------------------------------------------------------------------------------
--------------------------------------------------------------------------------------------------------------------------------------------------------------------------------------------------------
--------------------------------------------------------------------------------------------------------------------------------------------------------------------------------------------------------
--------------------------------------------------------------------------------------------------------------------------------------------------------------------------------------------------------
--------------------------------------------------------------------------------------------------------------------------------------------------------------------------------------------------------
--------------------------------------------------------------------------------------------------------------------------------------------------------------------------------------------------------
--------------------------------------------------------------------------------------------------------------------------------------------------------------------------------------------------------
-------------------------------------------------------------------------------------------------------------------------------------SUSCS--------------------------------------------------------------
---------------------CSS------------------------------------#---#---------------------------------------------------------------------------------------------------------------------------------------
-----------------------------------------------------------##---##--------------------------------------------------------------------------------------------------------------------------------------
--------------%%----%-------------%%%%%--%%%%%%%%%--%%%%--###---###--%%%%%---%%%%%%%%%%--------------------------tt-------------------k-----------------------------------------------------------------
%%%%%%%%%%%%%%||----|r------------|||||--|||||||||--||||%%%%%---%%%%%|||||---||||||||||----------------------tt--tt-----------------%%%%%%%-------------------------------------------------------------
||||||||||||||||%%%%%%%%%---------|||||--|||||||||--|||||||||---||||||||||---||||||||||--#---#---------------tt--tt-%%%%--%%%%%%--%%|||||||%%%%%%%%F%%%%%%%%%%%%%%%%%%%%%%%%%%%%%%%%%%%%%%%%%%%%%%%%%%%%
|||||||||||||||||||||||||XXX---XXX|||||--|||||||||--|||||||||---||||||||||---||||||||||XXX---XXXXXXXX--XXXXXXXXXXXXX||||--||||||--|||||||||||||||||X||||||||||||||||||||||||||||||||||||||||||||||||||||
