HEIGHT=16;WIDTH=201;THEME=0;OVERRIDE=false
--------------------------------------------------------------------------------------------------------------------------------------------------------------------------------------------------------
--------------------------------------------------------------------------------------------------------------------------------------------------------------------------------------------------------
--------------------------------------------------------------------------------------------------------------------------------------------------------------------------------------------------------
--------------------------------------------------------------------------------------------------------------------------------------------------------------------------------------------------------
--------------------------------------------------------------------------------------------------------------------------------------------------------------------------------------------------------
--------------------------------------------------------------------------------------------------------------------------------------------------------------------------------------------------------
--------------------------%%%%--------------------------------------------------------------------------------------------------------------------------------------------------------------------------
--------------------------||||--------------------------------------------------------------------------------------------------------------------------------------------------------------------------
--------------------------||||--------------------------------------------------------------------------------------------------------------------------------------------------------------------------
--------------------------||||--------------------------------------------------------------------------------------------------------------------------------------------------------------------------
------------------------%%%%||----------------------------------------------------------Tt--------------------------------------------------------------------------------------------------------------
------------------------|y||r|--------------------------------------#--#----------------tt------------y-------------------------k-----------------------------------------------------------------------
--------------------%%%%%%%%%%%%%%%%%%%--%%%%%---------------------##--##------------%%%%%%-------%%%%%%%------------------%%%%%%-------%%%%%%%%F%%%%%%%%%%%%%%%%%%%%%%%%%%%%%%%%%%%%%%%%%%%%%%%%%%%%%%%
%%%%%%%%%%%%%-------|||||||||||||||||||--|||||%%--%%%%%%%---%%%%%%%%%--%%%%%%%%%%%%%%||||||-------|||||||------------------||||||-------||||||||%|||||||||||||||||||||||||||||||||||||||||||||||||||||||
|||||||||||||-------|||||||||||||||||||--|||||||--|||||||---|||||||||--||||||||||||||||||||-------|||||||%%--%%-------r----|g|rkg-----k-||||||||||||||||||||||||||||||||||||||||||||||||||||||||||||||||
|||||||||||||XX---XX|||||||||||||||||||--|||||||--|||||||---|||||||||--||||||||||||||||||||XX---XX|||||||||--||XX--XXXXXXXXXXXXXXXXXXXXX||||||||||||||||||||||||||||||||||||||||||||||||||||||||||||||||
