HEIGHT=16;WIDTH=201;THEME=0;OVERRIDE=false
--------------------------------------------------------------------------------------------------------------------------------------------------------------------------------------------------------
--------------------------------------------------------------------------------------------------------------------------------------------------------------------------------------------------------
--------------------------------------------------------------------------------------------------------------------------------------------------------------------------------------------------------
--------------------------------------------------------------------------------------------------------------------------------------------------------------------------------------------------------
--------------------------------------------------------------------------------------------------------------------------------------------------------------------------------------------------------
-----------------------------------------------------------------r--------------------------------------------------------------------------------------------------------------------------------------
----------------------------------------------------------------%%%%------------------------------------------------------------------------------------------------------------------------------------
----------------------------------------------------------------||||------------------------------------------------------------------------------------------------------------------------------------
----------------------------------------------------------------||||------SSUCSS----------SSSS2-US----------------SSCSSS--------------------------------------------------------------------------------
----------------------------------------------------------------||||------------------------------------------------------------------------------------------------------------------------------------
-----------------------------------------------------------%%%%%%%||---------------------------|--------------------------------------------------------------------------------------------------------
-------------------tt--------------------------------------|||||||||---------------------------r-G------------------rr----2CSSS-------------------------------------------------------------------------
----------------Tt-tt-tt-----------------------------------|||||||||---%%%%%%%%%%-------%%%%%%%%%%%---tt---------%%%%%%%%-----------#--#----------------------------------------------------------------
%%%%%%%%%%%%%---tt-tt-tt----#---#--------------%%%%--%%%%--|k|||g|||g--||||||||||%%---%%|||||||||||---tt--Tt-----||||||||----------##--##---------------------------------------------------------------
|||||||||||||%%%%%%%%%%%%--##---##-------------||||--||||%%%%%%%%%%%%%%||||||||||||---|||||||||||||---tt--tt-----||||||||--------%%%%--%%%%%%%%%%%%F%%%%%%%%%%%%%%%%%%%%%%%%%%%%%%%%%%%%%%%%%%%%%%%%%%%%
|||||||||||||||||||||||||XXXX---XXXXXXXX---XXXX||||--||||||||||||||||||||||||||||||---|||||||||||||XXXXXXXXXXXXXX||||||||XXXXXXXX||||--||||||||||||X||||||||||||||||||||||||||||||||||||||||||||||||||||
