HEIGHT=16;WIDTH=201;THEME=0;OVERRIDE=false
--------------------------------------------------------------------------------------------------------------------------------------------------------------------------------------------------------
--------------------------------------------------------------------------------------------------------------------------------------------------------------------------------------------------------
--------------------------------------------------------------------------------------------------------------------------------------------------------------------------------------------------------
--------------------------------------------------------------------------------------------------------------------------------------------------------------------------------------------------------
--------------------------------------------------------------------------------------------------------------------------------------------------------------------------------------------------------
------------------------------------------------------------------------------------------------------------------------%%%%%---------------------------------------------------------------------------
------------------------------------------------------------------------------------------------------------------------|||||---------------------------------------------------------------------------
------------------------------------------------------------------------------------------------------------------------|||||---------------------------------------------------------------------------
---------------------------------------------------------------------------------------------------------------------y--|k|||---------------------------------------------------------------------------
-----------------------------------------S2CS2-----------------------------------------S2CS2-------------------------%%%%%%%|---------------------------------------------------------------------------
----------------------------------------------------------------------------2S2SSS-----------------------------------||||||||---------------------------------------------------------------------------
---------------------------------------------------------------------------------------------------------------------||||||||---------------------------------------------------------------------------
%%%%%%%%%%%%%%---%%%----------------------------------------------------------------%%-------------------------------||||||||-------------%%%%%%%%F%%%%%%%%%%%%%%%%%%%%%%%%%%%%%%%%%%%%%%%%%%%%%%%%%%%%%
||||||||||||||---|||-------%%%%%--%%%%%%%%%%%%%%%-------------%%%%%--%%%%%-----r----||%%%%%%%%-----------%%--%%%%%%%%%%%%%%%%%%%%%--------||||||||%|||||||||||||||||||||||||||||||||||||||||||||||||||||
||||||||||||||---|||-------|||||--|||||||||||||||-------------|||||--|||||%%%%%%%%%%||||||||||%%%%---%%%%||--|||||||||||||||||||||--#--#--||||||||||||||||||||||||||||||||||||||||||||||||||||||||||||||
||||||||||||||---|||XX---XX|||||--|||||||||||||||XXXXX---XXXXX|||||--|||||||||||||||||||||||||||||---||||||--|||||||||||||||||||||XXX--XXX||||||||||||||||||||||||||||||||||||||||||||||||||||||||||||||
