HEIGHT=16;WIDTH=201;THEME=0;OVERRIDE=false
--------------------------------------------------------------------------------------------------------------------------------------------------------------------------------------------------------
--------------------------------------------------------------------------------------------------------------------------------------------------------------------------------------------------------
--------------------------------------------------------------------------------------------------------------------------------------------------------------------------------------------------------
--------------------------------------------------------------------------------------------------------------------------------------------------------------------------------------------------------
--------------------------------------------------------------------------------------------------------------------------------------------------------------------------------------------------------
--------------------------------------------------------------------------------------------------------------------------------------------------------------------------------------------------------
------------------------------------------------------------------------------------------------y-------------------------------------------------------------------------------------------------------
--------------------------------------------------------------------------------------------%%%%%-------------------------------------------------------------------------------------------------------
----------------------------------------------------------------------SCS-------------------|||||-------------------------------------------------------------------------------------------------------
--------------------------------------------------------------------------------------------|||||---gk--------------------------------------------------------------------------------------------------
----------------------------------tt----Tt--------------------------------------------------|||||---%%%---------------------SUSSCSS---------------------------------------------------------------------
----------------------------------tt----tt---------------------------kr---------------------|||||---|||-------------------------------------------------------------------------------------------------
%%%%%%%%%%%%%%-----------%%%--%%%-tt----tt--------------%%%%%--%%%%%%%%%%%%%--%%%%%%---%%%%%%%%%%%%%%%%%%-----------------------------------------------------------------------------------------------
||||||||||||||-----------|||--|||%%%%%%%%%%%%%----------|||||--|||||||||||||--||||||---||||||||||||||||||-------------------------k------%%%%%%%%F%%%%%%%%%%%%%%%%%%%%%%%%%%%%%%%%%%%%%%%%%%%%%%%%%%%%%%
||||||||||||||%%%%---%%%%|||--||||||||||||||||%%%%--%%%%|||||--|||||||||||||--||||||---||||||||||||||||||-------%%%%%%--%%%%%%%%%%%%%%%%%||||||||%||||||||||||||||||||||||||||||||||||||||||||||||||||||
||||||||||||||||||---|||||||--||||||||||||||||||||--|||||||||--|||||||||||||--||||||---||||||||||||||||||XX---XX||||||--||||||||||||||||||||||||||||||||||||||||||||||||||||||||||||||||||||||||||||||||
