HEIGHT=16;WIDTH=201;THEME=0;OVERRIDE=false
--------------------------------------------------------------------------------------------------------------------------------------------------------------------------------------------------------
--------------------------------------------------------------------------------------------------------------------------------------------------------------------------------------------------------
--------------------------------------------------------------------------------------------------------------------------------------------------------------------------------------------------------
--------------------------------------------------------------------------------------------------------------------------------------------------------------------------------------------------------
--------------------------------------------------------------------------------------------------------------------------------------------------------------------------------------------------------
--------------------------------------------------------------------------------------------------------------------------------------------------------------------------------------------------------
--------------------------------------------------------------------------------------------------------------------------------------------------------------------------------------------------------
--------------------------------------------------------------------------------------------------------------------------------------------------------------------------------------------------------
--------------------------------------------------------------------------------------------------------------------------------------------------------------------------------------------------------
--------------------------------------------------------------------------------------------------------------------------------------------------------------------------------------------------------
--------------------------------------------------------------------------------------------------------------------------------------------------------------------------------------------------------
--------------------------------------------------k------------tt----------------------------------------------------------#---#------------------------------------------------------------------------
----------------------------------------------%%%%%%%%---------tt-----------------------------%%%%%--%%%%%---------------%%%---%%%----------------------------------------------------------------------
------------------------------------%%%%--%%%%||||||||---------tt--------------%%%%%%%%---%%%%|||||--|||||%%%---%%%------|||---|||%%%--%%%--------------------------------------------------------------
-----------%%%%%--%%%%%-------------||||--||||||||||||-------%%%%%%%%%%--------||||||||---|||||||||--||||||||---|||%%--%%|||---||||||--|||--------------------------------------------------------------
XXXXXXXXXXX|||||--|||||XX--XXXX---XX||||--||||||||||||XX---XX||||||||||XXX--XXX||||||||---|||||||||--||||||||---|||||--|||||---||||||--|||XXXXXXXXFXXXXXXXXXXXXXXXXXXXXXXXXXXXXXXXXXXXXXXXXXXXXXXXXXXXXX
