HEIGHT=16;WIDTH=201;THEME=0;OVERRIDE=false
--------------------------------------------------------------------------------------------------------------------------------------------------------------------------------------------------------
--------------------------------------------------------------------------------------------------------------------------------------------------------------------------------------------------------
--------------------------------------------------------------------------------------------------------------------------------------------------------------------------------------------------------
-----------------------------------------------------------------------------------------------------------%%%%%%%--------------------------------------------------------------------------------------
-----------------------------------------------------------------------------------------------------------|||||||--------------------------------------------------------------------------------------
---------------------------------------------------------------------------------------------------------r-|||||||--------------------------------------------------------------------------------------
---------------------------------------------------------------------------------------------------------%%%||||||--------------------------------------------------------------------------------------
---------------------------------------------------------------------------------------------------------|||||||||--------------------------------------------------------------------------------------
---------------------------------------------------------------------------------------------------------|||||||||--------------------------------------------------------------------------------------
---------------------------------------------------------------------------------------------------------||||||||r--g-----------------------------------------------------------------------------------
---------------------------------------------------------------------------------------------------------|||||||%%%%%-----------------------------------------------------------------------------------
--------------------------------S2SS22-------------------------------------------------------------------||||||||||||-----------------------------------------------------------------------------------
----------------------------------------------%%%---%%%--------------------------------%%%%%-------------||||||||||||-----------------------------------------------------------------------------------
--------------%%%%%%%%%%----------------------|||---|||-------------%%%--%%%-----------|||||-------------|||||r|||r||--------------%%%%---%%%%%%%%%%%%F%%%%%%%%%%%%%%%%%%%%%%%%%%%%%%%%%%%%%%%%%%%%%%%%%
%%%%%%%%%%%%%%||||||||||----------------------|||---|||-------------|||--|||----%%---%%|||||%%%%--%%%%%%%%%%%%%%%%%%%%%%%%%%---%%%%||||---||||||||||||%|||||||||||||||||||||||||||||||||||||||||||||||||
||||||||||||||||||||||||XXXXXXXXXXXXXXXXX---XX|||---|||XXXXX---XXXXX|||--|||XXXX||---|||||||||||--||||||||||||||||||||||||||---||||||||---||||||||||||||||||||||||||||||||||||||||||||||||||||||||||||||
