HEIGHT=16;WIDTH=201;THEME=0;OVERRIDE=false
--------------------------------------------------------------------------------------------------------------------------------------------------------------------------------------------------------
--------------------------------------------------------------------------------------------------------------------------------------------------------------------------------------------------------
--------------------------------------------------------------------------------------------------------------------------------------------------------------------------------------------------------
--------------------------------------------------------------------------------------------------------------------------------------------------------------------------------------------------------
--------------------------------------------------------------------------------------------------------------------------------------------------------------------------------------------------------
--------------------------------------------------------------------------------------------------------------------------------------------------------------------------------------------------------
--------------------------------------------------------------------------------------------------------------------------------------------------------------------------------------------------------
--------------------------------------------------------------------------------------------------------------------------------------------------------------------------------------------------------
------------------------------------------------------------------------------------------UCC-----------------------------------------------------------------------------------------------------------
--------------------------------------------------------------------------------------------------------------------------------------------------------------------------------------------------------
---------------------------------SSSCCCS------------tt-tt-----------------------------------------SUSSCS------------------------------------------------------------------------------------------------
----------------------------------------------------tt-tt---------------------------------y-ky----------------------------------------------------------------------------------------------------------
-------------------%%%%---%%%%--------------#--#----tt-tt-------------------------------%%%%%%%%---------------%%%%%---%%%%%----------------------------------------------------------------------------
%%%%%%%%%%%--------||||---||||-----r-------##--##--%%%%%%%%%%%%---%%%%%%%%%---%%%%%-----||||||||-y-------------|||||---|||||-------------%%%%%%%%F%%%%%%%%%%%%%%%%%%%%%%%%%%%%%%%%%%%%%%%%%%%%%%%%%%%%%%
|||||||||||%%%%%%%%||||---||||%%%%%%%%%%%%%%%--%%%%||||||||||||---|||||||||---|||||-----||||||||%%%%%%%%%------|||||---|||||%%%%%---%%%%%||||||||%||||||||||||||||||||||||||||||||||||||||||||||||||||||
|||||||||||||||||||||||---|||||||||||||||||||--||||||||||||||||---|||||||||---|||||XXXXX|||||||||||||||||XX--XX|||||---||||||||||---||||||||||||||||||||||||||||||||||||||||||||||||||||||||||||||||||||
