HEIGHT=16;WIDTH=201;THEME=0;OVERRIDE=false
--------------------------------------------------------------------------------------------------------------------------------------------------------------------------------------------------------
--------------------------------------------------------------------------------------------------------------------------------------------------------------------------------------------------------
--------------------------------------------------------------------------------------------------------------------------------------------------------------------------------------------------------
--------------------------------------------------------------------------------------------------------------------------------------------------------------------------------------------------------
--------------------------------------------------------------------------------------------------------------------------------------------------------------------------------------------------------
--------------------------------------------------------------------------------------------------------------------------------------------------------------------------------------------------------
--------------------------------------------------------------------------------------------------------------------------------------------------------------------------------------------------------
--------------------------------------------------------------------------------------------------------------------------------------------------------------------------------------------------------
--------------------------------------------------------------------------------------------SSSCC-------------------------------------------------------------------------------------------------------
--------------------------------------------------------------------------------------------------------------------------------------------------------------------------------------------------------
--------------------------------------------------------------------------%%%---------------------------------------------------------------------------------------------------------------------------
--------------------------------------------------------------------------|||---------------r-K---------------------------------------------------------------------------------------------------------
--------------------------------------------------%%--%%%%%%%---%%%%%-----|||--------%%--%%%%%%%%%%%%----------%%%---%%%--------------------------------------------------------------------------------
--------------------------------------------------||--|||||||---|||||---r-|||--------||--||||||||||||%%%%--%%%%|||---|||--------------------------------------------------------------------------------
------------%%%---%%%%%---%%------------%%%%--%%%%||--|||||||---|||||%%%%%%%%%%%%%%%%||--||||||||||||||||--|||||||---|||%%%%%-gr---%%--%%---------------------------------------------------------------
XXXXXXXXXXXX|||---|||||---||XXXXX--XXXXX||||--||||||--|||||||---|||||||||||||||||||||||--||||||||||||||||--|||||||---||||||||XXXXXX||--||XXXXXXXXFXXXXXXXXXXXXXXXXXXXXXXXXXXXXXXXXXXXXXXXXXXXXXXXXXXXXXX
