HEIGHT=16;WIDTH=201;THEME=0;OVERRIDE=false
--------------------------------------------------------------------------------------------------------------------------------------------------------------------------------------------------------
--------------------------------------------------------------------------------------------------------------------------------------------------------------------------------------------------------
--------------------------------------------------------------------------------------------------------------------------------------------------------------------------------------------------------
--------------------------------------------------------------------------------------------------------------------------------------------------------------------------------------------------------
--------------------------------------------------------------------------------------------------------------------------------------------------------------------------------------------------------
--------------------------------------------------------------------------------------------------------------------------------------------------------------------------------------------------------
--------------------------------------------------------------------------------------------------------------------------------------------------------------------------------------------------------
--------------------------------------------------------------------------------------------------------------------------------------------------------------------------------------------------------
------------------------------------------CSSS-------------------------------------------------SCC------------------------------------------------------------------------------------------------------
---------------Tt---------------------------------------------------------------------------------------------------------------#---#-------------------------------------------------------------------
---------------tt-------------------------------------------#--#---------------------------------------#--#--------------------##---##------------------------------------------------------------------
---------------tt------------------------------------------##--##------#--#----------------------y----##--##------------------###---###-----------------------------------------------------------------
-------------%%%%%%%%------------------%%%%%%%%-----------###--###----##--##--%%---%%------%%%%%%%%%%%%%--%%%%%%---%%-------%%%%%---%%%%%---------------------------------------------------------------
-------------||||||||%%%%%%%%%%%-------||||||||---------%%%%%--%%%%%%%%%--%%%%||---||------|||||||||||||--||||||---||-------|||||---|||||---------------------------------------------------------------
-------------|||||||||||||||||||-------||||||||%%%---%%%|||||--|||||||||--||||||---||%%--%%|||||||||||||--||||||---||-------|||||---|||||---------------------------------------------------------------
XXXXXXXXXXXXX|||||||||||||||||||XX---XX|||||||||||---||||||||--|||||||||--||||||---||||--|||||||||||||||--||||||---||XX---XX|||||---|||||XXXXXXXXFXXXXXXXXXXXXXXXXXXXXXXXXXXXXXXXXXXXXXXXXXXXXXXXXXXXXXX
