HEIGHT=16;WIDTH=201;THEME=0;OVERRIDE=false
--------------------------------------------------------------------------------------------------------------------------------------------------------------------------------------------------------
--------------------------------------------------------------------------------------------------------------------------------------------------------------------------------------------------------
--------------------------------------------------------------------------------------------------------------------------------------------------------------------------------------------------------
--------------------------------------------------------------------------------------------------------------------------------------------------------------------------------------------------------
--------------------------------------------------------------------------------------------------------------------------------------------------------------------------------------------------------
--------------------------------------------------------------------------------------------------------------------------------------------------------------------------------------------------------
--------------------------------------------------------------------------------------------------------------------------------------------------------------------------------------------------------
--------------------------------------------------------------------------------------------------------------------------------------------------------------------------------------------------------
--------------------------------------------------------------------------------------------------------------------------------------------------------------------------------------------------------
------------------------------------------------------------SSSCCC2S------------------------------------------------------------------------------------------------------------------------------------
----------------------------------------Tt--------------------------------------------------------------------------------------------------------------------------------------------------------------
----------------------------------------tt---------------------------------------------------------------------------------#--#-------------------------------------------------------------------------
----------------------------------------tt-------------------------------#---#------------------------%%--%%--------------##--##------------------------------------------------------------------------
------------------------%%%%%---------%%%%%%%%%------------%%%%%%%%%%---##---##-----------------------||--||-------------###--###-----------------------------------------------------------------------
%%%%%%%%%%%%%%%%%---%%%%|||||--#---#--|||||||||------------||||||||||--###---###---------%%%%%---%%%%%||--||%%%%---%%%%%%%%%--%%%%%%%%%%---%%%%%%%%%%%%%F%%%%%%%%%%%%%%%%%%%%%%%%%%%%%%%%%%%%%%%%%%%%%%%
|||||||||||||||||---|||||||||XXX---XXX|||||||||XXXXX--XXXXX||||||||||XXXXX---XXXXXXX---XX|||||---|||||||--||||||---|||||||||--||||||||||---|||||||||||||X|||||||||||||||||||||||||||||||||||||||||||||||
