HEIGHT=16;WIDTH=201;THEME=0;OVERRIDE=false
--------------------------------------------------------------------------------------------------------------------------------------------------------------------------------------------------------
--------------------------------------------------------------------------------------------------------------------------------------------------------------------------------------------------------
--------------------------------------------------------------------------------------------------------------------------------------------------------------------------------------------------------
--------------------------------------------------------------------------------------------------------------------------------------------------------------------------------------------------------
---------------------------------------------------------------------------------------------------------rk---------------------------------------------------------------------------------------------
-------------------------------------------------------------------------------------------------------%%%%---------------------------------------------------------------------------------------------
-------------------------------------------------------------------------------------------------------||||--------------g-y----------------------------------------------------------------------------
-------------------------------------------------------------------------------------------------------||||-------------%%%%----------------------------------------------------------------------------
---------------------------------------------------------------------------------------------------%%%%%%%|-------------||||----------------------------------------------------------------------------
--------------------SCCSSSCSS-----%%%--------------------------------------------------------------||||||||----------k--||||----------------------------------------------------------------------------
----------------------------------|||----------------------------------------g---------------------||||||||----------%%%%%||----------------------------------------------------------------------------
----------------------------------|||---------------------------------------%%%-------------------k||||||||-r--------|||||||----------------------------------------------------------------------------
------------#---#----y---k----%%%%%%%%%%%----k---------------------%%%%%----|||-----------------%%%%%%%%%%%%%%%%%%%%%%%%%%%%%%%-------------------------------------------------------------------------
----------%%%---%%%%%%%%%%%%%%|||||||||||%%%%%%---------%%%---%%%--|||||-r-g|||-r---------------|||||||||||||||||||||||||||||||-------------%%%%%%%%F%%%%%%%%%%%%%%%%%%%%%%%%%%%%%%%%%%%%%%%%%%%%%%%%%%%
----------|||---|||||||||||||||||||||||||||||||---------|||---|||--|||||%%%%%%%%%%%%%%%%%%--%%%%|||||||||||||||||||||||||||||||-------------||||||||%|||||||||||||||||||||||||||||||||||||||||||||||||||
XXXXXXXXXX|||---|||||||||||||||||||||||||||||||XXX---XXX|||---|||XX|||||||||||||||||||||||--|||||||||||||||||||||||||||||||||||XXXXX---XXXXX||||||||||||||||||||||||||||||||||||||||||||||||||||||||||||
