HEIGHT=16;WIDTH=201;THEME=0;OVERRIDE=false
--------------------------------------------------------------------------------------------------------------------------------------------------------------------------------------------------------
--------------------------------------------------------------------------------------------------------------------------------------------------------------------------------------------------------
--------------------------------------------------------------------------------------------------------------------------------------------------------------------------------------------------------
--------------------------------------------------------------------------------------------------------------------------------------------------------------------------------------------------------
--------------------------------------------------------------------------------------------------------------------------------------------------------------------------------------------------------
--------------------------------------------------------------------------------------------------------------------------------------------------------------------------------------------------------
---------------------------------------------------%%%%-------------------------------------------------------------------------------------------------------------------------------------------------
---------------------------------------------------||||-------------------------------------------------------------------------------------------------------------------------------------------------
------------------------------------------2SSS-----||||---%%%%%%----------------------------------------------------------------------------------------------------------------------------------------
---------------------------------------------------||||---||||||----------------------------------------------------------------------------------------------------------------------------------------
---------------------S2SCUS------------------------||||---||||||----------------------------------------------------------------------------------------------------------------------------------------
---------------------------------------------------||||---||||||----------------------------------------------------------------------------------------------------------------------------------------
%%%%%%%%%%%%%%---------------------------%%%%%%%%%%%%%%%%%%%%%%%%%%%%--%%%%%--%%%---------------------------#---#--%%%---------%%%%---%%%%--------------------------------------------------------------
||||||||||||||%%--%%-Y----g-%%%%%---%%%%%||||||||||||||||||||||||||||--|||||--|||------------%%---%%------%%%---%%%|||---------||||---||||%%%%%%%%F%%%%%%%%%%%%%%%%%%%%%%%%%%%%%%%%%%%%%%%%%%%%%%%%%%%%%
||||||||||||||||--||%%%%%%%%|||||---|||||||||||||||||||||||||||||||||--|||||--|||%%--%%%%--%%||---||%%%%%%|||---||||||---------||||---||||||||||||%|||||||||||||||||||||||||||||||||||||||||||||||||||||
||||||||||||||||--|||||||||||||||---|||||||||||||||||||||||||||||||||--|||||--|||||--||||--||||---|||||||||||---||||||XXX---XXX||||---||||||||||||||||||||||||||||||||||||||||||||||||||||||||||||||||||
