HEIGHT=16;WIDTH=201;THEME=0;OVERRIDE=false
--------------------------------------------------------------------------------------------------------------------------------------------------------------------------------------------------------
--------------------------------------------------------------------------------------------------------------------------------------------------------------------------------------------------------
--------------------------------------------------------------------------------------------------------------------------------------------------------------------------------------------------------
--------------------------------------------------------------------------------------------------------------------------------------------------------------------------------------------------------
--------------------------------------------------------------------------------------------------------------------------------------------------------------------------------------------------------
--------------------------------------------------------------------------------------------------------------------------------------------------------------------------------------------------------
--------------------------------------------------------------------------------------------------------------------------------------------------------------------------------------------------------
--------------------------------------------------------------------------------------------------------------------------------------------------------------------------------------------------------
--------------------------------------------------------------------------------------------------------------------------------------------------------------------------------------------------------
--------------------------------------------------------------------------------------------------------------------------------------CCCS--------------------------------------------------------------
-------------------------------------------------------------------------------------------------------------------%%%%---------------------------------------------------------------------------------
------------------------#--#---------------------------------------------------------------------------------------||||--------k--g---------------------------------------------------------------------
%%%%%%%%%%-------------##--##---------------------------------------------------tt--------------------------------%%%%%%%%%%%%%%%%%%--------------------------------------------------------------------
||||||||||-----------%%%%--%%%%------------------------------%%%%%---%%%%%%%----tt--------------------------------||||||||||||||||||%%%%%%%%%%%%%%%F%%%%%%%%%%%%%%%%%%%%%%%%%%%%%%%%%%%%%%%%%%%%%%%%%%%%
||||||||||-----------||||--||||%%%%%---%%%%%------%%%%---%%%%|||||---|||||||%%%%%%%%%%%---%%%%%%%%%%%%%%%%---%%%%%|||||||||||||||||||||||||||||||||%||||||||||||||||||||||||||||||||||||||||||||||||||||
||||||||||XXXX---XXXX||||--|||||||||---|||||XX--XX||||---|||||||||---||||||||||||||||||---||||||||||||||||---|||||||||||||||||||||||||||||||||||||||||||||||||||||||||||||||||||||||||||||||||||||||||||
