HEIGHT=16;WIDTH=201;THEME=0;OVERRIDE=false
--------------------------------------------------------------------------------------------------------------------------------------------------------------------------------------------------------
--------------------------------------------------------------------------------------------------------------------------------------------------------------------------------------------------------
--------------------------------------------------------------------------------------------------------------------------------------------------------------------------------------------------------
--------------------------------------------------------------------------------------------------------------------------------------------------------------------------------------------------------
--------------------------------------------------------------------------------------------------------------------------------------------------------------------------------------------------------
--------------------------------------------------------------------------------------------------------------------------------------------------------------------------------------------------------
--------------------------------------------------------------------------------------------------------------------------------------------------------------------------------------------------------
--------------------------------------------------------------------------------------------------------------------------------------------------------------------------------------------------------
--------------------------------------------------------------------------------------------------------------------------------------------------------------------------------------------------------
--------------------------------------------------------------------------------------------------------------------------------------------------------------------------------------------------------
--------------------------------------------------------------------------------------------------------------------------------------------------------------------------------------------------------
--------------------------------------------------------------------------------Tt------------------y-r-K-----------------------------------------------------------------------------------------------
------------------------------------------------------------%%%--%%%%%%%---%%%%-tt-----------------%%%%%%%----------------------------------------------------------------------------------------------
----------%%---%%%%---%%-----------------------%%--%%-------|||--|||||||---||||-tt-----------------|||||||--------%%%---%%%-----------------------------------------------------------------------------
----------||---||||---||-----------------------||--||%%---%%|||--|||||||---||||%%%%%%%%%%%--%%%%%%-|||||||--------|||---|||%%%%%---%%%%%----------------------------------------------------------------
XXXXXXXXXX||---||||---||XXXX---XXXXXXXXX--XXXXX||--||||---|||||--|||||||---|||||||||||||||--||||||XXXXXXXXXXXXXXXX|||---||||||||---|||||XXXXXXXXFXXXXXXXXXXXXXXXXXXXXXXXXXXXXXXXXXXXXXXXXXXXXXXXXXXXXXXX
