HEIGHT=16;WIDTH=201;THEME=0;OVERRIDE=false
--------------------------------------------------------------------------------------------------------------------------------------------------------------------------------------------------------
--------------------------------------------------------------------------------------------------------------------------------------------------------------------------------------------------------
--------------------------------------------------------------------------------------------------------------------------------------------------------------------------------------------------------
--------------------------------------------------------------------------------------------------------------------------------------------------------------------------------------------------------
--------------------------------------------------------------------------------------------------------------------------------------------------------------------------------------------------------
--------------------------------------------------------------------------------------------------------------------------------------------------------------------------------------------------------
--------------------------------------------------------------------------------------------------------------------------------------------------------------------------------------------------------
-------------------------------%%%%---------------------------------------------------------------------------------------------------------------------------------------------------------------------
-------------------------------k|||---------------------------------------------------------------------------------------------------------------------------------------------------------------------
-----------------------------%%%|||---------------SS-S--------------------------------------------------------------------------------------------------------------------------------------------------
-----------------------------||||||---------------------------------------------------------------------------------------------------------------------------------------------------------------------
-----------------------------||||||-----------------%------------------------------------------------------------------------------------#--#-----------------------------------------------------------
--------------------%%-------||||||--r---%%--%%-----|--------------------------------------------------------------------------%%%--%%%%%%--%%%---------------------------------------------------------
-------------#---#--||------%%%%%%%%%%%%%||--||%%%%%%%%%%%---------%%--%%------%%%---%%%----------%%--%%-----------------------|||--||||||--|||%%%%%%%%F%%%%%%%%%%%%%%%%%%%%%%%%%%%%%%%%%%%%%%%%%%%%%%%%
-----------%%%---%%%||%%--%%|||||||||||||||--|||||||||||||--#---#--||--||------|||---|||%%%%%%%%%%||--||---------yr------------|||--||||||--|||||||||||%||||||||||||||||||||||||||||||||||||||||||||||||
XXXXXXXXXXX|||---|||||||--|||||||||||||||||--|||||||||||||XXX---XXX||--||XX--XX|||---|||||||||||||||--||XXX--XXXXXXXXXXXXXXXXXX|||--||||||--||||||||||||||||||||||||||||||||||||||||||||||||||||||||||||
