HEIGHT=16;WIDTH=201;THEME=0;OVERRIDE=false
--------------------------------------------------------------------------------------------------------------------------------------------------------------------------------------------------------
--------------------------------------------------------------------------------------------------------------------------------------------------------------------------------------------------------
--------------------------------------------------------------------------------------------------------------------------------------------------------------------------------------------------------
--------------------------------------------------------------------------------------------------------------------------------------------------------------------------------------------------------
--------------------------------------------------------------------------------------------------------------------------------------------------------------------------------------------------------
--------------------------------------------------------------------------------------------------------------------------------------------------------------------------------------------------------
----------------------------------------------------------------------------------------------------------------------------------------%%%-------------------------------------------------------------
----------------------------------------------------------------------------------------------------------------------------------------|||-------------------------------------------------------------
-------------------------SCS--------------------------------------------------------------------------------------SS22------------------|||-------------------------------------------------------------
----------------------------------------------------------------------------------------------------------------------------------------|||-------------------------------------------------------------
------------------------------------------------------------------------------------------------g---------------------------------------|%%%%%----------------------------------------------------------
-------------------------------------r-----------------------------------------------------%%%%%%%--------------------------------------||||||----------------------------------------------------------
------------------------%%%%%%-%%%%%%%-----------------------------------------------------K|||K||-----%%---%%%%%%%%%%%%%%%%---%%%%%----||||||--k-------------------------------------------------------
------------------------||||||-|||||||----%%---%%----------------------------------------%%%%%%%%%%%%%%||---||||||||||||||||---|||||%%%%%%%%%%%%%%------------------------------------------------------
------------------------||||||-||||k|k----||---||--#--#--%%%---%%%%%%%%%%%%%---%%%%%---%%||||||||||||||||---||||||||||||||||---|||||||||||||||||||%%%%%%%%F%%%%%%%%%%%%%%%%%%%%%%%%%%%%%%%%%%%%%%%%%%%%%
XXXXXXXXXXXXXXXX---XXXXX||||||XXXXXXXXXXXX||---||XXX--XXX|||---|||||||||||||---|||||---||||||||||||||||||---||||||||||||||||---|||||||||||||||||||||||||||X|||||||||||||||||||||||||||||||||||||||||||||
