HEIGHT=16;WIDTH=201;THEME=0;OVERRIDE=false
--------------------------------------------------------------------------------------------------------------------------------------------------------------------------------------------------------
--------------------------------------------------------------------------------------------------------------------------------------------------------------------------------------------------------
--------------------------------------------------------------------------------------------------------------------------------------------------------------------------------------------------------
--------------------------------------------------------------------------------------------------------------------------------------------------------------------------------------------------------
--------------------------------------------------------------------------------------------------------------------------------------------------------------------------------------------------------
--------------------------------------------------------------------------------------------------------------------------------------------------------------------------------------------------------
--------------------------------------------------------------------------------------------------------------------------------------------------------------------------------------------------------
--------------------------------------------------------------------------------------------------------------------------------------------------------------------------------------------------------
--------------------------------------------------------------------------------------------------------------------------------------------------------------------------------------------------------
--------------------------------------------------------------------------------------------------------------------------------------------------------------------------------------------------------
---------------------------------------------------------------y-G------------------------------------------------------------------------%%%%----------------------------------------------------------
--------------------------------------------------------------%%%%-------------------------------------#--#-------------------------------||||----------------------------------------------------------
--------------------------------------------------------------||||--%%%%%%%%--%%----------------------##--##-------#---#------------------||||----------------------------------------------------------
-------------%%---%%--------%%---%%%%%%%---%%%%%%%--%%--------||||--||||||||--||---------------------###--###-----##---##-----------%%%%%%%%%%%%%%%%%%%%%%%F%%%%%%%%%%%%%%%%%%%%%%%%%%%%%%%%%%%%%%%%%%%%
%%%%%%%%%%%%%||---||%%%%%%%%||---|||||||---|||||||--||--------|||r--||||||||--||%%%%--%%%%--#---#--%%%%%--%%%%%--###---###----------|||||||||||||||||||||||%||||||||||||||||||||||||||||||||||||||||||||
|||||||||||||||---||||||||||||---|||||||---|||||||--||XXXXXXXXXXXXXX||||||||--||||||--||||XXX---XXX|||||--|||||XXXXX---XXXXXXXX--XXX||||||||||||||||||||||||||||||||||||||||||||||||||||||||||||||||||||
