HEIGHT=16;WIDTH=201;THEME=0;OVERRIDE=false
--------------------------------------------------------------------------------------------------------------------------------------------------------------------------------------------------------
--------------------------------------------------------------------------------------------------------------------------------------------------------------------------------------------------------
--------------------------------------------------------------------------------------------------------------------------------------------------------------------------------------------------------
--------------------------------------------------------------------------------------------------------------------------------------------------------------------------------------------------------
----------------------------------------------------------------------------------------------------------------------------r---------------------------------------------------------------------------
-------------------------------------------------------------------------------------------------------------------------%%%%%%-------------------------------------------------------------------------
-------------------------------------------------------------------------------------------------------------------------||||||-------------------------------------------------------------------------
---------------------------------------------------------------------------------------------%%%%------------------------|||||g-------------------------------------------------------------------------
---------------------------------------------------------------------------------------------||||------------------------||||%%%%%----------------------------------------------------------------------
------------------------------------------------------------------------------------------ry-||||------------------------|||||||||----------------------------------------------------------------------
------------------------------------------------------------------------------------------%%%%%%|-------------SCSCCCSSS--|||||||||----------------------------------------------------------------------
------------------------------------------------------------------------------------------|||||||------------------------g||||||||----------------------------------------------------------------------
-----------%%--%%--#--#---------------%%%--%%%%%%%%---%%%%%------------------------------k|||||r|--%%%%--%%%%-----------%%%%%%%%%%%%%%%%---%%%%---------------------------------------------------------
-----------||--||%%%--%%%-------------|||--||||||||---|||||---------%%%%--%%%%%%%%--%%%%%%%%%%%%%%%||||--||||-k---r---k-||||||||||||||||---||||%%%%%%%%F%%%%%%%%%%%%%%%%%%%%%%%%%%%%%%%%%%%%%%%%%%%%%%%%
-----------||--|||||--|||-------------|||--||||||||---|||||---------||||--||||||||--|||||||||||||||||||--||||%%%%%%%%%%%||||||||||||||||---||||||||||||%||||||||||||||||||||||||||||||||||||||||||||||||
XXXXXXXXXXX||--|||||--|||XXXXX---XXXXX|||--||||||||---|||||XXX---XXX||||--||||||||--|||||||||||||||||||--|||||||||||||||||||||||||||||||---|||||||||||||||||||||||||||||||||||||||||||||||||||||||||||||
