HEIGHT=16;WIDTH=201;THEME=0;OVERRIDE=false
--------------------------------------------------------------------------------------------------------------------------------------------------------------------------------------------------------
--------------------------------------------------------------------------------------------------------------------------------------------------------------------------------------------------------
--------------------------------------------------------------------------------------------------------------------------------------------------------------------------------------------------------
--------------------------------------------------------------------------------------------------------------------------------------------------------------------------------------------------------
--------------------------------------------------------------------------------------------------------------------------------------------------------------------------------------------------------
--------------------------------------------------------------------------------------------------------------------------------------------------------------------------------------------------------
--------------------------------------------------------------------------------------------------------------------------------------------------------------------------------------------------------
--------------------------------------------------------------------------------------------------------------------------------------------------------------------------------------------------------
------------------------------------------------------------------------------------------------------------------------------------SSSSCS--------------------------------------------------------------
------------------------------------------------------------------tt------------------------------------------------------------------------------------------------------------------------------------
----------------#--#------------------------------------------Tt--tt--------------------------y----------------#---#------------------------------------------------------------------------------------
---------------##--##--------2SSS2----------------#---#-------tt--tt----------------------%%%%%---------------##---##---------------------g-------------------------------------------------------------
-------------%%%%--%%%%--------------------------##---##--%%%%%%%%%%%%--------------------|||||-------------%%%%---%%%%%%%%---------%%%%%%%-------------------------------------------------------------
-------------||||--||||------------------------%%%%---%%%%||||||||||||%%%%---%%%%---------|||||------#--#---||||---||||||||---------|||k||y---%%%%%%%%F%%%%%%%%%%%%%%%%%%%%%%%%%%%%%%%%%%%%%%%%%%%%%%%%%
%%%%%%%%%%%%%||||--||||----------y-------------||||---||||||||||||||||||||---||||-----gr--|||||-----##--##--||||---||||||||--------%%%%%%%%%%%||||||||%|||||||||||||||||||||||||||||||||||||||||||||||||
|||||||||||||||||--||||XXXXXXXXXXXXXXXXX--XXXXX||||---||||||||||||||||||||---||||XXXXXXXXXXXXXXXXXXXXX--XXXX||||---||||||||XXX--XXX|||||||||||||||||||||||||||||||||||||||||||||||||||||||||||||||||||||
