HEIGHT=16;WIDTH=201;THEME=0;OVERRIDE=false
--------------------------------------------------------------------------------------------------------------------------------------------------------------------------------------------------------
--------------------------------------------------------------------------------------------------------------------------------------------------------------------------------------------------------
--------------------------------------------------------------------------------------------------------------------------------------------------------------------------------------------------------
--------------------------------------------------------------------------------------------------------------------------------------------------------------------------------------------------------
--------------------------------------------------------------------------------------------------------------------------------------------------------------------------------------------------------
--------------------------------------------------------------------------------------------------------------------------------------------------------------------------------------------------------
--------------------------------------------------------------------------------------------------------------------------------------------------------------------------------------------------------
--------------------------------------------------------------------------------------------------------------------------------------------------------------------------------------------------------
--------------------------------------------------------------------------------------------------------------------------------------------------------------------------------------------------------
--------------------------------------------------------------------------------------------------------------------------------------------------------------------------------------------------------
-------------------------------------------------------------------------------------------------r------------------------------------------------------------------------------------------------------
---------------------------------------------------------------------------------------------%%%%%%%----------------------------------------------------------------------------------------------------
%%%%%%%%%%---------------------#--#----------------%%%---%%%--------------------------#--#---|||||||--%%%%%---%%%%%-------------------------------------------------------------------------------------
||||||||||------------#--#----##--##--%%%%%---%%%%%|||---|||%%%%---%%%%-------------%%%--%%%-|||||||--|||||---|||||-----------%%%%---%%%%---%%%%--------------------------------------------------------
||||||||||----------%%%--%%%%%%%--%%%%|||||---||||||||---|||||||---||||%%---%%%%--%%|||--|||-|||||||--|||||---|||||-----------||||---||||---||||--------------------------------------------------------
||||||||||XXXXXXXXXX|||--|||||||--|||||||||---||||||||---|||||||---||||||---||||--|||||--|||XXXXXXXXXX|||||---|||||XXXX---XXXX||||XXX||||---||||XXXXXXXXFXXXXXXXXXXXXXXXXXXXXXXXXXXXXXXXXXXXXXXXXXXXXXXX
