HEIGHT=16;WIDTH=201;THEME=0;OVERRIDE=false
--------------------------------------------------------------------------------------------------------------------------------------------------------------------------------------------------------
--------------------------------------------------------------------------------------------------------------------------------------------------------------------------------------------------------
--------------------------------------------------------------------------------------------------------------------------------------------------------------------------------------------------------
--------------------------------------------------------------------------------------------------------------------------------------------------------------------------------------------------------
--------------------------------------------------------------------------------------------------------------------------------------------------------------------------------------------------------
--------------------------------------------------------------------------------------------------------------------------------------------------------------------------------------------------------
--------------------------------------------------------------------------------------------------------------------------------------------------------------------------------------------------------
-------------------------------------------------------------------------------------------------------------SSSSC2-------------------------------------------------------------------------------------
--------------------------------------------------------------------------------------------------------------------------------------------------------------------------------------------------------
--------------------------------------------------------------------------------------------------------------------------------------------------------------------------------------------------------
----------------------#---#--------------------------------------------------------------------------------------r--------------------------------------------------------------------------------------
------------#---#----##---##------------------------------------------------y--------------------------------%%%%%%-------------------------------------------------------------------------------------
----------%%%---%%%%%%%---%%%%-----%%%%%%--%%%-----------------------tt-%%%%%%%-Tt---tt----------------------||||||-------------------------------------------------------------------------------------
----------|||---|||||||---||||%%%%%||||||--|||-----------------------tt-|||||||-tt---tt----%%--%%------------||||||---%%%%------------------------------------------------------------------------------
----------|||---|||||||---|||||||||||||||--|||-----------------------tt-|||||||-tt---tt----||--||%%%---%%%---||||||-y-||||%%%---%%%%%%--%%%%%%%%%%%F%%%%%%%%%%%%%%%%%%%%%%%%%%%%%%%%%%%%%%%%%%%%%%%%%%%%
XXXXXXXXXX|||---|||||||---|||||||||||||||--|||XXX--XXXXXXXX--XXXXXXXXXXX|||||||XXXXXXXXXXXX||--|||||---|||XXXXXXXXXXXX|||||||---||||||--|||||||||||X||||||||||||||||||||||||||||||||||||||||||||||||||||
