HEIGHT=16;WIDTH=201;THEME=0;OVERRIDE=false
--------------------------------------------------------------------------------------------------------------------------------------------------------------------------------------------------------
--------------------------------------------------------------------------------------------------------------------------------------------------------------------------------------------------------
--------------------------------------------------------------------------------------------------------------------------------------------------------------------------------------------------------
--------------------------------------------------------------------------------------------------------------------------------------------------------------------------------------------------------
-----------------------------------------------------------------2CSS-----------------------------------------------------------------------------------------------------------------------------------
--------------------------------------------------------------------------------------------------------------------------------------------------------------------------------------------------------
--------------------------------------------------------------------------------------------------------------------------------------------------------------------------------------------------------
-----------------------------------------------------------------r-yg-----------------------------------------------------------------------------------------------------------------------------------
--------------------------------------------------------------%%%%%%%-----------------------------------------------------------------------------------------------------------------------------------
--------------------------------------------------------------|||||||-----------------------------------------------------------------------------------------------------------------------------------
--------------------------------------------------------------|||||||---------------------------------------------------------#---#---------------------------------------------------------------------
------------------------------------------------Tt--tt--------|||||||--------------------------------------------------------##---##--------------------------------------------------------------------
---------------------%%%%%--%%%%%---------------tt--tt--------|%%%|||-----------------------------#--#----------------------###---###-------------------------------------------------------------------
---------------------|||||--|||||%%%%%---%%%%%--tt--tt--------|||||||------%%%%%%%%%%%-----------##--##-------------%%--%%%%%%%---%%%%%-----------------------------------------------------------------
%%%%%%%%%%%%%%---%%%%|||||--||||||||||---|||||%%%%%%%%%%%%--k-|k||g||ky-g--|||||||||||%%%---%%%%%%%--%%%%-----------||--|||||||---|||||-----------%%%%%%%%F%%%%%%%%%%%%%%%%%%%%%%%%%%%%%%%%%%%%%%%%%%%%%
||||||||||||||---|||||||||--||||||||||---|||||||||||||||||XXXXXXXXXXXXXXXXX||||||||||||||---|||||||--||||XXXX---XXXX||--|||||||---|||||XXXX---XXXX||||||||X|||||||||||||||||||||||||||||||||||||||||||||
