HEIGHT=16;WIDTH=201;THEME=0;OVERRIDE=false
--------------------------------------------------------------------------------------------------------------------------------------------------------------------------------------------------------
--------------------------------------------------------------------------------------------------------------------------------------------------------------------------------------------------------
--------------------------------------------------------------------------------------------------------------------------------------------------------------------------------------------------------
--------------------------------------------------------------------------------------------------------------------------------------------------------------------------------------------------------
--------------------------------------------------------------------------------------------------------------------------------------------------------------------------------------------------------
--------------------------------------------------------------------------------------------------------------------------------------------------------------------------------------------------------
--------------------------------------------------------------------------------------------------------------------------------------------------------------------------------------------------------
--------------------------------------------------------------------------------------------------------------------------------------------------------------------------------------------------------
--------------------------------------------------------------------------------------------------------------------------------------------------------------------------------------------------------
--------------------------------------------------------------------------------------------------------------------------------------------------------------------------------------------------------
--------------------------------------------------------------------------------------------------------------------------------------------------------------------------------------------------------
---------------#--#----------------------------tt-------------------------------------------------------------------------------------------------------------------------------------------------------
-------------%%%--%%%-----------------%%---Tt--tt----------------------------------------------------------#---#------------------------%%%%%%%%F%%%%%%%%%%%%%%%%%%%%%%%%%%%%%%%%%%%%%%%%%%%%%%%%%%%%%%%
%%%%%%%%%%%%%|||--|||%%%%---%%%%------||---tt-%%%%%%%%%--%%--------%%--%%%%%---%%%--------%%%-------------##---##-----------------------||||||||%|||||||||||||||||||||||||||||||||||||||||||||||||||||||
||||||||||||||||--|||||||---||||%%--%%||---tt-|||||||||--||%%%--%%%||--|||||---|||--------|||------------###---###--%%%%--%%%%----------||||||||||||||||||||||||||||||||||||||||||||||||||||||||||||||||
||||||||||||||||--|||||||---||||||--||||XXXXXX|||||||||--|||||--|||||--|||||---|||XXXXXXXX|||XXXX--XXXXXXXXX---XXXXX||||--||||XXXX--XXXX||||||||||||||||||||||||||||||||||||||||||||||||||||||||||||||||
