HEIGHT=16;WIDTH=201;THEME=0;OVERRIDE=false
--------------------------------------------------------------------------------------------------------------------------------------------------------------------------------------------------------
--------------------------------------------------------------------------------------------------------------------------------------------------------------------------------------------------------
--------------------------------------------------------------------------------------------------------------------------------------------------------------------------------------------------------
--------------------------------------------------------------------------------------------------------------------------------------------------------------------------------------------------------
--------------------------------------------------------------------------------------------------------------------------------------------------------------------------------------------------------
--------------------------------------------------------------------------------------------------------------------------------------------------------------------------------------------------------
--------------------------------------------------------------------------------------------------------------------------------------------------------------------------------------------------------
--------------------------------------------------------------------------------------------------------------------------------------------------------------------------------------------------------
-----------------------------------y-g------------------------------------------------------------------------------------------------------------------------------------------------------------------
---------------------------------%%%%%------------------------------------------------------------------------------------------------------------------------------------------------------------------
---------------------------------|||||-------------------------------------------------------------------------------------------------%%%%-------------------------------------------------------------
---------------------------------|||||---k---y-----------------------------------------------------------------------------------------|k||-------------------------------------------------------------
%%%%%%%%%%%%%%%%%%%-------------%%%%%%%%%%%%%%%-------------------------------#---#------------------------%%%%---%%-------------%%%%%%%%%%%%%%%%%%%%F%%%%%%%%%%%%%%%%%%%%%%%%%%%%%%%%%%%%%%%%%%%%%%%%%%
|||||||||||||||||||-------------|||||||||||||||--%%%%%--%%%%%----------------##---##---%%%%%--%%%%%--------||||---||-------%%%%%%||||||||||||||||||||%||||||||||||||||||||||||||||||||||||||||||||||||||
|||||||||||||||||||%%%%%---%%%%%|||||||||||||||%%|||||--|||||---------------###---###--|||||--|||||%%%--%%%||||---||%%---%%|||||||||||||||||||||||||||||||||||||||||||||||||||||||||||||||||||||||||||||
||||||||||||||||||||||||---|||||||||||||||||||||||||||--|||||XXXXX---XXXXXXXXXX---XXXXX|||||--||||||||--|||||||---||||---|||||||||||||||||||||||||||||||||||||||||||||||||||||||||||||||||||||||||||||||
