HEIGHT=16;WIDTH=201;THEME=0;OVERRIDE=false
--------------------------------------------------------------------------------------------------------------------------------------------------------------------------------------------------------
--------------------------------------------------------------------------------------------------------------------------------------------------------------------------------------------------------
--------------------------------------------------------------------------------------------------------------------------------------------------------------------------------------------------------
--------------------------------------------------------------------------------------------------------------------------------------------------------------------------------------------------------
--------------------------------------------------------------------------------------------------------------------------------------------------------------------------------------------------------
--------------------------------------------------------------------------------------------------------------------------------------------------------------------------------------------------------
----------------------------------------------------CC2-------------------------------------------------------------------------------------------------------------------------------------------------
--------------------------------------------------------------------------------------------------------2SS---------------------------------------------------------------------------------------------
--------------------------------------------------------------------------SUCS--------------------------------------------------------------------------------------------------------------------------
-------------------------------------------------------g-------------------------------------CSSSCS-----------------------------------------------------------------------------------------------------
--------------------------------------------------%%%%%%%---------------------%--------------------------y---------USSSSSS------------------------------------------------------------------------------
--------------------------------------------------|||||||---------------------|-------------%---------%%%%%%--------------------------------------------------------------------------------------------
------------------------------------%%%%%--%%%%%-k|||||||--K-------------%%%%%%%%%%---------|---------||||||-k--------------%%%---%%%-------------------------------------------------------------------
----------------#--#----------------|||||--|||||%%%%%%%%%%%%%%%%---------||||||||||-------%%%%%%%%%%%%%%%%%%%%%%%-----------|||---|||-------------------------------------------------------------------
%%%%%%%%%%%%%%%%%--%%%--%%%%%--%%%%%|||||--|||||||||||||||||||||---------||||||||||%%---%%|||||||||||||||||||||||%%%%%%%%%%%|||---|||------------%%%%%%%%F%%%%%%%%%%%%%%%%%%%%%%%%%%%%%%%%%%%%%%%%%%%%%%
|||||||||||||||||--|||XX|||||--||||||||||--|||||||||||||||||||||XXX---XXX||||||||||||---|||||||||||||||||||||||||||||||||||||||---|||XXXXX--XXXXX||||||||X||||||||||||||||||||||||||||||||||||||||||||||
