HEIGHT=16;WIDTH=201;THEME=0;OVERRIDE=false
--------------------------------------------------------------------------------------------------------------------------------------------------------------------------------------------------------
--------------------------------------------------------------------------------------------------------------------------------------------------------------------------------------------------------
--------------------------------------------------------------------------------------------------------------------------------------------------------------------------------------------------------
--------------------------------------------------------------------------------------------------------------------------------------------------------------------------------------------------------
--------------------------------------------------------------------------------------------------------------------------------------------------------------------------------------------------------
--------------------------------------------------------------------------------------------------------------------------------------------------------------------------------------------------------
--------------------------------------------------------------------------------------------------------------------------------------------------------------------------------------------------------
--------------------------------------------------------------------------------------------------------------------------------------------------------------------------------------------------------
--------------------------------------------------------------------------------------------------------------------------------------------------------------------------------------------------------
--------------------------------------------------------------------------------------------------------------------------------------------------------------------------------------------------------
---------------------------%%%%%------------------------------------------------------------------------------------------------------------------------------------------------------------------------
---------------------------|||||--------------------------------------------------------------------SCCU------------------------------------------------------------------------------------------------
---------------------k-----|||||-----------------Y----------%%--%%%%--%%--------------------------------------#---#-------------%%%%--%%%%--------------------------------------------------------------
--------------------%%%%%%%%%%%%%%%%------------%%%%%%%-----||--||||--||------------------------------------%%%---%%%%%%%---%%%%||||--||||--------------------------------------------------------------
%%%%%%%%%%%%%%%%%%%%||||||||||||||||%%%%%%---%%%|||||||-----||--||||--||------%%%%%%-----------------y--r---|||---|||||||---||||||||--||||--------------------------------------------------------------
||||||||||||||||||||||||||||||||||||||||||---||||||||||XXXXX||--||||--||XXXXXX||||||XXXX--XXXXXXXXXXXXXXXXXX|||---|||||||---||||||||--||||XXXXXXXXFXXXXXXXXXXXXXXXXXXXXXXXXXXXXXXXXXXXXXXXXXXXXXXXXXXXXX
