HEIGHT=16;WIDTH=201;THEME=0;OVERRIDE=false
--------------------------------------------------------------------------------------------------------------------------------------------------------------------------------------------------------
--------------------------------------------------------------------------------------------------------------------------------------------------------------------------------------------------------
--------------------------------------------------------------------------------------------------------------------------------------------------------------------------------------------------------
--------------------------------------------------------------------------------------------------------------------------------------------------------------------------------------------------------
--------------------------------------------------------------------------------------------------------------------------------------------------------------------------------------------------------
--------------------------------------------------------------------------------------------------------------------------------------------------------------------------------------------------------
--------------------------------------------------------------------------------------------------------------------------------------------------------------------------------------------------------
--------------------------------------------------------------------------------------------------------------------------------------------------------------------------------------------------------
-----------------------------------------------------------------------------------------------rkk------------------------------------------------------------------------------------------------------
-----------------------------------------------------------------------------------------------%%%%--------------------------#---#----------------------------------------------------------------------
----------------------------------y---------------SS-CS----------------------------------------||||-------------------------##---##---------------------------------------------------------------------
------------------------#--#------%%%%%----------------------------------------------#---#-----||||-y-----SCSC-------------###---###--------------------------------------------------------------------
--------------%%%--%%%%%%--%%%----|||||-------------%-----------%%---%%------------%%%---%%%%%%%%%%%%%%------------------%%%%%---%%%%%------------------------------------------------------------------
--------------|||--||||||--|||----|||||-----------y-|-----------||---||---------%%%|||---||||||||||||||------------------|||||---|||||------%%%%%%%%F%%%%%%%%%%%%%%%%%%%%%%%%%%%%%%%%%%%%%%%%%%%%%%%%%%%
--------------|||--||||||--|||----|||||---k------%%%%%%%%%------||---||---------||||||---||||||||||||||------------------|||||---|||||----r-||||||||%|||||||||||||||||||||||||||||||||||||||||||||||||||
XXXXXXXXXXXXXX|||--||||||--|||XXXXXXXXXXXXXXXXXXX|||||||||XX--XX||---||XXX---XXX||||||---||||||||||||||XXXXXXXXXXXX---XXX|||||---|||||XXXXXX||||||||||||||||||||||||||||||||||||||||||||||||||||||||||||
