HEIGHT=16;WIDTH=201;THEME=0;OVERRIDE=false
--------------------------------------------------------------------------------------------------------------------------------------------------------------------------------------------------------
--------------------------------------------------------------------------------------------------------------------------------------------------------------------------------------------------------
--------------------------------------------------------------------------------------------------------------------------------------------------------------------------------------------------------
--------------------------------------------------------------------------------------------------------------------------------------------------------------------------------------------------------
--------------------------------------------------------------------------------------------------------------------------------------------------------------------------------------------------------
--------------------------------------------------------------------------------------------------------------------------------------------------------------------------------------------------------
--------------------------------------------------------------------------------------------------------------------------------------------------------------------------------------------------------
--------------------------------------------------------------------------------------------------------------------------------------------------------------------------------------------------------
--------------------------------------------------------------------------------------------------------------------------------------------------------------------------------------------------------
--------------------------------------------------------------------------------------------------------------------------------------------------------------------------------------------------------
-------------------------------------------------------------------------------r------------------------------------------------------------------------------------------------------------------------
----------------------------------------------------------------------------%%%%%--------------2SS------------------------------------------------------------------------------------------------------
----------%%%%%%%%%-------------------------%%--%%------------%%%%%%--------|||||-------%%--%%--------------%%%%%%%%----------------%%%%%%%-------------------------------------------------------------
%%%%%%%%%%|||||||||%%%--%%%%%%%%%-----------||--||------------||||||--------|||||-------||--||--------#--#--||||||||%%%---%%%-------|||||||-----%%%%%%%%F%%%%%%%%%%%%%%%%%%%%%%%%%%%%%%%%%%%%%%%%%%%%%%%
||||||||||||||||||||||--|||||||||%%%%%%%%%%%||--||%%%%%--%%%%%||||||----g---|||||-------||--||------%%%--%%%|||||||||||---|||-----r-K||||G|-----||||||||%|||||||||||||||||||||||||||||||||||||||||||||||
||||||||||||||||||||||--||||||||||||||||||||||--|||||||--|||||||||||XXXXXXXXXXXXXXXXXXXX||--||XXXXXX|||--||||||||||||||---|||XXXXXXXXXXXXXXXXXXX||||||||||||||||||||||||||||||||||||||||||||||||||||||||
