HEIGHT=16;WIDTH=201;THEME=0;OVERRIDE=false
--------------------------------------------------------------------------------------------------------------------------------------------------------------------------------------------------------
--------------------------------------------------------------------------------------------------------------------------------------------------------------------------------------------------------
--------------------------------------------------------------------------------------------------------------------------------------------------------------------------------------------------------
--------------------------------------------------------------------------------------------------------------------------------------------------------------------------------------------------------
--------------------------------------------------------------------------------------------------------------------------------------------------------------------------------------------------------
--------------------------------------------------------------------------------------------------------------------------------------------------------------------------------------------------------
--------------------------------------------------------------------------------------------------------------------------------------------------------------------------------------------------------
--------------------------------------------------------------------------------------------------------------------------------------------------------------------------------------------------------
-------------------------------------------------%%%%---------------------------------------------------------------------------------------------------------------------------------------------------
-------------------------------------------------||||------------------------------------------------------------------------CCS-S----------------------------------------------------------------------
-----------------------------%%%%----------------||||-------------------------------------------------------------#---#-----------------#--#------------------------------------------------------------
-----------------------------||||----------------||||------------------------------------------------------------##---##--------%------##--##-----------------------------------------------------------
-----------------------------||||--------------%%%%%%%%%%%%%%--%%-----------------------------------------------###---###----y--|----%%%%--%%%%---------------------------------------------------------
%%%%%%%%%%---------------%%%%%%%%%%%%%%%%---%%%||||||||||||||--||%%%%%--%%%%%-------%%%---%%%--#--#-----------%%%%%---%%%%%%%%%%%%%%%||||--||||%%%%%%%%F%%%%%%%%%%%%%%%%%%%%%%%%%%%%%%%%%%%%%%%%%%%%%%%%
||||||||||%%---%%%%%--%%%||||||||||||||||---|||||||||||||||||--|||||||--|||||%%---%%|||---|||%%%--%%%%%%---%%%|||||---|||||||||||||||||||--||||||||||||%||||||||||||||||||||||||||||||||||||||||||||||||
||||||||||||---|||||--|||||||||||||||||||---|||||||||||||||||--|||||||--|||||||---|||||---||||||--||||||---||||||||---|||||||||||||||||||--|||||||||||||||||||||||||||||||||||||||||||||||||||||||||||||
