HEIGHT=16;WIDTH=201;THEME=0;OVERRIDE=false
--------------------------------------------------------------------------------------------------------------------------------------------------------------------------------------------------------
--------------------------------------------------------------------------------------------------------------------------------------------------------------------------------------------------------
--------------------------------------------------------------------------------------------------------------------------------------------------------------------------------------------------------
--------------------------------------------------------------------------------------------------------------------------------------------------------------------------------------------------------
--------------------------------------------------------------------------------------------------------------------------------------------------------------------------------------------------------
--------------------------------------------------------------------------------------------------------------------------------------------------------------------------------------------------------
--------------------------------------------------------------------------------------------------------------------------------------------------------------------------------------------------------
--------------------------------------------------------------------------------------------------------------------------------------------------------------------------------------------------------
--------------------------------------------------------------------------------------------------------------------------------------------------------------------------------------------------------
---------------------------------------------y----------------------------------------------------------------------------------------------------------------------------------------------------------
--------------------------------------------%%%%%------------Tt-----------------------------------------------------------------------------------------------------------------------------------------
--------------------------------------------|||||------------tt----tt-----------------------------------------------------------------------------------------------------------------------------------
--------------%%------------#---#-----------|||||------%%%---tt----tt-------------%%---%%-----------%%%%--%%%%----#--#-------------------%%%%%%%%F%%%%%%%%%%%%%%%%%%%%%%%%%%%%%%%%%%%%%%%%%%%%%%%%%%%%%%
--------------||-----------##---##-----k----||y||------|||%%%%%%%%%%%%%%----------||---||-----------||||--||||---##--##---------%%%---%%%||||||||%||||||||||||||||||||||||||||||||||||||||||||||||||||||
%%%%%%%%%%%%%%||%%%---%%%%%%%---%%%%%%%%%%%%%%%%%%%%%%%|||||||||||||||||----------||---||-----------||||--||||--###--###-----y--|||---||||||||||||||||||||||||||||||||||||||||||||||||||||||||||||||||||
|||||||||||||||||||---|||||||---||||||||||||||||||||||||||||||||||||||||XXXX--XXXX||---||XXXX---XXXX||||--||||XXXXX--XXXXXXXXXXX|||---||||||||||||||||||||||||||||||||||||||||||||||||||||||||||||||||||
