HEIGHT=16;WIDTH=201;THEME=0;OVERRIDE=false
--------------------------------------------------------------------------------------------------------------------------------------------------------------------------------------------------------
--------------------------------------------------------------------------------------------------------------------------------------------------------------------------------------------------------
--------------------------------------------------------------------------------------------------------------------------------------------------------------------------------------------------------
--------------------------------------------------------------------------------------------------------------------------------------------------------------------------------------------------------
--------------------------------------------------------------------------------------------------------------------------------------------------------------------------------------------------------
--------------------------------------------------------------------------------------------------------------------------------------------------------------------------------------------------------
--------------------------SSSSC-------------------------------------------------------------------------------------------------------------------------------------------------------------------------
---------------------------------------------SSCS-------------------------------------------------------------------------------------------------------------------------------------------------------
--------------------------------------------------------------SSCSSS-CS------------------------------------------------------------CSC2-----------------------------------------------------------------
-----------------------------g--------------------------------------------------------------------------------------------------------------------------------------------------------------------------
-------------------------%%%%%%%-----------k--kg--------------------%--------------------------------------#---#-------------tt-------------------------------------------------------------------------
-------------------------|||||||---S-S-----%%%%%%------------------y|-------------------------------------##---##------------tt--g----------------------------------------------------------------------
--------------#--#----%%%%%%%%%%%%---------||||||-----#---#--%%%%%%%%%%%%%%%---%%%%-----------%%%%--%%%%%%%%---%%%%----------tt-%%%%%%%%%%%-------------------------------------------------------------
%%%%%%%%%%---##--##---||||||||||||--%------||||||---%%%---%%%|||||||||||||||---||||%%%---%%%--||||--||||||||---||||------%%%%%%%|||||||||||-------------------------------------------------------------
||||||||||--###--###--||||||||||||--|--y---||||||---|||---||||||||||||||||||---|||||||---|||--||||--||||||||---||||------||||||||||||||||||-------------------------------------------------------------
||||||||||XXXXX--XXXXX||||||||||||XXXXXXXXXXXXXXXXXX|||---||||||||||||||||||---|||||||---|||XX||||--||||||||---||||XX--XX||||||||||||||||||XXXXXXXXFXXXXXXXXXXXXXXXXXXXXXXXXXXXXXXXXXXXXXXXXXXXXXXXXXXXX
