HEIGHT=16;WIDTH=201;THEME=0;OVERRIDE=false
--------------------------------------------------------------------------------------------------------------------------------------------------------------------------------------------------------
--------------------------------------------------------------------------------------------------------------------------------------------------------------------------------------------------------
--------------------------------------------------------------------------------------------------------------------------------------------------------------------------------------------------------
--------------------------------------------------------------------------------------------------------------------------------------------------------------------------------------------------------
--------------------------------------------------------------------------------------------------------------------------------------------------------------------------------------------------------
--------------------------------------------------------------------------------------------------------------------------------------------------------------------------------------------------------
--------------------------------------------------------------------------------------------------------------------------------------------------------------------------------------------------------
--------------------------------------------------------------------------------------------------------------------------------------------------------------------------------------------------------
--------------------------------------------------------------------------------------------------------------------------------------------------------------------------------------------------------
--------------------------------------------tt----------------------------------------------------------------------------------------------------------------------------------------------------------
--------------------------------------------tt----------------------%%%%--------------------------------------------------------------------------------------------------------------------------------
--------------------------------------------tt----------------------||||--------------------------------------------------------------------------------------------------------------------------------
------------------------------------------%%%%%%%------------%%--%%-||||----y-----------------------------------%%%%--%%%%------------------------------------------------------------------------------
----------%%%%%--%%%%%------------------k-|||||||----Tt------||--||%%%%%%%%%%%%%--------%%%%%---%%%%%%%%%---%%%%||||--||||------------------------------------------------------------------------------
----------|||||--|||||%%---%%----%%%%%%%%%|||||||----tt------||--|||||||||||||||--------|||||---|||||||||---||||||||--||||------------------------------------------------------------------------------
XXXXXXXXXX|||||--|||||||---||XXXX||||||||||||||||XXXXXXXXXXXX||--|||||||||||||||XXXXXXXX|||||---|||||||||---||||||||--||||XXXXXXXXX---XXXXXXXXXXXXXFXXXXXXXXXXXXXXXXXXXXXXXXXXXXXXXXXXXXXXXXXXXXXXXXXXXX
