HEIGHT=16;WIDTH=201;THEME=0;OVERRIDE=false
--------------------------------------------------------------------------------------------------------------------------------------------------------------------------------------------------------
--------------------------------------------------------------------------------------------------------------------------------------------------------------------------------------------------------
--------------------------------------------------------------------------------------------------------------------------------------------------------------------------------------------------------
--------------------------------------------------------------------------------------------------------------------------------------------------------------------------------------------------------
--------------------------------------------------------------------------------------------------------------------------------------------------------------------------------------------------------
--------------------------------------------------------------------------------------------------------------------------------------------------------------------------------------------------------
--------------------------------------------------------------------------------------------------------------------------------------------------------------------------------------------------------
--------------------------------------------------------------------------------------------------------------------------------------------------------------------------------------------------------
-------------------------------------------------------------------------%%%%%--------------------------------------------------------------------------------------------------------------------------
-------------------------------------------------------------------------|||||--------------------------------------------------------------------------------------------------------------------------
-------------------------------------------------------------------------|||||r----------------------k--------------------------------------------------------------------------------------------------
-------------------------------------------------------------------------||%%%%%%---------------%%%%%%--------------------------------------------------------------------------------------------------
---------------------------y------------------------------------r--------||||||||---------------||g|||--rr----------------------------------------------------------------------------------------------
-------------------------%%%%%%%%%%------------%%%%---%%%%%%%%%%%%%%%%%%-||||||||-------------%%%%%%%%%%%%%%%%%%%%%%%%%%%%---%%%%%%%%%--%%%%%-----------------------------------------------------------
%%%%%%%%%%%%%--%%%%%---%%||||||||||%%%%%--%%%%%||||---||||||||||||||||||-|||||||g-----%%%%%%%%||||||||||||||||||||||||||||---|||||||||--|||||%%%%%%%%F%%%%%%%%%%%%%%%%%%%%%%%%%%%%%%%%%%%%%%%%%%%%%%%%%%
|||||||||||||--|||||---|||||||||||||||||--|||||||||---||||||||||||||||||XXXXXXXXXXXXXX||||||||||||||||||||||||||||||||||||---|||||||||--|||||||||||||X||||||||||||||||||||||||||||||||||||||||||||||||||
