HEIGHT=16;WIDTH=201;THEME=0;OVERRIDE=false
--------------------------------------------------------------------------------------------------------------------------------------------------------------------------------------------------------
--------------------------------------------------------------------------------------------------------------------------------------------------------------------------------------------------------
--------------------------------------------------------------------------------------------------------------------------------------------------------------------------------------------------------
--------------------------------------------------------------------------------------------------------------------------------------------------------------------------------------------------------
--------------------------------------------------------------------------------------------------------------------------------------------------------------------------------------------------------
--------------------------------------------------------------------------------------------------------------------------------------------------------------------------------------------------------
--------------------------------------------------------------------------------------------------------------------------------------------------------------------------------------------------------
--------------------------------------------------------------------------------------------------------------------------------------------------------------------------------------------------------
--------------------------------------------------------------------------------------------------------------------------------------------------------------------------------------------------------
--------------------------------------#--#--------------------------------------------------------------------------g-----------------------------------------------------------------------------------
-------------------------------------##--##-------------------------------------------------------------------------%%%%%%%-----------------------------------------------------------------------------
------------------------------------###--###--------------------------------------------------------------SCC-S-----|||||||-----------------------------------------------------------------------------
%%%%%%%%%%---------------%%%---%%%%%%%%--%%%%%----------------------%%%%%%%----#---#--------------------------------|||||||----------%%%%%--%%%%%%%%%%%%%F%%%%%%%%%%%%%%%%%%%%%%%%%%%%%%%%%%%%%%%%%%%%%%
||||||||||---------------|||---||||||||--|||||%%%%--%%%%------------|||g|||--%%%---%%%-----------------------%------||r|||r--%%%--%%%|||||--|||||||||||||%||||||||||||||||||||||||||||||||||||||||||||||
||||||||||--#---#--------|||---||||||||--|||||||||--||||%%--%%--%%%%%%%%%%%%%|||---|||------%%%%--%%%%-------|---%%%%%%%%%%%%|||--||||||||--||||||||||||||||||||||||||||||||||||||||||||||||||||||||||||
||||||||||XXX---XXXXX--XX|||---||||||||--|||||||||--||||||--||XX||||||||||||||||---|||XX--XX||||--||||XXXXXXXXXXX|||||||||||||||--||||||||--||||||||||||||||||||||||||||||||||||||||||||||||||||||||||||
