HEIGHT=16;WIDTH=201;THEME=0;OVERRIDE=false
--------------------------------------------------------------------------------------------------------------------------------------------------------------------------------------------------------
--------------------------------------------------------------------------------------------------------------------------------------------------------------------------------------------------------
--------------------------------------------------------------------------------------------------------------------------------------------------------------------------------------------------------
--------------------------------------------------------------------------------------------------------------------------------------------------------------------------------------------------------
--------------------------------------------------------------------------------------------------------------------------------------------------------------------------------------------------------
--------------------------------------------------------------------------------------------------------------------------------------------------------------------------------------------------------
--------------------------------------------------------------------------------------------------------------------------------------------------------------------------------------------------------
--------------------------------------------------------------------------------------------------------------------------------------------------------------------------------------------------------
--------------------------------------------------------------------------------------------------------------------------------------------------------------------------------------------------------
--------------------------------------------------------------------------------------------2SS---------------------------------------------------------------------------------------------------------
----------------------------------------------------------------SSSS------------------------------------------------------------------------------------------------------------------------------------
-----------------------------------------------------------------------------------------------%--------------------------------------------------------------------------------------------------------
-------------------------tt-Tt-Tt---------------------------------------------------------r---r|-----------------------------%%%%%%%%%%%%--%%%%%%%%%%%F%%%%%%%%%%%%%%%%%%%%%%%%%%%%%%%%%%%%%%%%%%%%%%%%%
------------%%%%%--%%%%%-tt-tt-tt---%%%---%%%----------------------g--------------------%%%%%%%%%%%--%%----------------------||||||||||||--|||||||||||%|||||||||||||||||||||||||||||||||||||||||||||||||
------------|||||--|||||-tt-tt-tt---|||---|||%%%%%%%%%--%%%%%%%%%%%%%%------------------|||||||||||--||----------------------||||||||||||--|||||||||||||||||||||||||||||||||||||||||||||||||||||||||||||
XXXXXXXXXXXX|||||--|||||XXXXXXXXXXXX|||---||||||||||||--||||||||||||||XX---XXXXXX---XXXX|||||||||||--||XXXX--XXXXXXXXX--XXXXX||||||||||||--|||||||||||||||||||||||||||||||||||||||||||||||||||||||||||||
