HEIGHT=16;WIDTH=201;THEME=0;OVERRIDE=false
--------------------------------------------------------------------------------------------------------------------------------------------------------------------------------------------------------
--------------------------------------------------------------------------------------------------------------------------------------------------------------------------------------------------------
--------------------------------------------------------------------------------------------------------------------------------------------------------------------------------------------------------
--------------------------------------------------------------------------------------------------------------------------------------------------------------------------------------------------------
--------------------------------------------------------------------------------------------------------------------------------------------------------------------------------------------------------
--------------------------------------------------------------------------------------------------------------------------------------------------------------------------------------------------------
--------------------------------------------------------------------------------------------------------------------------------------------------------------------------------------------------------
--------------------------------------------------------------------------------------------------------------------------------------------------------------------------------------------------------
---------------------------------------------------------------------------------------Y---r--------------------------------%%%%------------------------------------------------------------------------
-------------------------------------------------------------------------------------%%%%%%%--------------------------------||||------------------------------------------------------------------------
--------------------------------------kgy--------------------------------------------|||||||--------------------------------||||------------------------------------------------------------------------
-------------------------------------%%%%%---------------------------#--#------------|||||||------------------------------%%%%||------------------------------------------------------------------------
%%%%%%%%%%%%%----------------#--#----|||||--------------------------##--##-----------|||||||--------%%%-------------------||||||------%%%%%%%-----------------------------------------------------------
|||||||||||||---------------##--##--%%%%%%%%%%%%%%%%%%-------%%%%%%%%%--%%%%------%%%%%%%%%%%%%%%%%%|||%%%%%---%%%%%------||||||------|||||||-----------------------------------------------------------
|||||||||||||%%%%%---%%%%%%%%%--%%%%||||||||||||||||||%%%----|||||||||--||||%%--%%||||||||||||||||||||||||||---|||||-y----||||y|------|||||||%%%%%%%%F%%%%%%%%%%%%%%%%%%%%%%%%%%%%%%%%%%%%%%%%%%%%%%%%%%
||||||||||||||||||---|||||||||--|||||||||||||||||||||||||XXXX|||||||||--||||||--||||||||||||||||||||||||||||---|||||XXXXXXXXXXXXXXXXXX|||||||||||||||X||||||||||||||||||||||||||||||||||||||||||||||||||
