HEIGHT=16;WIDTH=201;THEME=0;OVERRIDE=false
--------------------------------------------------------------------------------------------------------------------------------------------------------------------------------------------------------
--------------------------------------------------------------------------------------------------------------------------------------------------------------------------------------------------------
--------------------------------------------------------------------------------------------------------------------------------------------------------------------------------------------------------
--------------------------------------------------------------------------------------------------------------------------------------------------------------------------------------------------------
--------------------------------------------------------------------------------------------------------------------------------------------------------------------------------------------------------
--------------------------------------------------------------------------------------------------------------------------------------------------------------------------------------------------------
--------------------------------------------------------------------------------------------------------------------------------------------------------------------------------------------------------
--------------------------------------------------------------------------------------------------------------------------------------------------------------------------------------------------------
--------------------------------------------------------------------------------------------------------------------------------------------------------------------------------------------------------
------------2SSS-------------#---#--------------------------------------------------------------------------------------------------------k-g-----------------------------------------------------------
----------------------------##---##-------------------------------------%%%%%%--------------------------------------------------------%%%%%%%-----------------------------------------------------------
---------------------------###---###------------------------------------||||||---------------------------------------------CS22-------|||||||-----------------------------------------------------------
-------------------%%--%%%%%%%---%%%%%%%%%---%%%%--#---#--%%%%--%%%%----||||||--------------------------------------------------------|||||||-----------------------------------------------------------
-----------%%%%%%%%||--|||||||---|||||||||---||||%%%---%%%||||--||||-y--||||||--------------------------------%%%---%%%--------------y|||||||-----------------------------------------------------------
-----------||||||||||--|||||||---|||||||||---|||||||---|||||||--||||%%%%%%%%%%%%%%%--%%%%%---%%%%%%%--%%%%%%%%|||---|||-------g-%%%%%%%%%%%%%%%%%%%%%%%F%%%%%%%%%%%%%%%%%%%%%%%%%%%%%%%%%%%%%%%%%%%%%%%%
XXXXXXXXXXX||||||||||--|||||||---|||||||||---|||||||---|||||||--|||||||||||||||||||--|||||---|||||||--|||||||||||---|||XXXXXXXXX|||||||||||||||||||||||X||||||||||||||||||||||||||||||||||||||||||||||||
