HEIGHT=16;WIDTH=201;THEME=0;OVERRIDE=false
--------------------------------------------------------------------------------------------------------------------------------------------------------------------------------------------------------
--------------------------------------------------------------------------------------------------------------------------------------------------------------------------------------------------------
--------------------------------------------------------------------------------------------------------------------------------------------------------------------------------------------------------
--------------------------------------------------------------------------------------------------------------------------------------------------------------------------------------------------------
----------------------------------------------------------------------K---------------------------------------------------------------------------------------------------------------------------------
----------------------------------------------------------------------%%%-------------------------------------------------------------------------------------------------------------------------------
----------------------------------------------------------------------|||-------------------------------------------------------------------------------------------------------------------------------
----------------------------------------------------------------------|r|-------------------------------------------------------------------------------------------------------------------------------
---------------------------------------SSCSS------------------------%%%%|-------------------------------------------------------------------------------------------------------------------------------
--------------------------------------------------------------------|||||-------------------------------------------------------------------------------------------------------------------------------
--------------------------------------------------------------------|||||--%%%--------------------------------------------------------------------------------------------------------------------------
-----------------------------------------g--------------------------|||||--|||--------------------------------------------------------------------------------------------------------------------------
%%%%%%%%%%%%%---#---#---------------%%%%%%%%%%%%%%%--%%%%----------g|||||--|||--r---%%%---%%%----------%%--------------------%%%%%---%%%%%--------------------------------------------------------------
|||||||||||||--##---##--------------|||||||||||||||--||||%%%--%%%%%%%%%%%%%%%%%%%%%%|||---|||----------||--------------------|||||---|||||--------------------------------------------------------------
|||||||||||||%%%%---%%%%------%%--%%|||||||||||||||--|||||||--|||||||||||||||||||||||||---|||%%--------||%%%%%---%%%%%%%---%%|||||---|||||--------------------------------------------------------------
|||||||||||||||||---||||XXXXXX||--|||||||||||||||||--|||||||--|||||||||||||||||||||||||---|||||XXX--XXX|||||||---|||||||---|||||||---|||||XXXXXXXXFXXXXXXXXXXXXXXXXXXXXXXXXXXXXXXXXXXXXXXXXXXXXXXXXXXXXX
