HEIGHT=16;WIDTH=201;THEME=0;OVERRIDE=false
--------------------------------------------------------------------------------------------------------------------------------------------------------------------------------------------------------
--------------------------------------------------------------------------------------------------------------------------------------------------------------------------------------------------------
--------------------------------------------------------------------------------------------------------------------------------------------------------------------------------------------------------
--------------------------------------------------------------------------------------------------------------------------------------------------------------------------------------------------------
--------------------------------------------------------------------------------------------------------------------------------------------------------------------------------------------------------
--------------------------------------------------------------------------------------------------------------------------------------------------------------------------------------------------------
--------------------------------------------------------------------------------------------------------------------------------------------------------------------------------------------------------
----------------------------------------------------------------------------------------------------------%%%%%%%---------------------------------------------------------------------------------------
----------------------------------------------------------------------------------------------------------|||||||---------------------------------------------------------------------------------------
-------------------------------------------------#---#----------------------------------------------------||||y||---------------------------------------------------------------------------------------
----------------22S-USC-------------------------##---##---------------------------------------------------||%%%||---------------r----------g------------------------------------------------------------
-----------------------------------------------###---###--------------------------------------------------|||||||------------%%%%%%-------%%%-----------------------------------------------------------
%%%%%%%%%%%%%%-----%-----%%%%---------#---#--%%%%%---%%%%%--#--#-------------%%%%---%%%%------------------|||||||------------||||||-------|||-----------------------------------------------------------
||||||||||||||--g--|-----||||-------%%%---%%%|||||---|||||%%%--%%%-tt-tt-----||||---||||------------------||r||y|-----------%%%%%%%%%%----|||----------%%%%%%%%F%%%%%%%%%%%%%%%%%%%%%%%%%%%%%%%%%%%%%%%%
||||||||||||||%%%%%%%%%%%||||-------|||---||||||||---||||||||--|||-tt-tt-----||||---||||-------------%%%%%%%%%%%%%%%%-------||||||||||----y||----------||||||||%||||||||||||||||||||||||||||||||||||||||
|||||||||||||||||||||||||||||XX---XX|||---||||||||---||||||||--|||XXXXXXXXXXX||||---||||XXXXX---XXXXX||||||||||||||||XX---XX||||||||||XXXXXXXXXXXXXXXXX|||||||||||||||||||||||||||||||||||||||||||||||||
