HEIGHT=16;WIDTH=201;THEME=0;OVERRIDE=false
--------------------------------------------------------------------------------------------------------------------------------------------------------------------------------------------------------
--------------------------------------------------------------------------------------------------------------------------------------------------------------------------------------------------------
--------------------------------------------------------------------------------------------------------------------------------------------------------------------------------------------------------
--------------------------------------------------------------------------------------------------------------------------------------------------------------------------------------------------------
--------------------------------------------------------------------------------------------------------------------------------------------------------------------------------------------------------
--------------------------------------------------------------------------------------------------------------------------------------------------------------------------------------------------------
--------------------------------------------------------------------------------------------------------------------------------------------------------------------------------------------------------
--------------------------------------------------------------------------------------------------------------------------------------------------------------------------------------------------------
---------------------------------CCSSC2S----------------------------------------------------------------------------------------------------------------------------------------------------------------
-----------------%%%%-------------------------------------------SSS-SSSC----------------------------------------------------#--#------------------------------------------------------------------------
-----------------|r||------------------------------------------------------------------------------------------------------##--##-----------------------------------------------------------------------
-----------------|%%%%%%--------------yg---------------------------|---------------------%%%------------------------------###--###----------------------------------------------------------------------
-----------------|||y|||----%%%%%%%%%%%%%%-------------------------y-y-------------------|||--------%%%%--%%%%%%%%%%%%%%%%%%%--%%%%%-----------%%%%%%%%F%%%%%%%%%%%%%%%%%%%%%%%%%%%%%%%%%%%%%%%%%%%%%%%%
--------------%%%%%%%%%%%%%%||||||||||||||---------%%%%%--%%%%%%%%%%%%%%%%------------%%%%%%%%%%%%%%||||--|||||||||||||||||||--|||||-----------||||||||%||||||||||||||||||||||||||||||||||||||||||||||||
--------------||||||||||||||||||||||||||||%%%%%%%%%|||||--||||||||||||||||------------||||||||||||||||||--|||||||||||||||||||--|||||%%%%---%%%%|||||||||||||||||||||||||||||||||||||||||||||||||||||||||
XXXXXXXXXXXXXX||||||||||||||||||||||||||||||||||||||||||--||||||||||||||||XX--XXXX--XX||||||||||||||||||--|||||||||||||||||||--|||||||||---|||||||||||||||||||||||||||||||||||||||||||||||||||||||||||||
