HEIGHT=16;WIDTH=201;THEME=0;OVERRIDE=false
--------------------------------------------------------------------------------------------------------------------------------------------------------------------------------------------------------
--------------------------------------------------------------------------------------------------------------------------------------------------------------------------------------------------------
--------------------------------------------------------------------------------------------------------------------------------------------------------------------------------------------------------
--------------------------------------------------------------------------------------------------------------------------------------------------------------------------------------------------------
--------------------------------------------------------------------------------------------------------------------------------------------------------------------------------------------------------
--------------------------------------------------------------------------------------------------------------------------------------------------------------------------------------------------------
--------------------------------------------------------------------------------------------------------------------------------------------------------------------------------------------------------
--------------------------------------------------------------------------------------------------------------------%%%%%-------------------------------------------------------------------------------
--------------------------------------------------------------------------------------------------------------------|||||-------------------------------------------------------------------------------
--------------------------------------------------------------------------------------------------------------------|||||-------------------------------------------------------------------------------
------------------------------------------------------------------2CSS--------------------------------------------%%%%|||-------------------------------------------------------------------------------
------------------------------------------------------------------------------------------------------------------|||||||-------------------------------------------------------------------------------
%%%%%%%%%%%%%-------------------------------#---#----------------------%%%---%%%----------%%%%--%%%%--------------|||||||-----#---#---------------------------------------------------------------------
|||||||||||||------------------------tt----##---##-----------------y---|||---|||%%%%--%%%%||||--||||--------------|||||k|r---##---##--%%--%%------------------------------------------------------------
|||||||||||||------------------------tt--%%%%---%%%%-----------%%%%%%%%|||---|||||||--||||||||--||||%%--%%-------%%%%%%%%%%%%%%---%%%%||--||------------------------------------------------------------
|||||||||||||XXX---XXXXXXX---XXXXXXXXXXXX||||---||||XXXX---XXXX|||||||||||---|||||||--||||||||--||||||--||XX---XX||||||||||||||---||||||--||XXXXXXXXFXXXXXXXXXXXXXXXXXXXXXXXXXXXXXXXXXXXXXXXXXXXXXXXXXXX
