HEIGHT=16;WIDTH=201;THEME=0;OVERRIDE=false
--------------------------------------------------------------------------------------------------------------------------------------------------------------------------------------------------------
--------------------------------------------------------------------------------------------------------------------------------------------------------------------------------------------------------
--------------------------------------------------------------------------------------------------------------------------------------------------------------------------------------------------------
--------------------------------------------------------------------------------------------------------------------------------------------------------------------------------------------------------
--------------------------------------------------------------------------------------------------------------------------------------------------------------------------------------------------------
----------------------SSSS------------------------------------------------------------------------------------------------------------------------------------------------------------------------------
--------------------------------------------------------------------------------------------------------------------------------------------------------------------------------------------------------
--------------------------------------------------------------------------------------------------------------------------------------------------------------------------------------------------------
--------------------------------------------------------------------------------------------------------------------------------------------------------------------------------------------------------
--------------------%%%%%%------------------------------------------------------------------------------------------------------------------------------------------------------------------------------
--------------------||||||------------SCU---------------------------------------------------------------------------------------------------------------------------------------------------------------
--------------------||||||---g-y---------------------------------------g-----------------#---#----------------------------------------------------------------------------------------------------------
%%%%%%%%%%%%%-------r||||r--%%%%%%%%-----%----------------------------%%%%%%%%---------%%%---%%%--------%%%--%%%------------%%%--%%%--------------------------------------------------------------------
|||||||||||||%%%%%%%%%%%%%%%||||||||-----|---%%--%%-------%%%%%--%%%%%||||||||%%%---%%%|||---|||--------|||--|||%%%%%--%%%%%|||--|||-----------%%%%%%%%F%%%%%%%%%%%%%%%%%%%%%%%%%%%%%%%%%%%%%%%%%%%%%%%%
||||||||||||||||||||||||||||||||||||%%%%%%%%%||--||-------|||||--||||||||||||||||---||||||---|||%%%--%%%|||--||||||||--||||||||--|||-----------||||||||%||||||||||||||||||||||||||||||||||||||||||||||||
|||||||||||||||||||||||||||||||||||||||||||||||--||XX---XX|||||--||||||||||||||||---||||||---||||||--||||||--||||||||--||||||||--|||XXXX---XXXX|||||||||||||||||||||||||||||||||||||||||||||||||||||||||
