HEIGHT=16;WIDTH=201;THEME=0;OVERRIDE=false
--------------------------------------------------------------------------------------------------------------------------------------------------------------------------------------------------------
--------------------------------------------------------------------------------------------------------------------------------------------------------------------------------------------------------
--------------------------------------------------------------------------------------------------------------------------------------------------------------------------------------------------------
--------------------------------------------------------------------------------------------------------------------------------------------------------------------------------------------------------
--------------------------------------------------------------------------------------------------------------------------------------------------------------------------------------------------------
--------------------------------------------------------------------------------------------------------------------------------------------------------------------------------------------------------
--------------------------------------------------------------------------------------------------------------------------------------------------------------------------------------------------------
--------------------------------------------------------------------------------------------------------------------------------------------------------------------------------------------------------
--------------------------------------------------------------------------------------------------------------------------------------------------------------------------------------------------------
--------------------------------------------------------------------------------------------------------------------------------------------------------------------------------------------------------
--------------------------------------------------------------------------------------------------------------------------------------------------------------------------------------------------------
-----------------------------------------------------------------------#---#----------------------------------------------------------------------------------------------------------------------------
%%%%%%%%%%%%%%-----------------k-kk----------------------------------%%%---%%%%%%------------------------------------------------%%---%%----------------------------------------------------------------
||||||||||||||---------%%%%%%%%%%%%%%----------------------------%%%%|||---||||||----------------------#--#----------------------||---||----------------------------------------------------------------
||||||||||||||--#---#--||||||||||||||%%%---%%%%%%--%%%-----------|||||||---||||||%%---%%--------------##--##--%%%%%---%%%%%%%--%%||---||%%%%%%%%F%%%%%%%%%%%%%%%%%%%%%%%%%%%%%%%%%%%%%%%%%%%%%%%%%%%%%%%
||||||||||||||XXX---XXX|||||||||||||||||---||||||--|||XXXX---XXXX|||||||---||||||||---||XXXXX--XXXXXXXXX--XXXX|||||---|||||||--||||---||||||||||X|||||||||||||||||||||||||||||||||||||||||||||||||||||||
