HEIGHT=16;WIDTH=201;THEME=0;OVERRIDE=false
--------------------------------------------------------------------------------------------------------------------------------------------------------------------------------------------------------
--------------------------------------------------------------------------------------------------------------------------------------------------------------------------------------------------------
--------------------------------------------------------------------------------------------------------------------------------------------------------------------------------------------------------
--------------------------------------------------------------------------------------------------------------------------------------------------------------------------------------------------------
------------------------------------------------------------------------------------------------------------k-k-----------------------------------------------------------------------------------------
----------------------------------------------------------------------------------------------------------%%%%%%%---------k-----------------------------------------------------------------------------
----------------------------------------------------------------------------------------------------------|||||||--------%%%%---------------------------------------------------------------------------
----------------------------------------------------------------------------------------------------------|||||||--------||||---------------------------------------------------------------------------
----------------------------------------------------------------------------------------------------------|||%%%|--------||||---------------------------------------------------------------------------
---------------CS2SCSSS--------------------------------2SSS2SSU-------------------------------------------|||||||--------||||---------------------------------------------------------------------------
----------------------------------------------------------------------------------------------------------|||||||--------||%%%%%%-------#---#-----------------------------------------------------------
-------------------------------------------------------------------r------#--#----------------------------|||||||--------|||k||||------##---##----------------------------------------------------------
%%%%%%%%%%%%%-----y-----%%%%-----------------------------K-------%%%%%%--##--##----#--#-------------------|%%%|||-------%%%%%%%%%%%%%%%%%---%%%%--------------------------------------------------------
|||||||||||||%%%%%%%%%%%||||--------------------------%%%%%%%%%%%||||||%%%%--%%%%%%%--%%%-----------------r||||||-r-----|||||||||||||||||---||||--------------------------------------------------------
||||||||||||||||||||||||||||-------------%%%%%---%%%%%|||||||||||||||||||||--|||||||--|||%%%%---%%%%%%%%%%%%%%%%%%%%----|||||||||||||||||---||||--------------------------------------------------------
||||||||||||||||||||||||||||XXXXX---XXXXX|||||---||||||||||||||||||||||||||--|||||||--|||||||---||||||||||||||||||||XXXX|||||||||||||||||---||||XXXXXXXXFXXXXXXXXXXXXXXXXXXXXXXXXXXXXXXXXXXXXXXXXXXXXXXX
