HEIGHT=16;WIDTH=201;THEME=0;OVERRIDE=false
--------------------------------------------------------------------------------------------------------------------------------------------------------------------------------------------------------
--------------------------------------------------------------------------------------------------------------------------------------------------------------------------------------------------------
--------------------------------------------------------------------------------------------------------------------------------------------------------------------------------------------------------
--------------------------------------------------------------------------------------------------------------------------------------------------------------------------------------------------------
--------------------------------------------------------------------------------------------------------------------------------------------------------------------------------------------------------
--------------------------------------------------------------------------------------------------------------------------------------------------------------------------------------------------------
--------------------------------------------------------------------------------------------------------------------------------------------------------------------------------------------------------
--------------------------------------------------------------------------------------------------------------------------------------------------------------------------------------------------------
-----------------------------------------------------------------------------------------------------------------------------------------CSSCS----------------------------------------------------------
--------------------------------------------------------------------------------------------------------------------------------------------------------------------------------------------------------
---------------------------------------------------#--#-------------------------------------------------------------------------------------------------------------------------------------------------
-----------------------------------------SUS------##--##-----#--#-----------------------------------------------------------------------r---g-----------------------------------------------------------
--------------tt---tt----------%%--%%------------###--###--%%%--%%%%%%%%%%-------------------------%%%%%---%%%%%------%%%---%%%--------%%%%%%%%%--------------------------------------------------------
--------------tt---tt----------||--||--------%%%%%%%--%%%%%|||--||||||||||-------------------------|||||---|||||------|||---|||--------|||||||||%%%%%%%%F%%%%%%%%%%%%%%%%%%%%%%%%%%%%%%%%%%%%%%%%%%%%%%%
%%%%%%%%%%%%%%%%%%%%%%%%%%--%%%||--||--------|||||||--||||||||--||||||||||-----------#--#----#--#--|||||---|||||%%--%%|||---|||%%%--%%%|||||||||||||||||%|||||||||||||||||||||||||||||||||||||||||||||||
||||||||||||||||||||||||||--|||||--||XXXXXXXX|||||||--||||||||--||||||||||XXX---XXXXXX--XXXXXX--XXX|||||---|||||||--|||||---||||||--||||||||||||||||||||||||||||||||||||||||||||||||||||||||||||||||||||
