HEIGHT=16;WIDTH=201;THEME=0;OVERRIDE=false
--------------------------------------------------------------------------------------------------------------------------------------------------------------------------------------------------------
--------------------------------------------------------------------------------------------------------------------------------------------------------------------------------------------------------
--------------------------------------------------------------------------------------------------------------------------------------------------------------------------------------------------------
--------------------------------------------------------------------------------------------------------------------------------------------------------------------------------------------------------
--------------------------------------------------------------------------------------------------------------------------------------------------------------------------------------------------------
--------------------------------------------------------------------------------------------------------------------------------------------------------------------------------------------------------
--------------------------------------------------------------------------------------------------------------------------------------------------------------------------------------------------------
--------------------------------------------------------------------------------------------------------------------------------------------------------------------------------------------------------
-------------------------------------------------------------------------SSSSS-----CS-C-----------------------------------------------------------------------------------------------------------------
--------------------------------------------------------------------------------------------------------------------------------------------------------------------------------------------------------
-------------------------------------------------------------------------------------%------------------------------------------------------------------------------------------------------------------
-----------------------------------------#--#------------------------------------yr--|------------------------------------------------------------------------------------------------------------------
------------------#--#-----------------%%%--%%%%%%%%--%%%%%-----------%%%%%%%%%%%%%%%%%%%%%%%%--%%%%%---------------%%%---%%%%%%------------------------------------------------------------------------
-----------------##--##----------------|||--||||||||--|||||%%%%---%%%%||||||||||||||||||||||||--|||||-----------%%%%|||---||||||%%---%%-----------------------------------------------------------------
%%%%%%%%%%%%%%--###--###---------------|||--||||||||--|||||||||---||||||||||||||||||||||||||||--|||||%%%%---%%%%|||||||---||||||||---||%%%--------------------------------------------------------------
||||||||||||||XXXXX--XXXXXXXXXX---XXXXX|||--||||||||--|||||||||---||||||||||||||||||||||||||||--|||||||||---|||||||||||---||||||||---|||||XXXXXXXXFXXXXXXXXXXXXXXXXXXXXXXXXXXXXXXXXXXXXXXXXXXXXXXXXXXXXX
