HEIGHT=16;WIDTH=201;THEME=0;OVERRIDE=false
--------------------------------------------------------------------------------------------------------------------------------------------------------------------------------------------------------
--------------------------------------------------------------------------------------------------------------------------------------------------------------------------------------------------------
--------------------------------------------------------------------------------------------------------------------------------------------------------------------------------------------------------
--------------------------------------------------------------------------------------------------------------------------------------------------------------------------------------------------------
--------------------------------------------------------------------------------------------------------------------------------------------------------------------------------------------------------
--------------------------------------------------------------------------------------------------------------------------------------------------------------------------------------------------------
--------------------------------------------------------------------------------------------------------------------------------------------------------------------------------------------------------
--------------------------------------------------------------------------------------------------------------------------------------------------------------------------------------------------------
-------------------------------------%%%%%%-------------------------------------------------------------------------------------------------------------------------------------------------------------
-------------------------------------||||||-------------------------------------------------------------------------------------------------------------------------------------------------------------
---------------------------------%%%%%|||||-------------------------------------------------------------------------------------------------------------------------------------------------------------
---------------------------------||||||||||-y--2SS2SU-------------------------------%%%%%%%-------------------------------------------------------------------------------------------------------------
--------------------------------%%%%%%%%%%%%%%----------------------------#--#------|||||||---------------------------#---#--%%%%--%%%%-----------------------------------------------------------------
----------------------%%%%--%%%%||||||||||||||-----------%%--------------##--##-----|g|||||-------------------------%%%---%%%||||--||||-----------------------------------------------------------------
--------------%%%%%%%%||||--||||||||||||||||||--------r--||------------%%%%--%%%%%%%%%%%%%%%%%%%%%%%%--%%%%---------|||---|||||||--||||%%%--%%%---------------------------------------------------------
XXXXXXXXXXXXXX||||||||||||--||||||||||||||||||XXXXXXXXXXX||XXXXX--XXXXX||||--||||||||||||||||||||||||--||||XXX---XXX|||---|||||||--|||||||--|||XXXXXXXXFXXXXXXXXXXXXXXXXXXXXXXXXXXXXXXXXXXXXXXXXXXXXXXXX
