HEIGHT=16;WIDTH=201;THEME=0;OVERRIDE=false
--------------------------------------------------------------------------------------------------------------------------------------------------------------------------------------------------------
--------------------------------------------------------------------------------------------------------------------------------------------------------------------------------------------------------
--------------------------------------------------------------------------------------------------------------------------------------------------------------------------------------------------------
--------------------------------------------------------------------------------------------------------------------------------------------------------------------------------------------------------
--------------------------------------------------------------------------------------------------------------------------------------------------------------------------------------------------------
--------------------------------------------------------------------------------------------------------------------------------------------------------------------------------------------------------
--------------------------------------------------------------------------------------------------------------------------------------------------------------------------------------------------------
----------------------U22S------------------------------------------------------------------------------------------------------------------------------------------------------------------------------
--------------------------------------------------------------------------------------------------------------------------------------------------------------------------------------------------------
-------------------------------------------------------------------------------SUSS--------------Tt-------------%%%-------------------------------------------------------------------------------------
----------------------y-k------------------------------------------------------------------------tt---tt--------|||----------------------#---#----------------------------------------------------------
---------------------%%%%%%%---------------------------------------------------------------------tt---tt--------|||---------------------##---##---------------------------------------------------------
---------------------|||||||-----------------------%%--%%--------%%%---%%%------gk-------------%%%%%%%%%%-----%%%||-------------------%%%%---%%%%-------------------------------------------------------
-------------------y-|||||||-----------------------||--||--#--#--|||---|||-----%%%%%%----------||||||||||-----|||||---g-r-------------||||---||||-------------------------------------------------------
%%%%%%%%%%--------%%%%%%%%%%%%--#---#--%%%%%--%%%%%||--||%%%--%%%|||---|||-----||yyk|--%%%--%%%||||||||||%%%%%%%%%%%%%%%%%%-----------||||---||||%%%%%%%%F%%%%%%%%%%%%%%%%%%%%%%%%%%%%%%%%%%%%%%%%%%%%%%
||||||||||XXX--XXX||||||||||||XXX---XXX|||||--|||||||--|||||--||||||---|||XXXXXXXXXXXXX|||--|||||||||||||||||||||||||||||||XXXX---XXXX||||---||||||||||||X||||||||||||||||||||||||||||||||||||||||||||||
