HEIGHT=16;WIDTH=201;THEME=0;OVERRIDE=false
--------------------------------------------------------------------------------------------------------------------------------------------------------------------------------------------------------
--------------------------------------------------------------------------------------------------------------------------------------------------------------------------------------------------------
--------------------------------------------------------------------------------------------------------------------------------------------------------------------------------------------------------
--------------------------------------------------------------------------------------------------------------------------------------------------------------------------------------------------------
--------------------------------------------------------------------------------------------------------------------------------------------------------------------------------------------------------
--------------------------------------------------------------------------------------------------------------------------------------------------------------------------------------------------------
--------------------------------------------------------------------------------------------------------------------------------------------------------------------------------------------------------
--------------------------------------------------------------------------------------------------------------------------------------------------------------------------------------------------------
--------------------------------------------------------------------------------------------------------------------------------------------------------------------------------------------------------
---------------------------------------------------------------------------------------------------2CS------------------------USSSS---------------------------------------------------------------------
---------------------------------------------------------------------------Tt---------------------------------------------------------------------------------------------------------------------------
-----------------------------------------22SSSCS---------------------------tt---------------------------------------------------------------------------------------------------------------------------
---------------------------------------------------------------------------tt----------%%%--%%%----------%%%%%------------------------------------------------------------------------------------------
------------------------------%%%---%%%-%-------------------%%%%---%%%%%%%%%%%%%-------|||--|||%%%%%%%%%%|||||-------------%%%%%%%%%--------------------------------------------------------------------
---------------%%---%%--#--#--|||---|||-|--------%%%%---%%%%||||---|||||||||||||-------|||--||||||||||||||||||-------------|||||||||--------------------------------------------------------------------
XXXXXXXXXXXXXXX||---||XXX--XXX|||---|||XXXXXXXXXX||||---||||||||---|||||||||||||XX---XX|||--||||||||||||||||||XXXXX---XXXXX|||||||||XXXX--XXXXXXXXXXXXFXXXXXXXXXXXXXXXXXXXXXXXXXXXXXXXXXXXXXXXXXXXXXXXXX
