HEIGHT=16;WIDTH=201;THEME=0;OVERRIDE=false
--------------------------------------------------------------------------------------------------------------------------------------------------------------------------------------------------------
--------------------------------------------------------------------------------------------------------------------------------------------------------------------------------------------------------
--------------------------------------------------------------------------------------------------------------------------------------------------------------------------------------------------------
--------------------------------------------------------------------------------------------------------------------------------------------------------------------------------------------------------
--------------------------------------------------------------------------------------------------------------------------------------------------------------------------------------------------------
--------------------------------------------------------------------------------------------------------------------------------------------------------------------------------------------------------
--------------------------------------------------------------------------------------------------------------------------------------------------------------------------------------------------------
---------------------------SS---------------------------------------------------------------------------------------------------------------------------------------------------------------------------
--------------------------------------------------------------------------------------------------------------------------------------------------------------------------------------------------------
-----------------------------%-------------------------------------------------------------------------------------------------------%%%%---------------------------------------------------------------
-----------------------------|--------------------------------#--#------------------#--#---------------------------------------------||||---------------------------------------------------------------
------------------------%%%%%%-------------------------------##--##----------------##--##--------------------------------------------||||---------------------------------------------------------------
%%%%%%%%%%--------------||||||------------------------------###--###--%%%%--%%%%--###--###-------------------------%%--%%------------||%%%%%---%%%%%%%%F%%%%%%%%%%%%%%%%%%%%%%%%%%%%%%%%%%%%%%%%%%%%%%%%
||||||||||%%---%%%%--%%-||||||----------------------------%%%%%--%%%%%||||--||||%%%%%--%%%%%%%%%%--%%%%%%%%%%%---%%||--||------------|||||||---||||||||%||||||||||||||||||||||||||||||||||||||||||||||||
||||||||||||---||||--||-|y||||-----------------%%%%---%%%%|||||--|||||||||--|||||||||--||||||||||--|||||||||||---||||--||------------||||r||---|||||||||||||||||||||||||||||||||||||||||||||||||||||||||
||||||||||||---||||--||XXXXXXXXXXXXXXXXXX--XXXX||||---|||||||||--|||||||||--|||||||||--||||||||||--|||||||||||---||||--||XXXXXXXXXXXXXXXXXXXXXX|||||||||||||||||||||||||||||||||||||||||||||||||||||||||
