HEIGHT=16;WIDTH=201;THEME=0;OVERRIDE=false
--------------------------------------------------------------------------------------------------------------------------------------------------------------------------------------------------------
--------------------------------------------------------------------------------------------------------------------------------------------------------------------------------------------------------
--------------------------------------------------------------------------------------------------------------------------------------------------------------------------------------------------------
--------------------------------------------------------------------------------------------------------------------------------------------------------------------------------------------------------
--------------------------------------------------------------------------------------------------------------------------------------------------------------------------------------------------------
--------------------------------------------------------------------------------------------------------------------------------------------------------------------------------------------------------
--------------------------------------------------------------------------------------------------------------------------------------------------------------------------------------------------------
--------------------------------------------------------------------------------------------------------------------------------------------------------------------------------------------------------
------------SSSC-----------------------------------------------------------------------------------------------------------------------------y----------------------------------------------------------
-------------------------------------------------------------------------------------------------------------------------------------------%%%----------------------------------------------------------
----------------%--------------------------%%%---------------------------------------------------------------------------------------------|||----------------------------------------------------------
---------------y|-k------------------------|||--------------------------------------------------------------------------------------%%%%---|||----------------------------------------------------------
%%%%%%%%%%%%%%%%%%%%---%%%%%-----------k--y|||-------------------------------------------%%%%%---%%%%%------------------------------||||---|||------%%%%%%%%F%%%%%%%%%%%%%%%%%%%%%%%%%%%%%%%%%%%%%%%%%%%
||||||||||||||||||||---|||g|--%%%%%%%%%%%%%%%%%%%%%%%---%%%-----------------%%---%%------|||||---|||||-----------%%--%%-------------||||---|||------||||||||%|||||||||||||||||||||||||||||||||||||||||||
||||||||||||||||||||%%%%%%%%%%|||||||||||||||||||||||---|||-----------%%%%%%||---||%%--%%|||||---|||||%%%%---%%%%||--||%%%%%--%%%%%-|G||---|||----y-||||||||||||||||||||||||||||||||||||||||||||||||||||
|||||||||||||||||||||||||||||||||||||||||||||||||||||---|||XXXX---XXXX||||||||---||||--|||||||---|||||||||---||||||--|||||||--|||||XXXXXXXXXXXXXXXXX||||||||||||||||||||||||||||||||||||||||||||||||||||
