HEIGHT=16;WIDTH=201;THEME=0;OVERRIDE=false
--------------------------------------------------------------------------------------------------------------------------------------------------------------------------------------------------------
--------------------------------------------------------------------------------------------------------------------------------------------------------------------------------------------------------
--------------------------------------------------------------------------------------------------------------------------------------------------------------------------------------------------------
--------------------------------------------------------------------------------------------------------------------------------------------------------------------------------------------------------
--------------------------------------------------------------------------------------------------------------------------------------------------------------------------------------------------------
--------------------------------------------------------------------------------------------------------------------------------------------------------------------------------------------------------
------------------------------------------------------CSS-----------------------------------------------------------------------------------------------------------------------------------------------
--------------------------------------------------------------------------------------------------------------------------------------------------------------------------------------------------------
--------------------------------------------------------------------------------------------------------------------------------------------------------------------------------------------------------
--------------------------------------------------------------------------------------------------------------------------------------------------------------------------------------------------------
-----------------------------------------------------%%%%%%----------------------------------------#---#------------------------------------------------------------------------------------------------
-----------------------------------------------------||||||----------------------------2SSCSCS----##---##----------------2USCS--------------------------------------------------------------------------
%%%%%%%%%%-------------------------%%%%---------%%%%%%%%%%%%%%%%%%%------------------------------###---###----------------------------------------------------------------------------------------------
||||||||||%%%%%--%%%%%-----%%%%%%%%||||---------|||||||||||||||||||%%%%---%%%%-----------------%%%%%---%%%%%----------------------------%%%%%%%%F%%%%%%%%%%%%%%%%%%%%%%%%%%%%%%%%%%%%%%%%%%%%%%%%%%%%%%%
|||||||||||||||--|||||%%%%%||||||||||||---------|||||||||||||||||||||||---||||%%--%%---y-------|||||---|||||%%%%%--%%%%%---r---%%--%%%%%||||||||%|||||||||||||||||||||||||||||||||||||||||||||||||||||||
|||||||||||||||--||||||||||||||||||||||XXXXXXXXX|||||||||||||||||||||||---||||||--||XXXXXXXXXXX|||||---||||||||||--|||||XXXXXXX||--|||||||||||||||||||||||||||||||||||||||||||||||||||||||||||||||||||||
