HEIGHT=16;WIDTH=201;THEME=0;OVERRIDE=false
--------------------------------------------------------------------------------------------------------------------------------------------------------------------------------------------------------
--------------------------------------------------------------------------------------------------------------------------------------------------------------------------------------------------------
--------------------------------------------------------------------------------------------------------------------------------------------------------------------------------------------------------
--------------------------------------------------------------------------------------------------------------------------------------------------------------------------------------------------------
--------------------------------------------------------------------------------------------------------------------------------------------------------------------------------------------------------
-------------------------------------------------------------------------------------------------2SCSS--------------------------------------------------------------------------------------------------
--------------------------------------------------------------------------------------------------------------------------------------------------------------------------------------------------------
--------------------------------------------------------------------------------------------------------------------------------------------------------------------------------------------------------
-------------------------------------------------------------------------------------------------r-k-r--------------------------------------------------------------------------------------------------
-------------------------------------------------------------------------------------------------%%%%%--------------------------------------------------------------------------------------------------
--------------------#--#--------------------#--#-------------SSCCCSSC--------------------------k-|||||------SSS-----------------------------------------------------------------------------------------
-------------------##--##------------------##--##-----tt---------------------------------------%%%%%%|--------------------------------------------------------------------------------------------------
------------------###--###---------------%%%%--%%%%---tt---------------------------------------|||||||-------------------#---#--------------------------------------------------------------------------
------------%%%%%%%%%--%%%%%-------------||||--||||---tt--------r------%%%%%%%--%%%------------|||||||---k----r--%%--%%%%%---%%%---------%%%%%%%%F%%%%%%%%%%%%%%%%%%%%%%%%%%%%%%%%%%%%%%%%%%%%%%%%%%%%%%
%%%%%%%%%%%%|||||||||--|||||%%%%%---%%%%%||||--||||%%%%%%%%%%%%%%%%%%%%|||||||--|||%%%%%%%%%%--|||||||--%%%%%%%%%||--|||||---|||---------||||||||%||||||||||||||||||||||||||||||||||||||||||||||||||||||
|||||||||||||||||||||--||||||||||---|||||||||--|||||||||||||||||||||||||||||||--|||||||||||||XXXXXXXXXXX|||||||||||--|||||---|||XXX---XXX|||||||||||||||||||||||||||||||||||||||||||||||||||||||||||||||
