HEIGHT=16;WIDTH=201;THEME=0;OVERRIDE=false
--------------------------------------------------------------------------------------------------------------------------------------------------------------------------------------------------------
--------------------------------------------------------------------------------------------------------------------------------------------------------------------------------------------------------
--------------------------------------------------------------------------------------------------------------------------------------------------------------------------------------------------------
--------------------------------------------------------------------------------------------------------------------------------------------------------------------------------------------------------
--------------------------------------------------------------------------------------------------------------------------------------------------------------------------------------------------------
--------------------------------------------------------------------------------------------------------------------------------------------------------------------------------------------------------
--------------------------------------------------------------------------------------------------------------------------------------------------------------------------------------------------------
--------------------------------------------------------------------------------------------------------------------------------------------------------------------------------------------------------
-------------------------k------------------------------------------------------------------------------------------------------------------------------------------------------------------------------
-----------------------%%%%%%%--------------------------------------------------------------------------------------------------------------------------------------------------------------------------
-----------------------|||||||---------------------------------#---#------------------------------------------------------------------------------------------------------------------------------------
-----------------------|||||||--------------------------------##---##------------------------#---#-----------------------------tt-----------------------------------------------------------------------
-----------------------|||||r|-------k-----------------------###---###---------------------%%%---%%%------%%%%--%%%%-----------tt-tt-Tt---%%%%%%%%F%%%%%%%%%%%%%%%%%%%%%%%%%%%%%%%%%%%%%%%%%%%%%%%%%%%%%
%%%%%%%%%%%%---------%%%%%%%%%%%%%%%%%%%------------#--#---%%%%%---%%%%%%%%%%%%%%%%%--%%%%%|||---|||%%--%%||||--||||%%%--%%%---tt-tt-tt---||||||||%|||||||||||||||||||||||||||||||||||||||||||||||||||||
||||||||||||%%%---%%%|||||||||||||||||||--#---#----##--##--|||||---|||||||||||||||||--||||||||---|||||--||||||--|||||||--|||%%%%%%%%%%%%%%||||||||||||||||||||||||||||||||||||||||||||||||||||||||||||||
|||||||||||||||---||||||||||||||||||||||XXX---XXXXXXX--XXXX|||||---|||||||||||||||||--||||||||---|||||--||||||--|||||||--|||||||||||||||||||||||||||||||||||||||||||||||||||||||||||||||||||||||||||||||
