HEIGHT=16;WIDTH=201;THEME=0;OVERRIDE=false
--------------------------------------------------------------------------------------------------------------------------------------------------------------------------------------------------------
--------------------------------------------------------------------------------------------------------------------------------------------------------------------------------------------------------
--------------------------------------------------------------------------------------------------------------------------------------------------------------------------------------------------------
--------------------------------------------------------------------------------------------------------------------------------------------------------------------------------------------------------
--------------------------------------------------------------------------------------------------------------------------------------------------------------------------------------------------------
--------------------------------------------------------------------------------------------------------------------------------------------------------------------------------------------------------
--------------------------------------------------------------------------------------------------------------------------------------------------------------------------------------------------------
--------------------------------------------------------------------------------------------------------------------------------------------------------------------------------------------------------
--------------------------------------------------------------------------------------------------------------------------------------------------------------------------------------------------------
-------------------------------------------------------------------------------------------------------%%%%%%-------------------------------------------------------------------------------------------
----------------------------------------------------------------------------------------------------k--||||||------------------------SSSCSS2C2----------------------------------------------------------
-------------------------------------------------------------------------------------#---#---------%%%%%|||||-------------------------------------------------------------------------------------------
---------------------------------------------------------#--#-----------tt---tt-----##---##--------||||||||||-------------------------------------------------------------------------------------------
--------------%%%---%%%------%%%%%--------%%%%---%%%%---##--##----------tt---tt---%%%%---%%%%------|g||||||||---------------#---#------k-----k-%%%%%%%%F%%%%%%%%%%%%%%%%%%%%%%%%%%%%%%%%%%%%%%%%%%%%%%%%
%%%%%%%%%%%%%%|||---|||------|||||%%%--%%%||||---||||--###--###---------tt---tt---||||---||||%%%%%%%%%%%%%%%%%%%%%%--%%%%--##---##--%%%%%%%%%%%||||||||%||||||||||||||||||||||||||||||||||||||||||||||||
|||||||||||||||||---|||XX--XX||||||||--|||||||---||||XXXXX--XXXXXXX--XXXXXXXXXXXXX||||---||||||||||||||||||||||||||--||||XXXX---XXXX||||||||||||||||||||||||||||||||||||||||||||||||||||||||||||||||||||
