HEIGHT=16;WIDTH=201;THEME=0;OVERRIDE=false
--------------------------------------------------------------------------------------------------------------------------------------------------------------------------------------------------------
--------------------------------------------------------------------------------------------------------------------------------------------------------------------------------------------------------
--------------------------------------------------------------------------------------------------------------------------------------------------------------------------------------------------------
--------------------------------------------------------------------------------------------------------------------------------------------------------------------------------------------------------
--------------------------------------------------------------------------------------------------------------------------------------------------------------------------------------------------------
--------------------------------------------------------------------------------------------------------------------------------------------------------------------------------------------------------
--------------------------------------------------------------------------------------------------------------------------------------------------------------------------------------------------------
--------------------------------------------------------------------------------------------------------------------------------------------------------------------------------------------------------
--------------------------------------------------------------------------------------------------------------------------------------------------------------------------------------------------------
--------------------------------------------------------------------------------------------------------------------------------------------------------------------------------------------------------
-----------------------------------------------------------%%%------------------------------------------------------------------------------------------------------------------------------------------
-----------------------------------------------------------|||-------------------------tt---------------------------------------------------------------------------------------------------------------
--------------Tt----------------------------%%--%%------y--|||-------------------------tt----------------------------------------------%%--%%%%%%%%%%F%%%%%%%%%%%%%%%%%%%%%%%%%%%%%%%%%%%%%%%%%%%%%%%%%%
%%%%%%%%%%----tt---Tt-%%%--%%%--------------||--||----%%%%%%||----#--#--%%%%%---%%%%%--tt----------------------------------------------||--||||||||||%||||||||||||||||||||||||||||||||||||||||||||||||||
||||||||||----tt---tt-|||--|||%%---%%-------||--||----|r||||||--%%%--%%%|||||---|||||%%%%%%%%%------------------------%%%---%%%--------||--|||||||||||||||||||||||||||||||||||||||||||||||||||||||||||||
||||||||||XXXXXXXXXXXX|||--|||||---||XXXXXXX||--||XXXXXXXXXXXXXX|||--||||||||---||||||||||||||XXXXX---XXXXXXXXX---XXXX|||---|||XXXXXXXX||--|||||||||||||||||||||||||||||||||||||||||||||||||||||||||||||
