HEIGHT=16;WIDTH=201;THEME=0;OVERRIDE=false
--------------------------------------------------------------------------------------------------------------------------------------------------------------------------------------------------------
--------------------------------------------------------------------------------------------------------------------------------------------------------------------------------------------------------
--------------------------------------------------------------------------------------------------------------------------------------------------------------------------------------------------------
--------------------------------------------------------------------------------------------------------------------------------------------------------------------------------------------------------
--------------------------------------------------------------------------------------------------------------------------------------------------------------------------------------------------------
--------------------------------------------------------------------------------------------------------------------------------------------------------------------------------------------------------
--------------------------------------------------------------------------------------------------------------------------------------------------------------------------------------------------------
--------------------------------------------------------------------------------------------------------------------------------------------------------------------------------------------------------
-------------------------------------------%%%%-----------------------------------------------22CUC----SCC----------------------------------------------------------------------------------------------
-------------------------------------------||||------------------------------------------------------------------------------------k--------------------------------------------------------------------
---------------------------------22S2----%%%|||--------------------%%%%-----------------------------------------------------------%%%-------------------------------------------------------------------
----------------tt-----------------------||||||--------------------|||g--------------------------y--------------------------------|||-------------------------------------------------------------------
----------------tt-----------------------||||||--------------%%%%%%%%%%%%%-----------------%%%%%%%%%%%%%%%%%----------------------|||-------------------------------------------------------------------
-------------%%%%%%%%%%--#---#----------%%%%%%%%%%%%%%%------|||||||||||||---------%%%%%%%%|||||||||||||||||---------------------G|||-------------------------------------------------------------------
-------------||||||||||%%%---%%%%%%%%%%%|||||||||||||||------|||||||||||||%%%---%%%|||||||||||||||||||||||||%%%%--%%%%%%--%%%%%%%%%%%%%%%--%%-----------------------------------------------------------
XXXXXXXXXXXXX|||||||||||||---||||||||||||||||||||||||||XX--XX||||||||||||||||---||||||||||||||||||||||||||||||||--||||||--|||||||||||||||--||XXXXXXXXFXXXXXXXXXXXXXXXXXXXXXXXXXXXXXXXXXXXXXXXXXXXXXXXXXX
