HEIGHT=16;WIDTH=201;THEME=0;OVERRIDE=false
--------------------------------------------------------------------------------------------------------------------------------------------------------------------------------------------------------
--------------------------------------------------------------------------------------------------------------------------------------------------------------------------------------------------------
--------------------------------------------------------------------------------------------------------------------------------------------------------------------------------------------------------
--------------------------------------------------------------------------------------------------------------------------------------------------------------------------------------------------------
--------------------------------------------------------------------------------------------------------------------------------------------------------------------------------------------------------
--------------------------------------------------------------------------------------------------------------------------------------------------------------------------------------------------------
--------------------------------------------------------------------------------------------------------------------------------------------------------------------------------------------------------
--------------------------------------------------------------------------------------------------------------------------------------------------------------------------------------------------------
--------------------------------------------------------------------------------------------------------------------------------------------------------------------------------------------------------
-----------------------------------------------------------------#--#-----------------------------------------------------------------------------------------------------------------------------------
------------------------------#---#-------CCS-------------------##--##----------------------------------------------------------------------------------------------------------------------------------
-----------------------------##---##---------------------------###--###---------------------------------------------------------------------------------------------------------------------------------
--------------%%%%%--%%%%%--###---###------------------------%%%%%--%%%%%-----------------------------------%%%---%%%-----------------#--#----%%%%%%%%F%%%%%%%%%%%%%%%%%%%%%%%%%%%%%%%%%%%%%%%%%%%%%%%%%
--------------|||||--|||||%%%%%---%%%%%--g----k-%%%%%%%%--%%%|||||--|||||-----------------------------------|||---|||----------------##--##---||||||||%|||||||||||||||||||||||||||||||||||||||||||||||||
%%%%%%%%%%%%%%|||||--||||||||||---|||||%%%%%%%%%||||||||--||||||||--|||||---------%%%%%--%%%%%%%---%%%%---%%|||---|||---------------###--###--||||||||||||||||||||||||||||||||||||||||||||||||||||||||||
|||||||||||||||||||--||||||||||---||||||||||||||||||||||--||||||||--|||||XXX---XXX|||||--|||||||---||||---|||||---|||XXXXX---XXXXXXXXXX--XXXXX||||||||||||||||||||||||||||||||||||||||||||||||||||||||||
