HEIGHT=16;WIDTH=201;THEME=0;OVERRIDE=false
--------------------------------------------------------------------------------------------------------------------------------------------------------------------------------------------------------
--------------------------------------------------------------------------------------------------------------------------------------------------------------------------------------------------------
--------------------------------------------------------------------------------------------------------------------------------------------------------------------------------------------------------
--------------------------------------------------------------------------------------------------------------------------------------------------------------------------------------------------------
--------------------------------------------------------------------------------------------------------------------------------------------------------------------------------------------------------
--------------------------------------------------------------------------------------------------------------------------------------------------------------------------------------------------------
--------------------------------------------------------------------------------------------------------------------------------------------------------------------------------------------------------
--------------------------------------------------------------------------------------------------------------------------------------------------------------------------------------------------------
--------------------------------------------------------------------------------------------------------------------------------------------------------------------------------------------------------
--------------------------------------------------------------------------------------------------------------------------------------------------------------------------------------------------------
--------------------------------------------------------------------------------------------------------------------------------------------------------------------------------------------------------
-------------------SSSSSS2-------------------------------------------------------------------------------------#--#-------------------------------------------------------------------------------------
----------%%%--%%%--------------#--#---------------#---#--%%---%%---------------------------------------%%%---##--##---------------%%%%%---%%%%%%%%%%%%%F%%%%%%%%%%%%%%%%%%%%%%%%%%%%%%%%%%%%%%%%%%%%%%%
----------|||--|||-------------##--##------------%%%---%%%||---||------------%%%---%%%%%%%---%%%%-------|||--###--###--------------|||||---|||||||||||||%|||||||||||||||||||||||||||||||||||||||||||||||
----------|||--|||-----------%%%%--%%%%----------|||---|||||---||------------|||---|||||||---||||-------|||%%%%%--%%%%%------------|||||---|||||||||||||||||||||||||||||||||||||||||||||||||||||||||||||
XXXXXXXXXX|||--|||XXXXXXXXXXX||||--||||XXXX--XXXX|||---|||||---||XXXXX--XXXXX|||---|||||||---||||XX---XX||||||||--|||||XXXXXXX---XX|||||---|||||||||||||||||||||||||||||||||||||||||||||||||||||||||||||
