HEIGHT=16;WIDTH=201;THEME=0;OVERRIDE=false
--------------------------------------------------------------------------------------------------------------------------------------------------------------------------------------------------------
--------------------------------------------------------------------------------------------------------------------------------------------------------------------------------------------------------
--------------------------------------------------------------------------------------------------------------------------------------------------------------------------------------------------------
--------------------------------------------------------------------------------------------------------------------------------------------------------------------------------------------------------
--------------------------------------------------------------------------------------------------------------------------------------------------------------------------------------------------------
--------------------------------------------------------------------------------------------------------------------------------------------------------------------------------------------------------
--------------------------------------------------------------------------------------------------------------------------------------------------------------------------------------------------------
--------------------------------------------------------------------------------------------------------------------------------------------------------------------------------------------------------
--------------------------------------------------------------------------------------------------------------------------------------------------------------------------------------------------------
--------------------------------------------------------------CSS---------------------------------------------------------------------------------------------------------------------------------------
--------------------------------------------------------------------------------------------------------------------------------------------------------------------------------------------------------
-------------------------------------------------------------------2USCU2U-----------------------#--#-----tt---------2CCSSS-----------------------------------------------------------------------------
------------------------------------------------------------------------------------------------##--##----tt--------------------------------------------------------------------------------------------
----------------------%%---%%-----------------------------%%%%%%%%----------------------------%%%%--%%%%%%%%%%-------------%--%%%%---%%%%---------------------------------------------------------------
%%%%%%%%%%------------||---||------%%%%%%%---%%%----------||||||||---r------%%%---%%%%%%---%%%||||--||||||||||------------Y|--||||---||||---------------------------------------------------------------
||||||||||XXXXX--XXXXX||---||XX--XX|||||||---|||XXXX--XXXX||||||||XXXXXXXXXX|||---||||||---|||||||--||||||||||XX--XXXXXXXXXXXX||||---||||XXXXXXXXFXXXXXXXXXXXXXXXXXXXXXXXXXXXXXXXXXXXXXXXXXXXXXXXXXXXXXX
