HEIGHT=16;WIDTH=201;THEME=0;OVERRIDE=false
--------------------------------------------------------------------------------------------------------------------------------------------------------------------------------------------------------
--------------------------------------------------------------------------------------------------------------------------------------------------------------------------------------------------------
--------------------------------------------------------------------------------------------------------------------------------------------------------------------------------------------------------
--------------------------------------------------------------------------------------------------------------------------------------------------------------------------------------------------------
--------------------------------------------------------------------------------------------------------------------------------------------------------------------------------------------------------
--------------------------------------------------------------------------------------------------------------------------------------------------------------------------------------------------------
--------------------------------------------------------------------------------------------------------------------------------------------------------------------------------------------------------
--------------------------------------------------------------------------------------------------------------------------------------------------------------------------------------------------------
---------------------------------------------------------UCS2US---------------------------------------------------------------------S-22----------------------------------------------------------------
--------------------------------------------------------------------------------------------------------------------------------------------------------------------------------------------------------
--------------------------------US2C2---------#---#------------------------------C-S-------------------------------------------------%------------------------------------------------------------------
---------------------------------------------##---##-------y--k----------------------------------------------------------------------|------------------------------------------------------------------
-------------------------------%------------###---###--%%%%%%%%%---------Tt-------%----------%%%%---%%%%---------------------------%%%%%%%--------------------------------------------------------------
-------------------------------|-k--------%%%%%---%%%%%|||||||||---------tt----y--|--r-------||||---||||---------------------------|||||||--------------------------------------------------------------
%%%%%%%%%%%%%%%--%%%%%-------%%%%%%%%%%%%%|||||---||||||||||||||---------tt--%%%%%%%%%%------||||---||||%%%%%%%%%%%%%%--%%%%%%---%%|||||||--------------------------------------------------------------
|||||||||||||||--|||||XXXXXXX||||||||||||||||||---||||||||||||||XXXXXXXXXXXXX||||||||||XX--XX||||---||||||||||||||||||--||||||---|||||||||XXXXXXXXFXXXXXXXXXXXXXXXXXXXXXXXXXXXXXXXXXXXXXXXXXXXXXXXXXXXXX
