HEIGHT=16;WIDTH=201;THEME=0;OVERRIDE=false
--------------------------------------------------------------------------------------------------------------------------------------------------------------------------------------------------------
--------------------------------------------------------------------------------------------------------------------------------------------------------------------------------------------------------
--------------------------------------------------------------------------------------------------------------------------------------------------------------------------------------------------------
--------------------------------------------------------------------------------------------------------------------------------------------------------------------------------------------------------
--------------------------------------------------------------------------------------------------------------------------------------------------------------------------------------------------------
--------------------------------------------------------------------------------------------------------------------------------------------------------------------------------------------------------
--------------------------------------------------------------------------------------------------------------------------------------------------------------------------------------------------------
--------------------------------------------------------------------------------------------------------------------------------------------------------------------------------------------------------
------------------------------------------------------------------------------------------------------------------------S2SC----------------------------------------------------------------------------
--------------------SSSSSC------------------------------------------------------------------------------------------------------------------------------------------------------------------------------
--------------------------------------------------------------------------------------------------------------------------------------------------------------------------------------------------------
-----------------------------------------------------------------------------------------------------------------%%%%---------y-------------------------------------------------------------------------
--------------------y--------------------------------------------%%%%%%%%%--%%%%------------------%%%%--%%%%--k--||||k-%%%%%%%%%%%----------------------------------------------------------------------
-------------------%%%%%%%%%%%-----------------------------------|||||||||--||||%%%%---%%%%-------||||--||||%%%%%%%%%%%|||||||||||----------------------------------------------------------------------
-------------------|||||||||||-----------%%--%%------%%%%%-------|||||||||--||||||||---||||%%---%%||||--||||||||||||||||||||||||||--------%%%%%%%%F%%%%%%%%%%%%%%%%%%%%%%%%%%%%%%%%%%%%%%%%%%%%%%%%%%%%%
XXXXXXXXXXXXXXX--XX|||||||||||XXXX---XXXX||--||XX--XX|||||XX---XX|||||||||--||||||||---||||||---||||||--||||||||||||||||||||||||||XXXXXXXX||||||||X|||||||||||||||||||||||||||||||||||||||||||||||||||||
