HEIGHT=16;WIDTH=201;THEME=0;OVERRIDE=false
--------------------------------------------------------------------------------------------------------------------------------------------------------------------------------------------------------
--------------------------------------------------------------------------------------------------------------------------------------------------------------------------------------------------------
--------------------------------------------------------------------------------------------------------------------------------------------------------------------------------------------------------
--------------------------------------------------------------------------------------------------------------------------------------------------------------------------------------------------------
--------------------------------------------------------------------------------------------------------------------------------------------------------------------------------------------------------
--------------------------------------------------------------------------------------------------------------------------------------------------------------------------------------------------------
--------------------------------------------------------------------------------------------------------------------------------------------------------------------------------------------------------
---------------------------------------------------------------------------------------------------%%%%%%-----------------------------------------------------------------------------------------------
---------------------------------------------------------------------------------------------------||||||-----------------------------------------------------------------------------------------------
-------------Tt-------------------------------------------------22-SSUSSS--------------------------||||||-----------------------------------------------------------------------------------------------
-------------tt--------------------------------------S2SSSUSS--------------------------------------||%%%%%%--------------------------#---#--------------------------------------------------------------
-------------tt---------------------------------------------------%--------------------------------||||||||-------------------------##---##-------------------------------------------------------------
------------%%%%%%-------------------%%---%%--#--#--------------k-|y-------------------------------r|||||||y------------%%%---%%%--###---###--%%%%%%%%F%%%%%%%%%%%%%%%%%%%%%%%%%%%%%%%%%%%%%%%%%%%%%%%%%
------------||||||------------%%---%%||---||%%%--%%%-------r---%%%%%%%%%%%--#--#------------------%%%%%%%%%%%%%%%%------|||---|||%%%%%---%%%%%||||||||%|||||||||||||||||||||||||||||||||||||||||||||||||
%%%%%%%%%%%%||||||------------||---||||---|||||--|||%%%%%%%%%%%|||||||||||%%%--%%%%%--%%----------||||||||||||||||%%--%%|||---||||||||---|||||||||||||||||||||||||||||||||||||||||||||||||||||||||||||||
||||||||||||||||||XXXXX--XXXXX||---||||---|||||--||||||||||||||||||||||||||||--|||||--||XXXX--XXXX||||||||||||||||||--|||||---||||||||---|||||||||||||||||||||||||||||||||||||||||||||||||||||||||||||||
