HEIGHT=16;WIDTH=201;THEME=0;OVERRIDE=false
--------------------------------------------------------------------------------------------------------------------------------------------------------------------------------------------------------
--------------------------------------------------------------------------------------------------------------------------------------------------------------------------------------------------------
--------------------------------------------------------------------------------------------------------------------------------------------------------------------------------------------------------
--------------------------------------------------------------------------------------------------------------------------------------------------------------------------------------------------------
--------------------------------------------------------------------------------------------------------------------------------------------------------------------------------------------------------
--------------------------------------------------------------------------------------------------------------------------------------------------------------------------------------------------------
--------------------------------------------------------------------------------------------------------------------------------------------------------------------------------------------------------
--------------------------------------------------------------------------------------------------------------------------------------------------------------------------------------------------------
--------------------------------------------------------------------------------------------------------------------------------------------------------------------------------------------------------
--------------------------------------------------------------------------------------------------------------------------------------------------------------------------------------------------------
---------------------#--#----------------------------tt-------------------------------------------------------------------------------------------------------------------------------------------------
--------------------##--##---------------------------tt-------------------------------------------------------------------------------------------------------------------------------------------------
%%%%%%%%%%%%%--%%--###--###------------------------%%%%%%%-----------------------------------------------------------%%%%---%%%%---------#---#---%%%%%%%%F%%%%%%%%%%%%%%%%%%%%%%%%%%%%%%%%%%%%%%%%%%%%%%
|||||||||||||--||%%%%%--%%%%%--tt--tt--------------|||||||%%---%%%%%%%--%%%%%------------%%%%---%%%%%%%%%%%%%%---%%%%||||---||||--------##---##--||||||||%||||||||||||||||||||||||||||||||||||||||||||||
|||||||||||||--|||||||--|||||--tt--tt--------------|||||||||---|||||||--|||||------------||||---||||||||||||||---||||||||---||||%%--%%%%%%---%%%%|||||||||||||||||||||||||||||||||||||||||||||||||||||||
|||||||||||||--|||||||--|||||XXXXXXXXXXXXXXX--XXXXX|||||||||---|||||||--|||||XXXXX--XXXXX||||---||||||||||||||---||||||||---||||||--||||||---|||||||||||||||||||||||||||||||||||||||||||||||||||||||||||
