HEIGHT=16;WIDTH=201;THEME=0;OVERRIDE=false
--------------------------------------------------------------------------------------------------------------------------------------------------------------------------------------------------------
--------------------------------------------------------------------------------------------------------------------------------------------------------------------------------------------------------
--------------------------------------------------------------------------------------------------------------------------------------------------------------------------------------------------------
--------------------------------------------------------------------------------------------------------------------------------------------------------------------------------------------------------
--------------------------------------------------------------------------------------------------------------------------------------------------------------------------------------------------------
--------------------------------------------------------------------------------------------------------------------------------------------------------------------------------------------------------
--------------------------------------------------------------------------------------------------------------------------------------------------------------------------------------------------------
--------------------------------------------------------------------------------------------------------------------------------------------------------------------------------------------------------
--------------------------------------------------------------------------------------------------------------------------------------------------------------------------------------------------------
----------------------------------------------------------------------------------2UCSS-----------------------------------------------------------------------------------------------------------------
------------------------------------%%%-------------------------------------------------------------------------------------SS2U2-----------------------------------------------------------------------
------------------------------------||k----------------tt-----------------------------------------------------------SSS---------------------------------------------------------------------------------
---------------------%%%--%%%-------||%%%----------Tt--tt---------y---------------------y--------------%%%%%--%%%%%-------------------------------------------------------------------------------------
-------------#---#---|||--|||%%%%%--|||||----------tt--tt-------%%%%%%----------%%%%%%%%%%%%%%%---%%%%%|||||--|||||---------------%%%%--%%%%------------------------------------------------------------
%%%%%%%%%%--##---##--|||--||||||||--|||||---g-G--%%%%%%%%%%%--%%||||||%%%%--%%%%|||||||||||||||---||||||||||--|||||--------%%%%%%%||||--||||------------------------------------------------------------
||||||||||XXXX---XXXX|||--||||||||XXXXXXXXXXXXXXX|||||||||||--||||||||||||--|||||||||||||||||||---||||||||||--|||||XXXXXXXX|||||||||||--||||XXXXXXXXFXXXXXXXXXXXXXXXXXXXXXXXXXXXXXXXXXXXXXXXXXXXXXXXXXXX
