HEIGHT=16;WIDTH=201;THEME=0;OVERRIDE=false
--------------------------------------------------------------------------------------------------------------------------------------------------------------------------------------------------------
--------------------------------------------------------------------------------------------------------------------------------------------------------------------------------------------------------
--------------------------------------------------------------------------------------------------------------------------------------------------------------------------------------------------------
--------------------------------------------------------------------------------------------------------------------------------------------------------------------------------------------------------
--------------------------------------------------------------------------------------------------------------------------------------------------------------------------------------------------------
--------------------------------------------------------------------------------------------------------------------------------------------------------------------------------------------------------
----------------------------------------------------------------------------%%%%------------------------------------------------------------------------------------------------------------------------
----------------------------------------------------------------------------||||------------------------------------------------------------------------------------------------------------------------
----------------------------------------------------------------------------||||------------------------------------------------------------------------------------------------------------------------
----------------------------------------------------------------------------||||------------------------------------------------------------------------------------------------------------------------
----------------------------------------------------------------------------||%%%%--------#--#------#---#-----------------------------------------------------------------------------------------------
---------------------------------------------------------Tt---Tt------------||||||-------##--##----##---##----------------------------------------------------------------------------------------------
----------------------------------------%%--%%%%%%--%%%%-tt---tt------------||||||-----%%%%--%%%%%%%%---%%%%----#--#----%%%%%%%-------------------------------------------------------------------------
%%%%%%%%%%%%%--------------y----------%%||--||||||--||||%%%%%%%%%%%%---%%%--||||||-----||||--||||||||---||||---##--##---|||||||---#--#---%%%%%%%%F%%%%%%%%%%%%%%%%%%%%%%%%%%%%%%%%%%%%%%%%%%%%%%%%%%%%%%
|||||||||||||%%%%%%%%%%%%%%%%---------||||--||||||--||||||||||||||||---|||%%%%%%%%%%%%%||||--||||||||---||||--###--###--|||||||--##--##--||||||||%||||||||||||||||||||||||||||||||||||||||||||||||||||||
|||||||||||||||||||||||||||||XXX---XXX||||--||||||--||||||||||||||||---||||||||||||||||||||--||||||||---||||XXXXX--XXXXX|||||||XXXX--XXXX|||||||||||||||||||||||||||||||||||||||||||||||||||||||||||||||
