HEIGHT=16;WIDTH=201;THEME=0;OVERRIDE=false
--------------------------------------------------------------------------------------------------------------------------------------------------------------------------------------------------------
--------------------------------------------------------------------------------------------------------------------------------------------------------------------------------------------------------
--------------------------------------------------------------------------------------------------------------------------------------------------------------------------------------------------------
--------------------------------------------------------------------------------------------------------------------------------------------------------------------------------------------------------
--------------------------------------------------------------------------------------------------------------------------------------------------------------------------------------------------------
--------------------------------------------------------------------------------------------------------------------------------------------------------------------------------------------------------
--------------------------------------------------------------------------------------------------------------------------------------------------------------------------------------------------------
--------------------------------------------------------------------------------------------------------------------------------------------------------------------------------------------------------
--------------------------------------------------------------------------------------------------------------------------------------------------------------------------------------------------------
--------------------------------------------------------------------------------------------------------------------------------------------------------------------------------------------------------
------------------------------------------------------------------------------------#---#---------------------------------------------#--#--------------------------------------------------------------
-----------------------------------------------------------------------------------##---##-------------------------------------------##--##-------------------------------------------------------------
------------------------------------------------------%%---%%---------------------###---###---------------------------r-------------###--###------------------------------------------------------------
--------------%%%%---%%%%%%%%%%%%%---#---#------------||---||-------------------%%%%%---%%%%%------------%%%%%--%%%%%%%%%%%-------%%%%%--%%%%%----------------------------------------------------------
--------------||||---|||||||||||||--##---##----#---#--||---||%%%%%--%%%%%-------|||||---|||||------------|||||--|||||||||||-------|||||--|||||----------------------------------------------------------
XXXXXXXXXXXXXX||||---|||||||||||||XXXX---XXXXXXX---XXX||---|||||||--|||||XX---XX|||||---|||||XXXXX--XXXXX|||||--|||||||||||XX---XX|||||--|||||XXXXXXXXFXXXXXXXXXXXXXXXXXXXXXXXXXXXXXXXXXXXXXXXXXXXXXXXXX
