HEIGHT=16;WIDTH=201;THEME=0;OVERRIDE=false
--------------------------------------------------------------------------------------------------------------------------------------------------------------------------------------------------------
--------------------------------------------------------------------------------------------------------------------------------------------------------------------------------------------------------
--------------------------------------------------------------------------------------------------------------------------------------------------------------------------------------------------------
--------------------------------------------------------------------------------------------------------------------------------------------------------------------------------------------------------
--------------------------------------------------------------------------------------------------------------------------------------------------------------------------------------------------------
--------------------------------------------------------------------------------------------------------r-----------------------------------------------------------------------------------------------
--------------------------------------------------------------------------------------------------------%%%---------------------------------------------------------------------------------------------
--------------------------------------------------------------------------------------------------------|||---------------------------------------------------------------------------------------------
--------------------------------------------------------------------------------------------------------|||--------------------%%%%%%%------------------------------------------------------------------
--------------------------------------------------------------------------------------------------------|||--------------------|||||||------------------------------------------------------------------
----------------------------------------------------------------------------#--#------------------------|%%%%------------------|||||||------------------------------------------------------------------
------------------------------------------SUC------------------------------##--##-----y-----------------|||||------------------||k|k||------------------------------------------------------------------
%%%%%%%%%%%%%---------%%%---%%%-------------------------------------------###--###----%%%%--------------|||y|--------------%%%%%%%%%%%%%%---------------------------------------------------------------
|||||||||||||%%%---%%%|||---|||-----------------%%%%---%%%%-------------%%%%%--%%%%%--||||------------%%%%%%%%%%%%%%%------||||||||||||||---------------------------------------------------------------
||||||||||||||||---||||||---|||--#---#-----k----||||---||||-------------|||||--|||||--||k|------y-----|||||||||||||||%%--%%||||||||||||||%%%%%%%%F%%%%%%%%%%%%%%%%%%%%%%%%%%%%%%%%%%%%%%%%%%%%%%%%%%%%%%
||||||||||||||||---||||||---|||XXX---XXXXXXXXXXX||||---||||XXXXX---XXXXX|||||--|||||XXXXXXXXXXXXXXXXXX|||||||||||||||||--||||||||||||||||||||||||X||||||||||||||||||||||||||||||||||||||||||||||||||||||
