HEIGHT=16;WIDTH=201;THEME=0;OVERRIDE=false
--------------------------------------------------------------------------------------------------------------------------------------------------------------------------------------------------------
--------------------------------------------------------------------------------------------------------------------------------------------------------------------------------------------------------
--------------------------------------------------------------------------------------------------------------------------------------------------------------------------------------------------------
--------------------------------------------------------------------------------------------------------------------------------------------------------------------------------------------------------
--------------------------------------------------------------------------------------------------------------------------------------------------------------------------------------------------------
--------------------------------------------------------------------------------------------------------------------------------------------------------------------------------------------------------
--------------------------------------------------------------------------------------------------------------------------------------------------------------------------------------------------------
------------------------------------------------------------------------------------------------------------------------------r-------------------------------------------------------------------------
-----------------------y--------------------------------------------------------------------------------------------------%%%%%-------------------------------------------------------------------------
-----------------------%%%%----SCS----------------------------------------------------------------------------------------||Y||-------------------------------------------------------------------------
-----------------------||||-----------------------------------------------------------------------------------------------||%%%%%-----------------------------------------------------------------------
-----------------------||||---------------------#---#-----------------------k---------------CUS2CUS-----------------------|||||||-----------------------------------------------------------------------
----------------tt---r-||||--------------------##---##--%%%---%%%-------%%%%%%%%%%%%--%%%%------------#--#--------%%%%%%%-|||||||-----------------------------------------------------------------------
------------tt--tt-%%%%%%%%%%%%%%%%%%%-------%%%%---%%%%|||---|||%%---%%||||||||||||--||||----------%%%--%%%%%--%%|||||||-|||||||-----------------------------------------------------------------------
%%%%%%%%%%--tt--tt-|||||||||||||||||||%%---%%||||---|||||||---|||||---||||||||||||||--||||----------|||--|||||--|||||||||%%%%%%%%%%%%%%%----------------------------------------------------------------
||||||||||XXXXXXXXX|||||||||||||||||||||---||||||---|||||||---|||||---||||||||||||||--||||XXXXXXXXXX|||--|||||--||||||||||||||||||||||||XXXXXXXXFXXXXXXXXXXXXXXXXXXXXXXXXXXXXXXXXXXXXXXXXXXXXXXXXXXXXXXX
