HEIGHT=16;WIDTH=201;THEME=0;OVERRIDE=false
--------------------------------------------------------------------------------------------------------------------------------------------------------------------------------------------------------
--------------------------------------------------------------------------------------------------------------------------------------------------------------------------------------------------------
--------------------------------------------------------------------------------------------------------------------------------------------------------------------------------------------------------
--------------------------------------------------------------------------------------------------------------------------------------------------------------------------------------------------------
--------------------------------------------------------------------------------------------------------------------------------------------------------------------------------------------------------
--------------------------------------------------------------------------------------------------------------------------------------------------------------------------------------------------------
--------------------------------------------------------------------------------------------------------------------------------------------------------------------------------------------------------
--------------------------------------------------------------------------------------------------------------------------------------------------------------------------------------------------------
--------------------------------------------------------------------------------------------------------------------------------------------------------------------------------------------------------
----------------------------------------------------------------------------------k---r-----------------------------------------------------------------------------------------------------------------
---------------------------------------------------------------------------------%%%%%%%----------------------------------------------------------------------------------------------------------------
--------------------------------------------------------------------------------Y|||||||-------------------------------------------#--#-----------------------------------------------------------------
%%%%%%%%%%------------------------------------%%%--%%%%%%--%%%-----------------%%%%%%%%%%%%--------------------------------------%%%--%%%%%%%%%%%F%%%%%%%%%%%%%%%%%%%%%%%%%%%%%%%%%%%%%%%%%%%%%%%%%%%%%%
||||||||||--------------------------------%%%%|||--||||||--|||--------%%%---%%%||||||||||||-----------------#--#---r-----%%%--%%%|||--|||||||||||%||||||||||||||||||||||||||||||||||||||||||||||||||||||
||||||||||-----%%---%%--------------------|||||||--||||||--|||--#--#--|||---|||||||||||||||--#---#--------%%%--%%%%%%%%%%|||--||||||--||||||||||||||||||||||||||||||||||||||||||||||||||||||||||||||||||
||||||||||XXXXX||---||XXXX--XXXXXXXX--XXXX|||||||--||||||--|||XXX--XXX|||---|||||||||||||||XXX---XXXXX--XX|||--|||||||||||||--||||||--||||||||||||||||||||||||||||||||||||||||||||||||||||||||||||||||||
