HEIGHT=16;WIDTH=201;THEME=0;OVERRIDE=false
--------------------------------------------------------------------------------------------------------------------------------------------------------------------------------------------------------
--------------------------------------------------------------------------------------------------------------------------------------------------------------------------------------------------------
--------------------------------------------------------------------------------------------------------------------------------------------------------------------------------------------------------
--------------------------------------------------------------------------------------------------------------------------------------------------------------------------------------------------------
--------------------------------------------------------------------------------------------------------------------------------------------------------------------------------------------------------
--------------------------------------------------------------------------------------------------------------------------------------------------------------------------------------------------------
--------------------------------------------------------------------------------------------------------------------------------------------------------------------------------------------------------
--------------------------------------------------------------------------------------------------------------------------------------------------------------------------------------------------------
--------------------------------------------------------------------------------------------------------------------------------------------------------------------------------------------------------
-----------------------------------------------------rg--------------------------------------S2S--------------------------------------------------------------------------------------------------------
---------------------------------------------------%%%%%%%----------------------------------------------------------------------------------------------------------------------------------------------
---------------------------------------------------|||||||----------------------------------------------------------------------------------------------------------------------------------------------
%%%%%%%%%%%%%%%%%---%%%--tt------------------------|||||||--------------------------------------y-------------------------------------------------------------------------------------------------------
|||||||||||||||||---|||--tt------------------------|||||||--------------------------------%%%%%%%%-------------%%--%%----------------tt-----------------------------------------------------------------
|||||||||||||||||---|||--tt---------%%%%%---%%%%%%%%%%%%%%%%%%%%%%---------#--#-----------||||||||-------------||--||%%%%%--%%%%%----tt--%%%%%%%%F%%%%%%%%%%%%%%%%%%%%%%%%%%%%%%%%%%%%%%%%%%%%%%%%%%%%%%
|||||||||||||||||---|||XXXXXXXXX--XX|||||---||||||||||||||||||||||XX---XXXXX--XXXXXX---XXX||||||||XXXXX---XXXXX||--|||||||--|||||XXXXXXXX||||||||X||||||||||||||||||||||||||||||||||||||||||||||||||||||
