HEIGHT=16;WIDTH=201;THEME=0;OVERRIDE=false
--------------------------------------------------------------------------------------------------------------------------------------------------------------------------------------------------------
--------------------------------------------------------------------------------------------------------------------------------------------------------------------------------------------------------
--------------------------------------------------------------------------------------------------------------------------------------------------------------------------------------------------------
--------------------------------------------------------------------------------------------------------------------------------------------------------------------------------------------------------
--------------------------------------------------------------------------------------------------------------------------------------------------------------------------------------------------------
--------------------------------------------------------------------------------------------------------------------------------------------------------------------------------------------------------
--------------K-----------------------------------------------------------------------------------------------------------------------------------------------------------------------------------------
-------------%%%%---------------------------------------------------------------------------------------------------------------------------------------------------------------------------------------
-------------||||---------------------------------------------------------------------------------------------------------------------------------------------------------------------------------------
-------------||||---------------------------------------------------------------------------------------------------SCS------------SCSS-----------------------------------------------------------------
-------------||%%%%%%---------------------------------------------UCSS2---------------------------------------------------------------------------------------------------------------------------------
-------------||||||||-----------------------------------------------------------------------------------------------------------------------------------------------------------------------------------
-------------||||||||------------------------------------------------------#---#------------------------------------------------------------------------------------------------------------------------
-------------||y|||||k---------------------------------------------KgG----##---##----------------------------------%%%%%%%------%%%%%%%%----------------------------------------------------------------
%%%%%%%%%%%%%%%%%%%%%%%----------%%%%---%%%%%%%--%%%%%%%%--%%%%%%%%%%%%%%%%%---%%%%%%---%%%%%%%--%%%%%%%--%%%%---%%|||||||%%--%%||||||||----------------------------------------------------------------
|||||||||||||||||||||||XXXX--XXXX||||---|||||||--||||||||--|||||||||||||||||---||||||---|||||||--|||||||--||||---|||||||||||--||||||||||XXXXXXXXFXXXXXXXXXXXXXXXXXXXXXXXXXXXXXXXXXXXXXXXXXXXXXXXXXXXXXXX
