HEIGHT=16;WIDTH=201;THEME=0;OVERRIDE=false
--------------------------------------------------------------------------------------------------------------------------------------------------------------------------------------------------------
--------------------------------------------------------------------------------------------------------------------------------------------------------------------------------------------------------
--------------------------------------------------------------------------------------------------------------------------------------------------------------------------------------------------------
--------------------------------------------------------------------------------------------------------------------------------------------------------------------------------------------------------
--------------------------------------------------------------------------------------------------------------------------------------------------------------------------------------------------------
--------------------------------------------------------------------------------------------------------------------------------------------------------------------------------------------------------
--------------------------------------------------------------------------------------------------------------------------------------------------------------------------------------------------------
--------------------------------------------------------------------------------------------------------------------------------------------------------------------------------------------------------
--------------------------------------------------------------------------------------------------------------------------------------------------------------------------------------------------------
--------------------------------------------------------------------------------------------------------------------------------------------------------------------------------------------------------
----------------------------------------------------------------------------------------------------------SSSSCS2---2C2SS-------------------------------------------------------------------------------
--------------------------------------------------------------------------------------------------------------------------------------------------------------------------------------------------------
-------------------------------------------------------#---#---------#---#---------%%%%%%%%%%-----------------------------------------------------------------------------------------------------------
--------------------------------------%%%%%---%%%%%---##---##---%%--##---##--------||||||||||--------------------------r---------tt--tt----%%%%%%%%F%%%%%%%%%%%%%%%%%%%%%%%%%%%%%%%%%%%%%%%%%%%%%%%%%%%%
-----------%%%%%--%%%%%%%%---%%%------|||||---|||||--###---###--||%%%%---%%%%------||||||||||%%%%---%%%%%%%%%%%%%%%%%%%%%%%%%----tt--tt----||||||||%||||||||||||||||||||||||||||||||||||||||||||||||||||
XXXXXXXXXXX|||||--||||||||---|||XX--XX|||||---|||||XXXXX---XXXXX||||||---||||XX--XX||||||||||||||---|||||||||||||||||||||||||XXXXXXXXXXXXXX|||||||||||||||||||||||||||||||||||||||||||||||||||||||||||||
