HEIGHT=16;WIDTH=201;THEME=0;OVERRIDE=false
--------------------------------------------------------------------------------------------------------------------------------------------------------------------------------------------------------
--------------------------------------------------------------------------------------------------------------------------------------------------------------------------------------------------------
--------------------------------------------------------------------------------------------------------------------------------------------------------------------------------------------------------
--------------------------------------------------------------------------------------------------------------------------------------------------------------------------------------------------------
--------------------------------------------------------------------------------------------------------------------------------------------------------------------------------------------------------
--------------------------------------------------------------------------------------------------------------------------------------------------------------------------------------------------------
--------------------------------------------------------------------------------------------------------------------------------------------------------------------------------------------------------
--------------------------------------------------------------------------------------------------------------------------------------------------------------------------------------------------------
--------------------------------------------------------------------------------------------------------------------------------------------------------------------------------------------------------
--------------------------------------------------------------------------------------------------------------------------------------------------------------------------------------------------------
----------------------------------------------------------------------------------------#---#-----------------------------------------------------------------------------------------------------------
---------------------------------------------------------------------------------------##---##--------------------------------------#---#---------------------------------------------------------------
-----------------------------------------------------------------------%%%-----------%%%%---%%%%----------------------------------%%%---%%%-------------------------------------------------------------
-------------------yrr-%%%---%%%%%%%---%%%%%%%--%%%%%---%%-------------||r------g----||||---||||---------------%%%%%%%%%%%%%%---%%|||---|||-------------------------------------------------------------
--------------%%%%%%%%%|||---|||||||---|||||||--|||||---||%%%%---%%%%%%%%%%%%%%%%%%%%||||---||||---------------||||||||||||||---|||||---|||-------------------------------------------------------------
XXXXXXXXXXXXXX||||||||||||---|||||||---|||||||--|||||---||||||---||||||||||||||||||||||||---||||XXXXX--XXXXXXXX||||||||||||||---|||||---|||XXXXXXXXFXXXXXXXXXXXXXXXXXXXXXXXXXXXXXXXXXXXXXXXXXXXXXXXXXXXX
