HEIGHT=16;WIDTH=201;THEME=0;OVERRIDE=false
--------------------------------------------------------------------------------------------------------------------------------------------------------------------------------------------------------
--------------------------------------------------------------------------------------------------------------------------------------------------------------------------------------------------------
--------------------------------------------------------------------------------------------------------------------------------------------------------------------------------------------------------
--------------------------------------------------------------------------------------------------------------------------------------------------------------------------------------------------------
--------------------------------------------------------------------------------------------------------------------------------------------------------------------------------------------------------
--------------------------------------------------------------------------------------------------------------------------------------------------------------------------------------------------------
--------------------------------------------------------------------------------------------------------------------------------------------------------------------------------------------------------
--------------------------------------------------------------------------------------------------------------------------------------------------------------------------------------------------------
-------------------------------------------------------SSSCUS----------------------------------------SSS------------------------------------------------------------------------------------------------
--------------------------------------------------------------------------------------------------------------------------------------------------------------------------------------------------------
------------------------------------------------------------------------------------------------------------------------------------------#--#----------------------------------------------------------
---------------------------------------------#---#------y--------------------------------SS2---------------------------------------------##--##---------------------------------------------------------
--------------------------------------------##---##---%%%%%%%%%-------------------------------------%%%%-------------------------k------###--###--------------------------------------------------------
-----------------------------------%%--%%--###---###--|||||||||-------%%%%------%%%%%--------%%--%%-|r|y-----------------------%%%%%%%%%%%%--%%%%%------------------------------------------------------
-----------%%%%%%%%---%%%%%--------||--||%%%%%---%%%%%|||||||||--k---r||||g--r--|||||--------||--||%%%%%%%%%%%%%%%%%%%---------||||||||||||--|||||------------------------------------------------------
XXXXXXXXXXX||||||||---|||||XXXXXXXX||--|||||||---||||||||||||||XXXXXXXXXXXXXXXXX|||||XXXXXXXX||--|||||||||||||||||||||XXX---XXX||||||||||||--|||||XXXXXXXXFXXXXXXXXXXXXXXXXXXXXXXXXXXXXXXXXXXXXXXXXXXXXX
