HEIGHT=16;WIDTH=201;THEME=0;OVERRIDE=false
--------------------------------------------------------------------------------------------------------------------------------------------------------------------------------------------------------
--------------------------------------------------------------------------------------------------------------------------------------------------------------------------------------------------------
--------------------------------------------------------------------------------------------------------------------------------------------------------------------------------------------------------
--------------------------------------------------------------------------------------------------------------------------------------------------------------------------------------------------------
--------------------------------------------------------------------------------------------------------------------------------------------------------------------------------------------------------
--------------------------------------------------------------------------------------------------------------------------------------------------------------------------------------------------------
------------------------------------------r-------------------------------------------------------------------------------------------------------------------------------------------------------------
------------------------------------------%%%%---------------------------------------------22U----------------------------------------------------------------------------------------------------------
------------------------------------------||||----------------------------------------------------------------------------------------------------------------------------------------------------------
------------------------------------------||||----------------------------------------------------------------------------------------------------------------------------------------------------------
------------------------------------------||||----------------------------------------------------------------------------------------------------------------------------------------------------------
------------------------------------%%%%%%%|||--------k------------------------------------%%%%%-----------------------#--#-----------------------------------------------------------------------------
%%%%%%%%%%%%------------------------||||||||||----%%%%%%%%%%%%%%---%%%%%---%%%%---%%%%%----|||||----------------------##--##----------------------------------------------------------------------------
||||||||||||--------%%%%---%%%%---g-Y|||||||||----||||||||||||||---|||||---y|y|r--|||||----|||||---%%---%%---#--#---%%%%--%%%%--------------------------------------------------------------------------
||||||||||||--------||||---||||%%%%%%%%%%%%%%%%%%%||||||||||||||---|||||%%%%%%%%%%|||||----|||||---||---||--##--##--||||--||||%%%%%--%%%%%%%%%%%%%F%%%%%%%%%%%%%%%%%%%%%%%%%%%%%%%%%%%%%%%%%%%%%%%%%%%%%
||||||||||||XXX--XXX||||---|||||||||||||||||||||||||||||||||||||---||||||||||||||||||||XXXXXXXXXXXX||---||XXXX--XXXX||||--|||||||||--|||||||||||||X|||||||||||||||||||||||||||||||||||||||||||||||||||||
