HEIGHT=16;WIDTH=201;THEME=0;OVERRIDE=false
--------------------------------------------------------------------------------------------------------------------------------------------------------------------------------------------------------
--------------------------------------------------------------------------------------------------------------------------------------------------------------------------------------------------------
--------------------------------------------------------------------------------------------------------------------------------------------------------------------------------------------------------
--------------------------------------------------------------------------------------------------------------------------------------------------------------------------------------------------------
--------------------------------------------------------------------------------------------------------------------------------------------------------------------------------------------------------
--------------------------------------------------------------------------------------------------------------------------------------------------------------------------------------------------------
--------------------------------------------------------------------------------------------------------------------------------------------------------------------------------------------------------
--------------------------------------------------------------------------------------------------------------------------------------------------------------------------------------------------------
-------------------------------------------------------------------------------------------------------CSSCSSS------------------------------------------------------------------------------------------
--------------------------------------------------------------------------------------------------------------------------------U22CCS------------------------------------------------------------------
--------------------------------------------------------------------------------------------------------------------------------------------------------------------------------------------------------
-----------------------------------------------------------------------------#--#-----------------------------------------------------------------------------------------------------------------------
%%%%%%%%%%%%---------------------------%%---%%%%%--%%%----------%%%%---%%%%%%%--%%%%%---%%-----------%%%%%%%%%%%------------------Y-----%%%%%%%%F%%%%%%%%%%%%%%%%%%%%%%%%%%%%%%%%%%%%%%%%%%%%%%%%%%%%%%%
||||||||||||--#---#--%%%%%%------%%--%%||---|||||--|||----------||||---|||||||--|||||---||%%%%---%%%%|||||||||||-------------%%%%%%%%%%%||||||||%|||||||||||||||||||||||||||||||||||||||||||||||||||||||
||||||||||||%%%---%%%||||||------||--||||---|||||--|||%%%%--%%%%||||---|||||||--|||||---||||||---|||||||||||||||%%%%%---%%%%%|||||||||||||||||||||||||||||||||||||||||||||||||||||||||||||||||||||||||||
|||||||||||||||---|||||||||XX--XX||--||||---|||||--|||||||--||||||||---|||||||--|||||---||||||---||||||||||||||||||||---||||||||||||||||||||||||||||||||||||||||||||||||||||||||||||||||||||||||||||||||
