HEIGHT=16;WIDTH=201;THEME=0;OVERRIDE=false
--------------------------------------------------------------------------------------------------------------------------------------------------------------------------------------------------------
--------------------------------------------------------------------------------------------------------------------------------------------------------------------------------------------------------
--------------------------------------------------------------------------------------------------------------------------------------------------------------------------------------------------------
--------------------------------------------------------------------------------------------------------------------------------------------------------------------------------------------------------
--------------------------------------------------------------------------------------------------------------------------------------------------------------------------------------------------------
--------------------------------------------------------------------------------------------------------------------------------------------------------------------------------------------------------
-----------------------------------------------------------SSS------------------------------------------------------------------------------------------------------------------------------------------
--------------------------------------------------------------------------%%%%%---------------------------------------------------------k---------------------------------------------------------------
--------------------------------------------------------------------------|||||---------------------------------------------------%%%%%%%---------------------------------------------------------------
--------------------------------------------------------------------------|||||--%%%%%--------------------------------------------|||||||---------------------------------------------------------------
------------------------------#---#-----------------------%%%%%-----------|||||--|||||--------------------------------------------|||||||---------------------------------------------------------------
-----------------------------##---##----------------------|||||-----------|||||--|||||--------------------------------------------||||||k------g--------------------------------------------------------
---------------------------%%%%---%%%%--------------------|y|||G---------%%%%%%%%%%%%%%%%----------------------------------------%%%%%%%%%%%%%%%%%%%%%%%%%%F%%%%%%%%%%%%%%%%%%%%%%%%%%%%%%%%%%%%%%%%%%%%
------------#---#-----tt---||||---||||-------------%%%%%%%%%%%%%%%%%%%%%%||||||||||||||||-----------%%%%---%%%%--------%%%%--%%%%||||||||||||||||||||||||||%||||||||||||||||||||||||||||||||||||||||||||
%%%%%%%%%%%%%---%%%---tt---||||---||||-------------||||||||||||||||||||||||||||||||||||||-----------||||---||||--#--#--||||--|||||||||||||||||||||||||||||||||||||||||||||||||||||||||||||||||||||||||||
|||||||||||||---|||XXXXXXXX||||---||||XXXXX---XXXXX||||||||||||||||||||||||||||||||||||||XXXX---XXXX||||---||||XXX--XXX||||--|||||||||||||||||||||||||||||||||||||||||||||||||||||||||||||||||||||||||||
