HEIGHT=16;WIDTH=201;THEME=0;OVERRIDE=false
--------------------------------------------------------------------------------------------------------------------------------------------------------------------------------------------------------
--------------------------------------------------------------------------------------------------------------------------------------------------------------------------------------------------------
--------------------------------------------------------------------------------------------------------------------------------------------------------------------------------------------------------
--------------------------------------------------------------------------------------------------------------------------------------------------------------------------------------------------------
--------------------------------------------------------------------------------------------------------------------------------------------------------------------------------------------------------
--------------------------------------------------------------------------------------------------------------------------------------------------------------------------------------------------------
--------------------------------------------------------------------------------------------------------------------------------------------------------------------------------------------------------
--------------------------------------------------------------------------------------------------------------------------------------------------------------------------------------------------------
--------------------------------------------------------------------------------------------------------------------------------------------------------------------------------------------------------
-----------------------------------------------------------------k-r------------------------------------------------------------------------------------------------------------------------------------
---------------------------------------------------------------%%%%%------------------------#---#-----------------------------------%%%%----------------------------------------------------------------
---------------------------------------------------------------|||||-----------------------##---##----------------------------------||||----------------------------------------------------------------
-----------------------------------------%%%%---%%%%-----------|||||--------%%---%%-------###---###----------%%%%%--%%%%%-----------||||----------------------------------------------------------------
----------%%%%%%-------------------------||||---||||-----------|||%%%%%%%---||---||%%%%%%%%%%---%%%%%--#--#--|||||--|||||-----r-y---||||----------------------------------------------------------------
%%%%%%%%%%||||||%%---%%------------%%--%%||||---||||%%%---%%%--||||||||||---||---||||||||||||---|||||%%%--%%%|||||--|||||%%%%%%%%%%%%%%%%%%%%%%%%%%F%%%%%%%%%%%%%%%%%%%%%%%%%%%%%%%%%%%%%%%%%%%%%%%%%%%%
||||||||||||||||||---||XXXXX--XXXXX||--||||||---|||||||---|||XXXXXXXXXXXXXXX||---||||||||||||---||||||||--||||||||--|||||||||||||||||||||||||||||||X||||||||||||||||||||||||||||||||||||||||||||||||||||
