HEIGHT=16;WIDTH=201;THEME=0;OVERRIDE=false
--------------------------------------------------------------------------------------------------------------------------------------------------------------------------------------------------------
--------------------------------------------------------------------------------------------------------------------------------------------------------------------------------------------------------
--------------------------------------------------------------------------------------------------------------------------------------------------------------------------------------------------------
--------------------------------------------------------------------------------------------------------------------------------------------------------------------------------------------------------
--------------------------------------------------------------------------------------------------------------------------------------------------------------------------------------------------------
--------------------------------------------------------------------------------------------------------------------------------------------------------------------------------------------------------
--------------------------------------------------------------------------------------------------------------------------------------------------------------------------------------------------------
-------------------------------------C-2S---------------------------------------------------------------------------------------------------------------------------------------------------------------
--------------------------------------------------------------------------------------------------------------------------------------------------------------------------------------------------------
--------------------------------------%----------------------------------------------------------------------------------------2SS----------------------------------------------------------------------
----------------------------------g--g|-y---------------------------------------------------------------------------------------------------------------------------------------------------------------
----------------------------------%%%%%%%---------------------------------------------------------------------------------------------------------------------------------------------------------------
-----------------------#---#------|||||||--------------#--#---%%%%%%%%%----tt------------------#--#----------------%%%---%%%%%-----r-%%%--%%%-----------------------------------------------------------
----------------------##---##----g||||||r-------------##--##--|||||||||----tt------%%%%--%%%%%%%--%%%--------------|||---|||||%%%%%%%|||--|||-----------------------------------------------------------
%%%%%%%%%%%%%%---%%--###---###--%%%%%%%%%%%%%%---%%%%%%%--%%%%|||||||||%%%%%%%%%%%%||||--|||||||--|||-----------%%%|||---|||||||||||||||--|||-----------------------------------------------------------
||||||||||||||---||XXXXX---XXXXX||||||||||||||---|||||||--|||||||||||||||||||||||||||||--|||||||--|||XXXX---XXXX||||||---|||||||||||||||--|||XXXXXXXXFXXXXXXXXXXXXXXXXXXXXXXXXXXXXXXXXXXXXXXXXXXXXXXXXXX
