HEIGHT=16;WIDTH=201;THEME=0;OVERRIDE=false
--------------------------------------------------------------------------------------------------------------------------------------------------------------------------------------------------------
--------------------------------------------------------------------------------------------------------------------------------------------------------------------------------------------------------
--------------------------------------------------------------------------------------------------------------------------------------------------------------------------------------------------------
--------------------------------------------------------------------------------------------------------------------------------------------------------------------------------------------------------
--------------------------------------------------------------------------------------------------------------------------------------------------------------------------------------------------------
--------------------------------------------------------------------------------------------------------------------------------------------------------------------------------------------------------
--------------------------------------------------------------------------------------------------------------------------------------------------------------------------------------------------------
----------------------------------------------------------------------------------------------Yk--r-----------------------------------------------------------------------------------------------------
---------------------------CC2---------------------------------------------%%%%%%-----------%%%%%%%-----------------------------------------------------------------------------------------------------
---------------------------------------------------------------------------||||||-----------|||||||-----------------------------------------------------------------------------------------------------
---------------------------------------------------------------------------||||||-----------|||||||-----------------------------------------------------------------------------------------------------
--------------------------g-----Tt---------------------2US2S---------------|||||%%%---------|||||||-----------------------------------------------------------------------------------------------------
------------%%%%%%-----%%%%%%%%-tt--------%%%%%%%%%%%----------------------||||||||-------%%%||||||----%%%%%%%---%%%%%%%--%%%%%-----%%--%%--------------------------------------------------------------
------------||||||-----||||||||-tt--------|||||||||||--------%%%---%%%-----||||||||-------|||||||||----|||||||---|||||||--|||||-----||--||--------------------------------------------------------------
%%%%%%%%%%%%%%%%%%%%%%%||||||||%%%%%%%--%%|||||||||||--------|||---|||%%%%%%%%%%%%%%%---y-||||||g|rrk--|||||||---|||||||--|||||-----||--||--------------------------------------------------------------
||||||||||||||||||||||||||||||||||||||--|||||||||||||XXXXXXXX|||---||||||||||||||||||XXXXXXXXXXXXXXXXXX|||||||---|||||||--|||||XXXXX||--||XXXXXXXXFXXXXXXXXXXXXXXXXXXXXXXXXXXXXXXXXXXXXXXXXXXXXXXXXXXXXX
