HEIGHT=16;WIDTH=201;THEME=0;OVERRIDE=false
--------------------------------------------------------------------------------------------------------------------------------------------------------------------------------------------------------
--------------------------------------------------------------------------------------------------------------------------------------------------------------------------------------------------------
--------------------------------------------------------------------------------------------------------------------------------------------------------------------------------------------------------
--------------------------------------------------------------------------------------------------------------------------------------------------------------------------------------------------------
--------------------------------------------------------------------------------------------------------------------------------------------------------------------------------------------------------
--------------------------------------------------------------------------------------------------------------------------------------------------------------------------------------------------------
--------------------------------------------------------------------------------------------------------------------------------------------------------------------------------------------------------
--------------------------------------------------------------------------------------------------------------------------------------------------------------------------------------------------------
--------------------------------------------------------------------------------------------------------------SUCUSS------------------------------------------------------------------------------------
---------------------------------SSUS------2S-----------------------------------------------------------------------------------------------------------------------------------------------------------
--------------------------------------------------------------------------------------------Tt----------------------------------------------------------------------------------------------------------
------------------------------------------|-------------------------------------------------tt----------------------------------Tt----tt----------------------------------------------------------------
----------%%%%--%%%%----------------g----kK-k---#---#-----------------------------------%%%%%%%%%%%---#--#---%%%%%%%%%----------tt----tt----------------------------------------------------------------
----------||||--||||--%%---%%%%%%%%%%%%%%%%%%%%%%---%%%---------------------------------|||||||||||--##--##--|||||||||%%--%%%%%%%%%%%%%%%---------------------------------------------------------------
%%%%%%%%%%||||--||||--||---||||||||||||||||||||||---|||%%%%%--%%%%%----------%%%%---%%%%|||||||||||%%%%--%%%%|||||||||||--|||||||||||||||---------------------------------------------------------------
||||||||||||||--||||XX||---||||||||||||||||||||||---||||||||--|||||XXXX--XXXX||||---|||||||||||||||||||--|||||||||||||||--|||||||||||||||XXXXXXXXFXXXXXXXXXXXXXXXXXXXXXXXXXXXXXXXXXXXXXXXXXXXXXXXXXXXXXX
