HEIGHT=16;WIDTH=201;THEME=0;OVERRIDE=false
--------------------------------------------------------------------------------------------------------------------------------------------------------------------------------------------------------
--------------------------------------------------------------------------------------------------------------------------------------------------------------------------------------------------------
--------------------------------------------------------------------------------------------------------------------------------------------------------------------------------------------------------
--------------------------------------------------------------------------------------------------------------------------------------------------------------------------------------------------------
--------------------------------------------------------------------------------------------------------------------------------------------------------------------------------------------------------
--------------------------------------------------------------------------------------------------------------------------------------------------------------------------------------------------------
--------------------------------------------------------------------------------------------------------------------------------------------------------------------------------------------------------
---------------------------------------------------------------%%%%-------------------------------------------------------------------------------------------------------------------------------------
--------------------------------------------------------------k||||-------------------------------------S2CS--------------------------------------------------------------------------------------------
-------------------------------------------------------------%%%%||-------------------------------------------------------------------------------------------------------------------------------------
-------------------------------------------------------------||||||------------------------------------|------------------------------------------------------------------------------------------------
----------------------------------------------------------g--||||||-r----------------------------------gk-k---------------------------------------------------------------------------------------------
----------------------------------------------k---------%%%%%%%%%%%%%%%%%%---------------------------%%%%%%%-----------------------------%%%%%%%%F%%%%%%%%%%%%%%%%%%%%%%%%%%%%%%%%%%%%%%%%%%%%%%%%%%%%%%
-----------------------------------------%%%%%%---------||||||||||||||||||%%%---%%%----------------y-|||||||----r------------%%%%%--%%%%%||||||||%||||||||||||||||||||||||||||||||||||||||||||||||||||||
%%%%%%%%%%-------%%%%%--%%%%%%%%%%%%%%%%-||||||---------|||||||||||||||||||||---|||-------------%%%%%%%%%%%%%%%%%%%%%%%--%%%%|||||--||||||||||||||||||||||||||||||||||||||||||||||||||||||||||||||||||||
||||||||||XX---XX|||||--||||||||||||||||XXXXXXXXXXXXXXXX|||||||||||||||||||||---|||XXXXX---XXXXX|||||||||||||||||||||||--|||||||||--||||||||||||||||||||||||||||||||||||||||||||||||||||||||||||||||||||
