HEIGHT=16;WIDTH=201;THEME=0;OVERRIDE=false
--------------------------------------------------------------------------------------------------------------------------------------------------------------------------------------------------------
--------------------------------------------------------------------------------------------------------------------------------------------------------------------------------------------------------
--------------------------------------------------------------------------------------------------------------------------------------------------------------------------------------------------------
--------------------------------------------------------------------------------------------------------------------------------------------------------------------------------------------------------
--------------------------------------------------------------------------------------------------------------------------------------------------------------------------------------------------------
--------------------------------------------------------------------------------------------------------------------------------------------------------------------------------------------------------
--------------------------------------------------------------------------------------------------------------------------------------------------------------------------------------------------------
--------------------------------------------------------------------------------------------------------------------------------------------------------------------------------------------------------
----------------------------------------------------------------SSSSSSSS--------------------------------------------------------------------------------------------------------------------------------
--------------------------------------------------------------------------------------------------------------------------------------------------------------------------------------------------------
---------------------------------------------------------------------------------yg------------------------------------------------#---#----------------------------------------------------------------
----------------SSSS----------------------------------------------r-------------%%%%%%%---------------Tt-----------------#---#----##---##---------------------------------------------------------------
-----------------------------------------%%--%%----------------%%%%%%%%%%%%--%%-|||||||---------------tt---------------%%%---%%%%%%%---%%%%-------------------------------------------------------------
%%%%%%%%%%%%%%---------------------------||--||%%%%%%---%%%%%%%||||||||||||--||-|||||||--%%%%---%%%%--tt---------------|||---|||||||---||||%%%%%%%%F%%%%%%%%%%%%%%%%%%%%%%%%%%%%%%%%%%%%%%%%%%%%%%%%%%%%
||||||||||||||----r-----------------y-k--||--||||||||---|||||||||||||||||||--||-k||||||--||||---||||%%%%%%%------------|||---|||||||---||||||||||||%||||||||||||||||||||||||||||||||||||||||||||||||||||
||||||||||||||XXXXXXXXXXXX---XXXXXXXXXXXX||--||||||||---|||||||||||||||||||--||XXXXXXXXXX||||---|||||||||||XXXXX--XXXXX|||---|||||||---|||||||||||||||||||||||||||||||||||||||||||||||||||||||||||||||||
