HEIGHT=16;WIDTH=201;THEME=0;OVERRIDE=false
--------------------------------------------------------------------------------------------------------------------------------------------------------------------------------------------------------
--------------------------------------------------------------------------------------------------------------------------------------------------------------------------------------------------------
--------------------------------------------------------------------------------------------------------------------------------------------------------------------------------------------------------
--------------------------------------------------------------------------------------------------------------------------------------------------------------------------------------------------------
--------------------------------------------------------------------------------------------------------------------------------------------------------------------------------------------------------
--------------------------------------------------------------------------------------------------------------------------------------------------------------------------------------------------------
--------------------------------------------------------------------------------------------------------------------------------------------------------------------------------------------------------
--------------------------------------------------------------------------------------------------------------------------------------------------------------------------------------------------------
--------------------------------------------------------------------------------------------------------------------------------------------------------------------------------------------------------
--------------------------------------------------------------------------------------------------------------------------------------------------------------------------------------------------------
---------------------------#--#-------------------------#---#---------------------#--#------------------------------------------------------------------------------------------------------------------
--------------------------##--##-----------------------##---##-------------------##--##------#--#-------------------------------------------------------------------------------------------------------
-------------------------###--###-------------#---#--%%%%---%%%%---------------%%%%--%%%%---##--##---%%%%%%%--%%%%%---%%%-------------------------------------------------------------------------------
-----------------------%%%%%--%%%%%---------%%%---%%%||||---||||------%%%------||||--||||--###--###--|||||||--|||||---|||-%%%-----------%%%%%%%%F%%%%%%%%%%%%%%%%%%%%%%%%%%%%%%%%%%%%%%%%%%%%%%%%%%%%%%%
-----------------------|||||--|||||%%%%%%%%%|||---|||||||---||||------|||%%%%%%||||--||||%%%%%--%%%%%|||||||--|||||---|||-|||-----------||||||||%|||||||||||||||||||||||||||||||||||||||||||||||||||||||
XXXXXXXXXXXXXXXXX---XXX|||||--|||||||||||||||||---|||||||---||||XX--XX|||||||||||||--|||||||||--||||||||||||--|||||---|||XXXXXXXXXXXXXXX||||||||||||||||||||||||||||||||||||||||||||||||||||||||||||||||
