HEIGHT=16;WIDTH=201;THEME=0;OVERRIDE=false
--------------------------------------------------------------------------------------------------------------------------------------------------------------------------------------------------------
--------------------------------------------------------------------------------------------------------------------------------------------------------------------------------------------------------
--------------------------------------------------------------------------------------------------------------------------------------------------------------------------------------------------------
--------------------------------------------------------------------------------------------------------------------------------------------------------------------------------------------------------
--------------------------------------------------------------------------------------------------------------------------------------------------------------------------------------------------------
------------------------------------------------------------------------------------------------------SS------------------------------------------------------------------------------------------------
--------------------------------------------------------------------------------------------------------------------------------------------------------------------------------------------------------
--------------------------------------------------------------------------------------------------------%-----------------------------------------------------------------------------------------------
-----------------------------------------------------------------------------------------------------r--|-----------------------------------------------------------------------------------------------
-------------------------------------yr-------------------------------------------------------------%%%%%%----------------------------------------------------------------------------------------------
-------------------------SSCUU2--%%%%%%-----------------------------r-y-----------------------------||||||---------------------------#---#--------------------------------------------------------------
---------------------------------||y|||-----------------------------%%%%------------tt--------------y|||||-----#--#-----------------##---##-------------------------------------------------------------
-------------%%%%---%%%%---------||%%%|-----------------------------||||------------tt-tt-tt--%%%%%%%%%%%%%%--##--##--------------%%%%---%%%%-----------------------------------------------------------
%%%%%%%%%%%%%||||---||||----G----||||||r---------------------------y||||r--y--------tt-tt-tt--||||||||||||||%%%%--%%%%------------||||---||||%%%%%%%%F%%%%%%%%%%%%%%%%%%%%%%%%%%%%%%%%%%%%%%%%%%%%%%%%%%
|||||||||||||||||---||||%%%%%%%%%%%%%%%%%%%%%%%%%%%%---%%%%%--%%%%%%%%%%%%%%%%%%%%%%%%%%%%%%%%||||||||||||||||||--||||%%%%%--%%%%%||||---||||||||||||%||||||||||||||||||||||||||||||||||||||||||||||||||
|||||||||||||||||---||||||||||||||||||||||||||||||||---|||||--||||||||||||||||||||||||||||||||||||||||||||||||||--|||||||||--|||||||||---|||||||||||||||||||||||||||||||||||||||||||||||||||||||||||||||
