HEIGHT=16;WIDTH=201;THEME=0;OVERRIDE=false
--------------------------------------------------------------------------------------------------------------------------------------------------------------------------------------------------------
--------------------------------------------------------------------------------------------------------------------------------------------------------------------------------------------------------
--------------------------------------------------------------------------------------------------------------------------------------------------------------------------------------------------------
--------------------------------------------------------------------------------------------------------------------------------------------------------------------------------------------------------
--------------------------------------------------------------------------------------------------------------------------------------------------------------------------------------------------------
--------------------------------------------------------------------------y-----------------------------------------------------------------------------------------------------------------------------
-------------------------------------------------------------------------%%%%%%%------------------------------------------------------------------------------------------------------------------------
-------------------------------------------------------------------------|||||||------------------------------------------------------------------------------------------------------------------------
-------------------------------------------------------------------------|||||||------------------------------------------------------------------------------------------------------------------------
-------------------------------------------------------------------------|||||||----------#--#----------------------------------------------------------------------------------------------------------
-------------------------------------------------------------------------||%%%%|---------##--##---------------------------------------------------------------------------------------------------------
---------------------------------------------------------%%%-------------|||||||--------###--###---------------2CSSS------------------------------------------------------------------------------------
-------------------------%%%%--%%%%%%--%%%%%%--%%%%------|||------------%%%%%%%%%%%%%%%%%%%--%%%%%------------------------------------------------------------------------------------------------------
%%%%%%%%%%%%%%-----------||||--||||||--||||||--||||%%%%%%%%%%%--%%------|||||||||||||||||||--|||||--%%%---%%%------------------%%%%--%%%%%%%%%%%%F%%%%%%%%%%%%%%%%%%%%%%%%%%%%%%%%%%%%%%%%%%%%%%%%%%%%%%
||||||||||||||-----------||||--||||||--||||||--|||||||||||||||--||%%--%%|||||||||||||||||||--|||||%%|||---|||------y-g--%%---%%||||--||||||||||||%||||||||||||||||||||||||||||||||||||||||||||||||||||||
||||||||||||||XXX--XXXXXX||||--||||||--||||||--|||||||||||||||XX||||--|||||||||||||||||||||--||||||||||---|||XXXXXXXXXXX||---||||||--|||||||||||||||||||||||||||||||||||||||||||||||||||||||||||||||||||
