HEIGHT=16;WIDTH=201;THEME=0;OVERRIDE=false
--------------------------------------------------------------------------------------------------------------------------------------------------------------------------------------------------------
--------------------------------------------------------------------------------------------------------------------------------------------------------------------------------------------------------
--------------------------------------------------------------------------------------------------------------------------------------------------------------------------------------------------------
--------------------------------------------------------------------------------------------------------------------------------------------------------------------------------------------------------
--------------------------------------------------------------------------------------------------------------------------------------------------------------------------------------------------------
--------------------------------------------------------------------------------------------------------------------------------------------------------------------------------------------------------
--------------------------------------------------------------------------------------------------------------------------------------------------------------------------------------------------------
--------------------------------------------------------------------------------------------------------------------------------------------------------------------------------------------------------
-----------------------------------------------------------------------------------------------------SCC-SS---------------------------------------------------------------------------------------------
--------------------------------------------------------------------------------------------------------------------------------------------------------------------------------------------------------
--------------------------------------------------------------------------------------------------------%-------------#--#------------------------------------------------------------------------------
--------------k--------------------------------------------------------------#--#------------------k-y-y|------------##--##-----------------------------------------------------------------------------
%%%%%%%%%%%%%%%%%%%%---%%-------------%%%%%%---------------#--#-------------##--##----------------%%%%%%%%%%%%---%%%%%%--%%%%%%%%%%---------------------------------------------------------------------
||||||||||||||||||||---||-------------||||||--------------##--##-----------###--###---------------||||||||||||---||||||--||||||||||%%---%%--------------------------------------------------------------
||||||||||||||||||||---||%%%%%---%%%%%||||||%%%%%--%%%%%%%%%--%%%%-------%%%%%--%%%%%-------------||||||||||||---||||||--||||||||||||---||--------------------------------------------------------------
||||||||||||||||||||---|||||||---||||||||||||||||--|||||||||--||||XX---XX|||||--|||||XXXXX---XXXXX||||||||||||---||||||--||||||||||||---||XXXXXXXXFXXXXXXXXXXXXXXXXXXXXXXXXXXXXXXXXXXXXXXXXXXXXXXXXXXXXX
