HEIGHT=16;WIDTH=201;THEME=0;OVERRIDE=false
--------------------------------------------------------------------------------------------------------------------------------------------------------------------------------------------------------
--------------------------------------------------------------------------------------------------------------------------------------------------------------------------------------------------------
--------------------------------------------------------------------------------------------------------------------------------------------------------------------------------------------------------
--------------------------------------------------------------------------------------------------------------------------------------------------------------------------------------------------------
--------------------------------------------------------------------------------------------------------------------------------------------------------------------------------------------------------
--------------------------------------------------------------------------------------------------------------------------------------------------------------------------------------------------------
--------------------------------------------------------------------------------------------------------------------------------------------------------------------------------------------------------
--------------------------------------------------------------------------------------------------------------------------------------------------------------------------------------------------------
--------------------------------------------------------------------------------------r-----------------------------------------------------------------------------------------------------------------
---------------------------------------------------------------------------------%%%%%%-----------------------------------------------------------------------------------------------------------------
------------------------------------------------------------SSC------------------||||||-----------------------------------------------------------------------------------------------------------------
------------------SS2-------------#---#-----Tt-----------------------------------||||||-----------------------------------CCU2--------------------------------------------------------------------------
--------------------------------%%%---%%%---tt--Tt-----------------------%%%%%---g|||||--%%%%%--%%%%%----------------------------%%%%--%%%%-------------------------------------------------------------
-------------------------#--#---|||---|||---tt--tt-%%%--%%%---g----------|||||-%%%|||||--|||||--|||||%%%%%---%%%%%---------------||||--||||%%%%%%%%F%%%%%%%%%%%%%%%%%%%%%%%%%%%%%%%%%%%%%%%%%%%%%%%%%%%%
%%%%%%%%%%%%%%----------##--##--|||---|||%%%%%%%%%%|||--|||%%%%%%%%%%--%%|||||-||||||||--|||||--||||||||||---|||||%%--%%---------||||--||||||||||||%||||||||||||||||||||||||||||||||||||||||||||||||||||
||||||||||||||XXXXXXXXXXXX--XXXX|||---||||||||||||||||--|||||||||||||--|||||||XXXXXXXXXXX|||||--||||||||||---|||||||--||XXXXXXXXX||||--|||||||||||||||||||||||||||||||||||||||||||||||||||||||||||||||||
