HEIGHT=16;WIDTH=201;THEME=0;OVERRIDE=false
--------------------------------------------------------------------------------------------------------------------------------------------------------------------------------------------------------
--------------------------------------------------------------------------------------------------------------------------------------------------------------------------------------------------------
--------------------------------------------------------------------------------------------------------------------------------------------------------------------------------------------------------
--------------------------------------------------------------------------------------------------------------------------------------------------------------------------------------------------------
--------------------------------------------------------------------------------------------------------------------------------------------------------------------------------------------------------
--------------------------------------------------------------------------------------------------------------------------------------------------------------------------------------------------------
--------------------------------------------------------------------------------------------------------------------------------------------------------------------------------------------------------
--------------------------------------------------------------------------------------------------------------------------------------------------------------------------------------------------------
----------------------------------------------------------------SSCS--------------------------S2S-----g-------------------------------------------------------------------------------------------------
-----------------------------------------------------------------------------------------------------%%%%%---------tt-----------------------------------------------------------------------------------
-----------------------------------------------------------------------------------------------------|||||---------tt-----------------------------------------------------------------------------------
----------------SSSU----------------------#--#-------------------------------------------------------|||||---------tt-----------------------------------------------------------------------------------
----------------------------------------%%%--%%%---------------%%%%%%----------------------%%%%%%%%%-|||||------%%%%%%%%-------------------%%%%%%%%F%%%%%%%%%%%%%%%%%%%%%%%%%%%%%%%%%%%%%%%%%%%%%%%%%%%%
%%%%%%%%%%%%%%--------------------------|||--|||---------------||||||----------------------|||||||||%%%%%%%%%%%%||||||||%%%%%--%%%%%-------||||||||%||||||||||||||||||||||||||||||||||||||||||||||||||||
||||||||||||||-------------------%%---%%|||--|||---------------||||||----------------------||||||||||||||||||||||||||||||||||--|||||-------|||||||||||||||||||||||||||||||||||||||||||||||||||||||||||||
||||||||||||||XXXXXXXXXXXX---XXXX||---|||||--|||XXX--XXXXX---XX||||||XXX---XXXXX--XXXX---XX||||||||||||||||||||||||||||||||||--|||||XX---XX|||||||||||||||||||||||||||||||||||||||||||||||||||||||||||||
