HEIGHT=16;WIDTH=201;THEME=0;OVERRIDE=false
--------------------------------------------------------------------------------------------------------------------------------------------------------------------------------------------------------
--------------------------------------------------------------------------------------------------------------------------------------------------------------------------------------------------------
--------------------------------------------------------------------------------------------------------------------------------------------------------------------------------------------------------
-------------------------------------gry----------------------------------------------------------------------------------------------------------------------------------------------------------------
-----------------------------------%%%%%%---------------------------------------------------------------------------------------------------------------------------------------------------------------
-----------------------------------||||||---------------------------------------------------------------------------------------------------------------------------------------------------------------
-----------------------------------||||||---------------------------------------------------------------------------------------------------------------------------------------------------------------
-----------------------------------||||||---------------------------------------------------------------------------------------------------------------------------------------------------------------
-------------------------------%%%%%%%|||---------------------------------------------------------------------------------------------------------------------------------------------------------------
-------------------------------||||||||||---------------------------------------------------------------------------------------------------------------------------------------------------------------
-------------------------------||||||||||---------------------------------------------------------------------------------------------------------------------------------------------------------------
------------------------------k||||||||||---------------------------------------------------------------------------------------------------------------------------------------------------------------
------------------%%--%%%%%%%%%%%%%%%%%%%%%%%%%%--%%%%%-------------------------------------#--#--------------------------------------------------------------------------------------------------------
%%%%%%%%%%%%------||--||||||||||||||||||||||||||--|||||%%%%---%%%%---------------#--#------##--##---%%---%%%%---%%--------------------------------------------------------------------------------------
||||||||||||------||--||||||||||||||||||||||||||--|||||||||---||||%%%%%--%%%%%--##--##----###--###--||---||||---||-----------------------%%%%%%%%F%%%%%%%%%%%%%%%%%%%%%%%%%%%%%%%%%%%%%%%%%%%%%%%%%%%%%%
||||||||||||XXXXXX||--||||||||||||||||||||||||||--|||||||||---|||||||||--|||||XXXX--XXXXXXXXX--XXXXX||---||||---||XXXXX--XXXXXXXXXXXXXXXX||||||||X||||||||||||||||||||||||||||||||||||||||||||||||||||||
