HEIGHT=16;WIDTH=201;THEME=0;OVERRIDE=false
--------------------------------------------------------------------------------------------------------------------------------------------------------------------------------------------------------
--------------------------------------------------------------------------------------------------------------------------------------------------------------------------------------------------------
--------------------------------------------------------------------------------------------------------------------------------------------------------------------------------------------------------
--------------------------------------------------------------------------------------------------------------------------------------------------------------------------------------------------------
-----------------------------------------------------------------------------------------%%%%%%%--------------------------------------------------------------------------------------------------------
-----------------------------------------------------------------------------------------|||||||--------------------------------------------------------------------------------------------------------
-----------------------------------------------------------------------------------------|||||||--------------------------------------------------------------------------------------------------------
-----------------------------------------------------------------------------------------|||||||--------------------------------------------------------------------------------------------------------
--------------------------------------------------------------------------------------%%%%%%||||--------------------------------------------------------------------------------------------------------
--------------------------------------------------------------------------------------||||||||||--------------------------------------------------------------------------------------------------------
---------------------------------------------------------------------------#--#-----%%%%%%%|||||--------------------------------------------------------------------------------------------------------
--------------------------------------------------------tt----------------##--##----||||||||||||-----------------------------------r--------------------------------------------------------------------
--------------%%%%%---%%%%%-----------------------------tt--tt-----------###--###---||||||||||||-y----------------------%%%---%%%--%%%%%%---------------------------------------------------------------
%%%%%%%%%%%%%%|||||---|||||------------------#---#------tt--tt---------%%%%%--%%%%%%%%%%%%%%%%%%%%%---------------------|||---|||--||||||---%%%%%%%%F%%%%%%%%%%%%%%%%%%%%%%%%%%%%%%%%%%%%%%%%%%%%%%%%%%%
|||||||||||||||||||---|||||-----------------##---##--%%%%%%%%%%%%%---%%|||||--|||||||||||||||||||||-----------%%%%--%%%%|||---|||--|||y||---||||||||%|||||||||||||||||||||||||||||||||||||||||||||||||||
|||||||||||||||||||---|||||XXX--XXXXX---XXXXXX---XXXX|||||||||||||---|||||||--|||||||||||||||||||||XXXX---XXXX||||--|||||||---|||XXXXXXXXXXX||||||||||||||||||||||||||||||||||||||||||||||||||||||||||||
