HEIGHT=16;WIDTH=201;THEME=0;OVERRIDE=false
--------------------------------------------------------------------------------------------------------------------------------------------------------------------------------------------------------
--------------------------------------------------------------------------------------------------------------------------------------------------------------------------------------------------------
--------------------------------------------------------------------------------------------------------------------------------------------------------------------------------------------------------
--------------------------------------------------------------------------------------------------------------------------------------------------------------------------------------------------------
--------------------------------------------------------------------------------------------------------------------------------------------------------------------------------------------------------
--------------------------------------------------------------------------------------------------------------------------------------------------------------------------------------------------------
--------------------------------------------------------------------------------------------------------------------------------------------------------------------------------------------------------
--------------------------------------------------------------------------------------------------------------------------------------------------------------------------------------------------------
-------------------------------SCSC---------------------------------------------------------------------------------------------------------------------------------------------------------------------
--------------------------------------------------------------------------------------------------------------------------------------------------------------------------------------------------------
--------------------------------------------------------------------------------------------------------------------------------------------------------------------------------------------------------
------------------------------g--------------------------------------------------------------------------------SS2--------------------------------------------------------------------------------------
----------------------------%%%%%%%%%%%--%%%%%---%%%%%%%%%---%%%%--------------------------------%%%%%--%%%%%-------------------------------------------------------------------------------------------
%%%%%%%%%%------------------|||||||||||--|||||---|||||||||---||||%%%%---%%%%---------------------|||||--|||||-------------------------------%%%%%%%%F%%%%%%%%%%%%%%%%%%%%%%%%%%%%%%%%%%%%%%%%%%%%%%%%%%%
||||||||||------------------|||||||||||--|||||---|||||||||---||||||||---||||------------%%%---%%%|||||--|||||--k--g-------------------%%%%%%||||||||%|||||||||||||||||||||||||||||||||||||||||||||||||||
||||||||||XXX---XXXXXXXXXXXX|||||||||||XX|||||---|||||||||---||||||||---||||XXXXX--XXXXX|||---||||||||--|||||XXXXXXXXX---XXXXXX---XXXX||||||||||||||||||||||||||||||||||||||||||||||||||||||||||||||||||
