HEIGHT=16;WIDTH=201;THEME=0;OVERRIDE=false
--------------------------------------------------------------------------------------------------------------------------------------------------------------------------------------------------------
--------------------------------------------------------------------------------------------------------------------------------------------------------------------------------------------------------
--------------------------------------------------------------------------------------------------------------------------------------------------------------------------------------------------------
--------------------------------------------------------------------------------------------------------------------------------------------------------------------------------------------------------
--------------------------------------------------------------------------------------------------------------------------------------------------------------------------------------------------------
--------------------------------------------------------------------------------------------------------------------------------------------------------------------------------------------------------
--------------------------------------------------------------------------------------------------------------------------------------------------------------------------------------------------------
--------------------------------------------------------------------------------------------------------------------------------------------------------------------------------------------------------
--------------------------------------------------------------------------------------------------------------------------------------------------------------------------------------------------------
--------------#--#--------%%%%------------------------------------------------------#--#----------------------------------------------------------------------------------------------------------------
-------------##--##-------||||------------------------------------#---#------------##--##---------------------------------------------------------------------------------------------------------------
------------###--###------||||-----------------------------------##---##----------###--###-----------------------------------------------tt-------------------------------------------------------------
----------%%%%%--%%%%%---g||||y--k-----------------------------%%%%---%%%%%%--%%%%%%%--%%%%%---------%%%%%--%%%%%--------------------tt--tt-------------------------------------------------------------
----------|||||--|||||%%%%%%%%%%%%%%-------------%%%%%%--------||||---||||||--|||||||--|||||--#---#--|||||--|||||--------------------tt--tt----%%%%%%%%F%%%%%%%%%%%%%%%%%%%%%%%%%%%%%%%%%%%%%%%%%%%%%%%%
%%%%%%%%%%|||||--|||||||||||||||||||%%%%%---%%%%%||||||--#--#--||||---||||||--|||||||--|||||%%%---%%%|||||--|||||--#--#----#--#--%%%%%%%%%%%%%%||||||||%||||||||||||||||||||||||||||||||||||||||||||||||
|||||||||||||||--||||||||||||||||||||||||---|||||||||||XXX--XXX||||---||||||--|||||||--||||||||---||||||||--|||||XXX--XXXXXX--XXX|||||||||||||||||||||||||||||||||||||||||||||||||||||||||||||||||||||||
