HEIGHT=16;WIDTH=201;THEME=0;OVERRIDE=false
--------------------------------------------------------------------------------------------------------------------------------------------------------------------------------------------------------
--------------------------------------------------------------------------------------------------------------------------------------------------------------------------------------------------------
--------------------------------------------------------------------------------------------------------------------------------------------------------------------------------------------------------
--------------------------------------------------------------------------------------------------------------------------------------------------------------------------------------------------------
--------------------------------------------------------------------------------------------------------------------------------------------------------------------------------------------------------
--------------------------------------------------------------------------------------------------------------------------------------------------------------------------------------------------------
--------------------------------------------------------------------------------------------------------------------------------------------------------------------------------------------------------
--------------------------------------------------------------------------------------------------------------------------------------------------------------------------------------------------------
--------------------------------------------------------------------------------------------------------------------------------------------------------------------------------------------------------
-------------------------SUCCSS-------------------------------------------------------------------------------------------------------------------------------------------------------------------------
--------------------------------------------------------------------------------------------------------------------------------------------------------------------------------------------------------
------------------K-------------------------------------------------------------------------------------------------------------------------------------------------------------------------------------
--------------%%%%%%%%%%---g------------------------------%%%--%%%------------#--#---%%%--%%%-------%%%%--%%%%------------------------------------------------------------------------------------------
--------------||||||||||%%%%%%%%%-------------------------|||--|||-----------##--##--|||--|||-------||||--||||------------------------------------------------------------------------------------------
%%%%%%%%%%%%%%|||||||||||||||||||---------#---#----g------|||--|||---------%%%%--%%%%|||--|||-------||||--||||%%%%--%%%%------------%%--%%--------------------------------------------------------------
|||||||||||||||||||||||||||||||||XX---XXXXX---XXXXXXXXXXXX|||--|||XXX---XXX||||--|||||||--|||XXXXXXX||||--||||||||--||||XXXXX--XXXXX||--||XXXXXXXXFXXXXXXXXXXXXXXXXXXXXXXXXXXXXXXXXXXXXXXXXXXXXXXXXXXXXX
