HEIGHT=16;WIDTH=201;THEME=0;OVERRIDE=false
--------------------------------------------------------------------------------------------------------------------------------------------------------------------------------------------------------
--------------------------------------------------------------------------------------------------------------------------------------------------------------------------------------------------------
--------------------------------------------------------------------------------------------------------------------------------------------------------------------------------------------------------
--------------------------------------------------------------------------------------------------------------------------------------------------------------------------------------------------------
--------------------------------------------------------------------------------------------------------------------------------------------------------------------------------------------------------
--------------------------------------------------------------------------------------------------------------------------------------------------------------------------------------------------------
--------------------------------------------------------------------------------------------------------------------------------------------------------------------------------------------------------
--------------------------------------------------------------------------------------------------------------------------------------------------------------------------------------------------------
--------------------------------------------------------------------------------------------------------------------------------k-----------------------------------------------------------------------
-----------------------------------------------------------------------------------------------------------------------------%%%%-----------------------------------------------------------------------
-----------------------------------------------------------------------------------------------------------------------------||||-----------------------------------------------------------------------
-------------------------------------------------------------y--------------------------------------#---#--------------------||||----r-----y------------------------------------------------------------
%%%%%%%%%%-------------------------------------------------%%%%%%%--------------------%%%%--%%%%---##---##------------------%%%%%%%%%%%%%%%%%%----------------------------------------------------------
||||||||||%%---%%%%--%%----------%%%------------#--#--%%%%%|||||||%%%%--%%%%%%---%%---||||--||||--###---###-----------------||||||||||||||||||%%%%%%%%F%%%%%%%%%%%%%%%%%%%%%%%%%%%%%%%%%%%%%%%%%%%%%%%%%
||||||||||||---||||--||----------|||----------%%%--%%%||||||||||||||||--||||||---||---||||--||||%%%%%---%%%%%--------%%---%%||||||||||||||||||||||||||%|||||||||||||||||||||||||||||||||||||||||||||||||
||||||||||||---||||--||XXXX--XXXX|||XXXX--XXXX|||--|||||||||||||||||||--||||||---||XXX||||--|||||||||---|||||XXXXXXXX||---||||||||||||||||||||||||||||||||||||||||||||||||||||||||||||||||||||||||||||||
