HEIGHT=16;WIDTH=201;THEME=0;OVERRIDE=false
--------------------------------------------------------------------------------------------------------------------------------------------------------------------------------------------------------
--------------------------------------------------------------------------------------------------------------------------------------------------------------------------------------------------------
--------------------------------------------------------------------------------------------------------------------------------------------------------------------------------------------------------
--------------------------------------------------------------------------------------------------------------------------------------------------------------------------------------------------------
--------------------------------------------------------------------------------------------------------------------------------------------------------------------------------------------------------
--------------------------------------------------------------------------------------------------------------------------------------------------------------------------------------------------------
--------------------------------------------------------------------------------------------------------------------------------------------------------------------------------------------------------
--------------------------------------------------------------------------------------------------------------------------------------------------------------------------------------------------------
--------------------------------------------------------------------------------------------------------------------------------------------------------------------------------------------------------
---------------------------------------SCUS-----------------------------------------------------------#---#-----------------------#---#-----------------------------------------------------------------
-----------------------------------------------------------------------------------------------------##---##---------------------##---##----------------------------------------------------------------
-----------------tt---------------------------------------------------------------------------------###---###-------------------###---###---------------------------------------------------------------
--------------tt-tt---tt-%%%%%%%%%%%%-r---------------------------------------------------%%%--%%%%%%%%---%%%%%---------------%%%%%---%%%%%-------------------------------------------------------------
%%%%%%%%%%%%%-tt-tt---tt-||||||||||||%%%%%%%%%%---%%----------------------------%%%%--%%%%|||--||||||||---|||||---------------|||||---|||||-------------------------------------------------------------
|||||||||||||%%%%%%%%%%%%||||||||||||||||||||||---||------%%--%%%%--%%%%%%--%%%%||||--|||||||--||||||||---|||||%%--%%%%%---%%%|||||---|||||%%%%%%%%F%%%%%%%%%%%%%%%%%%%%%%%%%%%%%%%%%%%%%%%%%%%%%%%%%%%%
|||||||||||||||||||||||||||||||||||||||||||||||---||XX--XX||--||||--||||||--||||||||--|||||||--||||||||---|||||||--|||||---||||||||---|||||||||||||X||||||||||||||||||||||||||||||||||||||||||||||||||||
