HEIGHT=16;WIDTH=201;THEME=0;OVERRIDE=false
--------------------------------------------------------------------------------------------------------------------------------------------------------------------------------------------------------
--------------------------------------------------------------------------------------------------------------------------------------------------------------------------------------------------------
--------------------------------------------------------------------------------------------------------------------------------------------------------------------------------------------------------
--------------------------------------------------------------------------------------------------------------------------------------------------------------------------------------------------------
--------------------------------------------------------------------------------------------------------------------------------------------------------------------------------------------------------
--------------------------------------------------------------------------------------------------------------------------------------------------------------------------------------------------------
--------------------------------------------------------------------------------------------------------------------------------------------------------------------------------------------------------
-----------------CCSCS----------------------------------------------------------------------------------------------------------------------------------------------------------------------------------
--------------------------------------------------------------------------------------------------------------------------------------------------------------------------------------------------------
--------------------------------------------------------------------------------------------------------------------------------------------------------------------------------------------------------
----------------yr---g----------------------------------------------------------------------------------------------------------------------------------------------------------------------------------
---------------%%%%%%%--------------------------------------------------------SSCS----------------------------------------------------------------------------------------------------------------------
---------------|||||||------------%%---%%--------------------------------------------------------------------%%%%%--%%%%%-------------------------------------------------------------------------------
----------%%%%%%%%%%%%%%%%%%%%%%%%||---||------------%%%%%---%%%%%------%%------------%%%---%%%%%%%%%%-------|||||--|||||-------%%%%%--%%%%%------------------------------------------------------------
%%%%%%%%%%||||||||||||||||||||||||||---||%%--%%------|||||---|||||------||-------g----|||---||||||||||%%---%%|||||--|||||-------|||||--|||||------------------------------------------------------------
||||||||||||||||||||||||||||||||||||---||||--||XX--XX|||||---|||||XX--XX||XXXXXXXXXXXX|||---||||||||||||---|||||||--|||||XX---XX|||||--|||||XXXXXXXXFXXXXXXXXXXXXXXXXXXXXXXXXXXXXXXXXXXXXXXXXXXXXXXXXXXX
