HEIGHT=16;WIDTH=201;THEME=0;OVERRIDE=false
--------------------------------------------------------------------------------------------------------------------------------------------------------------------------------------------------------
--------------------------------------------------------------------------------------------------------------------------------------------------------------------------------------------------------
--------------------------------------------------------------------------------------------------------------------------------------------------------------------------------------------------------
--------------------------------------------------------------------------------------------------------------------------------------------------------------------------------------------------------
--------------------------------------------------------------------------------------------------------------------------------------------------------------------------------------------------------
--------------------------------------------------------------------------------------------------------------------------------------------------------------------------------------------------------
--------------------------------------------------------------------------------------------------------------------------------------------------------------------------------------------------------
--------------------------------------------------------------------------------------------------------------------------------------------------------------------------------------------------------
--------------------------------------------------------------------------------------------------------------------------------------------------------------------------------------------------------
--------------------------------------------------------------------------------------------------------------------------------------------------------------------------------------------------------
--------------------------------------------------------------------------------------------------------------------------------------------------------------------------------------------------------
---------------------------------------#--#------#---#-------------------------------------%%%%--------------------------#--#----y----------------------------------------------------------------------
-------------------------------------%%%--%%%---##---##----r-k-----%%%---%%%---------------||||------#---#-------------%%%--%%%-%%%%%-------------------------------------------------------------------
%%%%%%%%%%%%%%%--%%%----------%%---%%|||--|||--###---###--%%%%%%%%%|||---|||---------------||||k----##---##------------|||--|||-|||||-g-----------------------------------------------------------------
|||||||||||||||--|||----------||---|||||--|||%%%%%---%%%%%||||||||||||---|||-------%%%%%%%%%%%%%%--###---###--%%%---%%%|||--|||%%%%%%%%%%%%%%%%%%%F%%%%%%%%%%%%%%%%%%%%%%%%%%%%%%%%%%%%%%%%%%%%%%%%%%%%%
|||||||||||||||--|||XXXX--XXXX||---|||||--||||||||---|||||||||||||||||---|||XX---XX||||||||||||||XXXXX---XXXXX|||---||||||--||||||||||||||||||||||X|||||||||||||||||||||||||||||||||||||||||||||||||||||
