HEIGHT=16;WIDTH=201;THEME=0;OVERRIDE=false
--------------------------------------------------------------------------------------------------------------------------------------------------------------------------------------------------------
--------------------------------------------------------------------------------------------------------------------------------------------------------------------------------------------------------
--------------------------------------------------------------------------------------------------------------------------------------------------------------------------------------------------------
--------------------------------------------------------------------------------------------------------------------------------------------------------------------------------------------------------
--------------------------------------------------------------------------------------------------------------------------------------------------------------------------------------------------------
--------------------------------------------------------------------------------------------------------------------------------------------------------------------------------------------------------
--------------------------------------------------------------------------------------------------------------------------------------------------------------------------------------------------------
--------------------------------------------------------------------------------------------------------------------------------------------------------------------------------------------------------
--------------------------------------------------------------------------------------------------------------------------------------------------------------------------------------------------------
--------------------------------------------------------------------------------------%%%%%-------------------------------------------------------------------------------------------------------------
----------------------------------------------#--#------------------------------------r||||---------------#---#-----------------------------------------------------------------------------------------
---------------------------------------------##--##---------------------------------%%%%|||--------------##---##----------------------------------------------------------------------------------------
%%%%%%%%%%%%------------%%%%%---------------###--###-------------%%---%%---#---#----|||||||-------------###---###---------------------------------------------------------------------------------------
||||||||||||------------|||||-------------%%%%%--%%%%%---#---#---||---||--##---##--%%%%%%%%%%---------%%%%%---%%%%%-------------%%%--%%%----------------------------------------------------------------
||||||||||||------------|||||%%%%%---%%%%%|||||--|||||--##---##--||---||%%%%---%%%%||||||||||--#---#--|||||---|||||%%%%%---%%%%%|||--|||%%%%%%%%F%%%%%%%%%%%%%%%%%%%%%%%%%%%%%%%%%%%%%%%%%%%%%%%%%%%%%%%
||||||||||||XXXXX--XXXXX||||||||||---||||||||||--|||||XXXX---XXXX||---||||||---||||||||||||||XXX---XXX|||||---||||||||||---||||||||--|||||||||||X|||||||||||||||||||||||||||||||||||||||||||||||||||||||
