HEIGHT=16;WIDTH=201;THEME=0;OVERRIDE=false
--------------------------------------------------------------------------------------------------------------------------------------------------------------------------------------------------------
--------------------------------------------------------------------------------------------------------------------------------------------------------------------------------------------------------
--------------------------------------------------------------------------------------------------------------------------------------------------------------------------------------------------------
----------------------------------------------------------------------%%%-------------------------------------------------------------------------------------------------------------------------------
----------------------------------------------------------------------|||-------------------------------------------------------------------------------------------------------------------------------
----------------------------------------------------------------------|||-------------------------------------------------------------------------------------------------------------------------------
----------------------------------------------------------------------|||------yy-----------------------------------------------------------------------------------------------------------------------
----------------------------------------------------------------------|||------%%%%---------------------------------------------------------------------------------------------------------------------
----------------------------------------------------------------------|||------||||----------------------------SSC2C2S----------------------------------------------------------------------------------
----------------------------------------------------------------------|||------||||---------------------------------------------------------------------------------------------------------------------
--------------tt---------------------------------------------SSUS-----|||------||||---------------------------------------------------------------------------------------------------------------------
--------------tt------------------------------------------------------||%%%%%--||||------------------------------r--------#--#-----SSS------------------------------------------------------------------
%%%%%%%%%%%---tt----------%%---%%-------------------------------------|||||||--||||---------------%%%%--%%%%%%%%%%%%%%%--##--##---------%%%%%%%%F%%%%%%%%%%%%%%%%%%%%%%%%%%%%%%%%%%%%%%%%%%%%%%%%%%%%%%%
|||||||||||%%%%%%%%-------||---||--#--#--%%--%%%%%%%---%%%%%----------|||||||--||||-------#---#---||||--|||||||||||||||%%%%--%%%%-------||||||||%|||||||||||||||||||||||||||||||||||||||||||||||||||||||
|||||||||||||||||||%%%%%%%||---||%%%--%%%||--|||||||---|||||%%%%%%%%%-||g|k||--||||------##---##--||||--|||||||||||||||||||--||||-------||||||||||||||||||||||||||||||||||||||||||||||||||||||||||||||||
||||||||||||||||||||||||||||---|||||--|||||--|||||||---||||||||||||||XXXXXXXXXXXXXXXXXXXXXX---XXXX||||--|||||||||||||||||||--||||XXXXXXX||||||||||||||||||||||||||||||||||||||||||||||||||||||||||||||||
