HEIGHT=16;WIDTH=201;THEME=0;OVERRIDE=false
--------------------------------------------------------------------------------------------------------------------------------------------------------------------------------------------------------
--------------------------------------------------------------------------------------------------------------------------------------------------------------------------------------------------------
--------------------------------------------------------------------------------------------------------------------------------------------------------------------------------------------------------
--------------------------------------------------------------------------------------------------------------------------------------------------------------------------------------------------------
--------------------------------------------------------------------------------------------------------------------------------------------------------------------------------------------------------
--------------------------------------------------------------------------------------------------------------------------------------------------------------------------------------------------------
--------------------------------------------------------------------------------------------------------------------------------------------------------------------------------------------------------
--------------------------------------------------------------------------------------------------------------------------------------------------------------------------------------------------------
--------------------------------------------------------------------------------------------------------------------------------------------------------------------------------------------------------
--------------------------------------------------------------------------------------------------------------------------------------------------------------------------------------------------------
----------------------------tt--------------------------------------UCS-----------SCS----------SCCSS----------------------------------------------------------------------------------------------------
---------------2SSSS22S-----tt--------------------------------------------------------------------------------------------------------------------------------------------------------------------------
------------------------%%%%%%%%%%%%%--------%%%%%--%%%%%----------------%%%%%------------------------------------------------------%%%---%%%-----------------------------------------------------------
------------------------|||||||||||||--------|||||--|||||----------------|||||--------%%--%%-------k--------------------------#--#--|||---|||-----------------------------------------------------------
%%%%%%%%%%%%%%--y-------|||||||||||||%%%--%%%|||||--|||||-------%%%%%%%%%|||||%%%%%%%%||--||%%%%%%%%%%%-------------------%%%%%--%%%|||---|||-----------------------------------------------------------
||||||||||||||XXXXXXXXXX||||||||||||||||--||||||||--|||||XXXXXXX||||||||||||||||||||||||--|||||||||||||XX--XXXXXXX---XXXXX|||||--||||||---|||XXXXXXXXFXXXXXXXXXXXXXXXXXXXXXXXXXXXXXXXXXXXXXXXXXXXXXXXXXX
