HEIGHT=16;WIDTH=201;THEME=0;OVERRIDE=false
--------------------------------------------------------------------------------------------------------------------------------------------------------------------------------------------------------
--------------------------------------------------------------------------------------------------------------------------------------------------------------------------------------------------------
--------------------------------------------------------------------------------------------------------------------------------------------------------------------------------------------------------
--------------------------------------------------------------------------------------------------------------------------------------------------------------------------------------------------------
--------------------------------------------------------------------------------------------------------------------------------------------------------------------------------------------------------
--------------------------------------------------------------------------------------------------------------------------------------------------------------------------------------------------------
--------------------------------------------------------------------------------------------------------------------------------------------------------------------------------------------------------
-------------------------------------------------------------------------g------------------k-----------------------------------------------------------------------------------------------------------
----------------------------------------------------------------------%%%%%%---------------%%%%%--------------------------------------------------------------------------------------------------------
----------------------------------------------------------------------||||||---------------|||||---------------------#---#------------------------------------------------------------------------------
-----------------------------------%%%%%--------------%%%-------------||||||---------------|||||--------------------##---##-----------------------------------------------------------------------------
----------------#---#--------------|||||--------------|||------r------||||||---------------|||||-------------------###---###----------------------------------------------------------------------------
---------------##---##--%%%%%%%%%--|||||--------------|||----%%%%%%%%%%%%%%%%%%--%%%%%%%%%%%%%%%%%----g----------%%%%%---%%%%%%%%%%---%%%%%-------------------------------------------------------------
-------------%%%%---%%%%|||||||||--|k|||----k-----r---|||--y-||||||||||||||||||--|||||||||||||||||%%%%%%%%%------|||||---||||||||||---|||||%%%%%%%%F%%%%%%%%%%%%%%%%%%%%%%%%%%%%%%%%%%%%%%%%%%%%%%%%%%%%
-------------||||---|||||||||||||%%%%%%%%%%%%%%%%%%%%%%%%%%%%||||||||||||||||||--||||||||||||||||||||||||||------|||||---||||||||||---|||||||||||||%||||||||||||||||||||||||||||||||||||||||||||||||||||
XXXXXXXXXXXXX||||---|||||||||||||||||||||||||||||||||||||||||||||||||||||||||||XX||||||||||||||||||||||||||XX--XX|||||---||||||||||---||||||||||||||||||||||||||||||||||||||||||||||||||||||||||||||||||
