HEIGHT=16;WIDTH=201;THEME=0;OVERRIDE=false
--------------------------------------------------------------------------------------------------------------------------------------------------------------------------------------------------------
--------------------------------------------------------------------------------------------------------------------------------------------------------------------------------------------------------
--------------------------------------------------------------------------------------------------------------------------------------------------------------------------------------------------------
--------------------------------------------------------------------------------------------------------------------------------------------------------------------------------------------------------
--------------------------------------------------------------------------------------------------------------------------------------------------------------------------------------------------------
--------------------------------------------------------------------------------------------------------------------------------------------------------------------------------------------------------
--------------------------------------------------------------------------------------------------------------------------------------------------------------------------------------------------------
--------------------------------------------------------------------------------------------------------------------------------------------------------------------------------------------------------
--------------------------------------------------------------------------------------------------------------------------------------------------------------------------------------------------------
--------------------------------------------Tt--------------#---#-------------------------------------%%%%----------------------------------------------------------------------------------------------
--------------------------------------------tt-------------##---##------------------------------------||||-----------------------UCS--------------------------------------------------------------------
--------------------------------------------tt------------###---###----------------------------SC2S---||k|----------------------------------------------------------------------------------------------
----------------%%%%%%%%%-------%%%%%%%%%%%%%%%%%%------%%%%%---%%%%%-------------------------------%%%%%%%%%%%%----------------------------------------------------------------------------------------
----------%%--%%|||||||||-------||||||||||||||||||%%%%%%|||||---|||||--%%%%%%%%---%%%%%-------------||||||||||||%%%%%---%%%%%-g----k-g------------------------------------------------------------------
%%%%%%%%%%||--|||||||||||%%---%%|||||||||||||||||||||||||||||---|||||--||||||||---|||||%%%%%%-----y-|||||||||||||||||---|||||%%%%%%%%%%-----------------------------------------------------------------
||||||||||||--|||||||||||||---|||||||||||||||||||||||||||||||---|||||XX||||||||---|||||||||||XXXXXXX|||||||||||||||||---|||||||||||||||XXXXXXXXXXXXXXFXXXXXXXXXXXXXXXXXXXXXXXXXXXXXXXXXXXXXXXXXXXXXXXXXX
