HEIGHT=16;WIDTH=201;THEME=0;OVERRIDE=false
--------------------------------------------------------------------------------------------------------------------------------------------------------------------------------------------------------
--------------------------------------------------------------------------------------------------------------------------------------------------------------------------------------------------------
--------------------------------------------------------------------------------------------------------------------------------------------------------------------------------------------------------
--------------------------------------------------------------------------------------------------------------------------------------------------------------------------------------------------------
--------------------------------------------------------------------------------------------------------------------------------------------------------------------------------------------------------
--------------------------------------------------------------------------------------------------------------------------------------------------------------------------------------------------------
--------------------------------------------------------------------------------------------------------------------------------------------------------------------------------------------------------
-------------------------------------SSUC---------------------------------------------------------------%%%%%-------------------------------------------------------------------------------------------
---------------------------------------------------------------------------------------------%%%--------|||||-------------------------------------------------------------------------------------------
---------------------------------------------------------------------------------------------|||--------|||||-------------------------------------------------------------------------------------------
----------------------------kk----------------------------------------------------tt--Tt-----|||--------||||%%%%%%--------------------------------------------------------------------------------------
----------------------------%%%%-----%%%%%----------------------------------------tt--tt----r|||--------||||||||||--------------------------------------------------------------------------------------
-------------tt-------------||||-----|||||----------%%%--%%%------------%%%---%%%%%%%%%%%%%%%%%%%%%%%%--||Gk|k||||--y----%%%%%%%%---%%%%%%%%%%%%F%%%%%%%%%%%%%%%%%%%%%%%%%%%%%%%%%%%%%%%%%%%%%%%%%%%%%%%
-------------tt--tt--%%%%%%%%%%%%%%%-|||||--r-------|||--|||------------|||---||||||||||||||||||||||||%%%%%%%%%%%%%%%%%%%||||||||---||||||||||||%|||||||||||||||||||||||||||||||||||||||||||||||||||||||
%%%%%%%%%%%%-tt--tt--|||||||||||||||%%%%%%%%%%------|||--|||------------|||---|||||||||||||||||||||||||||||||||||||||||||||||||||---||||||||||||||||||||||||||||||||||||||||||||||||||||||||||||||||||||
||||||||||||XXXXXXXXX|||||||||||||||||||||||||XX--XX|||--|||XXXXX--XXXXX|||---|||||||||||||||||||||||||||||||||||||||||||||||||||---||||||||||||||||||||||||||||||||||||||||||||||||||||||||||||||||||||
