HEIGHT=16;WIDTH=201;THEME=0;OVERRIDE=false
--------------------------------------------------------------------------------------------------------------------------------------------------------------------------------------------------------
--------------------------------------------------------------------------------------------------------------------------------------------------------------------------------------------------------
--------------------------------------------------------------------------------------------------------------------------------------------------------------------------------------------------------
--------------------------------------------------------------------------------------------------------------------------------------------------------------------------------------------------------
--------------------------------------------------------------------------------------------------------------------------------------------------------------------------------------------------------
--------------------------------------------------------------------------------------------------------------------------------------------------------------------------------------------------------
--------------------------------------------------------------------------------------------------------------------------------------------------------------------------------------------------------
--------------------------------------------------------------------------------------------------------------------------------------------------------------------------------------------------------
--------------------------------------------------------------------------------------------------------------------------------------------------------------------------------------------------------
--------------------------------------------------------------------------------------------------------------------------------------------------------------------------------------------------------
--------------------------------------------------------------------------------------------------------------------------------------------------------------------------------------------------------
----------------SSSS--------------------------------2SSS------#---#-----SSCS----------------------------------------------------------------------------------------------------------------------------
%%%%%%%%%%%%%----------------------%%--%%--------------------##---##-------------------------------%%%%%--%%%%%-------------%%%%---%%%%-----------------------------------------------------------------
|||||||||||||--------------#---#---||--||%%%%--%%%%---------###---###-----------------------%%---%%|||||--|||||-------------||||---||||--#--#-----------------------------------------------------------
|||||||||||||---------K---##---##--||--||||||--||||---r---%%%%%---%%%%%---r------------%%%%%||---|||||||--|||||%%%%%---%%%%%||||---||||%%%--%%%---------------------------------------------------------
|||||||||||||XXXXXXXXXXXXXXX---XXXX||--||||||--||||XXXXXXX|||||---|||||XXXXXXXXXX--XXXX|||||||---|||||||--||||||||||---|||||||||---|||||||--|||XXXXXXXXFXXXXXXXXXXXXXXXXXXXXXXXXXXXXXXXXXXXXXXXXXXXXXXXX
