HEIGHT=16;WIDTH=201;THEME=0;OVERRIDE=false
--------------------------------------------------------------------------------------------------------------------------------------------------------------------------------------------------------
--------------------------------------------------------------------------------------------------------------------------------------------------------------------------------------------------------
--------------------------------------------------------------------------------------------------------------------------------------------------------------------------------------------------------
--------------------------------------------------------------------------------------------------------------------------------------------------------------------------------------------------------
--------------------------------------------------------------------------------------------------------------------------------------------------------------------------------------------------------
--------------------------------------------------------------------------------------------------------------------------------------------------------------------------------------------------------
--------------------------------------------------------------------------------------------------------------------------------------------------------------------------------------------------------
--------------------------------------------------------------------------------------------------------------------------------------------------------------------------------------------------------
--------------------------------------------------------------------------------------------------------------------------------------------------------------------------------------------------------
-----------------------------------------------------------------------------%%%------------------------------------------------------------------------------------------------------------------------
-----------------------------------------------------------------Tt----------|||------------------------------------------------------SUS---------------------------------------------------------------
----------------g---------#---#-----------------------------tt---tt----------|||------------------------------------------------------------------------------------------------------------------------
%%%%%%%%%%%%%%%%%%%%%%---##---##-----------%%%%%%-----------tt---tt--%%--%%%%%%%%%%%%%%------------------------%%%%%---%%%%%----------------------------------------------------------------------------
||||||||||||||||||||||--###---###----------||||||%%%---%%%%%%%%%%%%%%||--||||||||||||||------------------------|||||---|||||------------G---------------------------------------------------------------
||||||||||||||||||||||%%%%%---%%%%%%%%--%%%|||||||||---||||||||||||||||--||||||||||||||------------%%%%%--%%%%%|||||---|||||---------%%%%%%%%%%%%%%%F%%%%%%%%%%%%%%%%%%%%%%%%%%%%%%%%%%%%%%%%%%%%%%%%%%%
|||||||||||||||||||||||||||---||||||||--||||||||||||---||||||||||||||||--||||||||||||||XX---XXXXXXX|||||--||||||||||---|||||XXXX---XX|||||||||||||||X|||||||||||||||||||||||||||||||||||||||||||||||||||
