HEIGHT=16;WIDTH=201;THEME=0;OVERRIDE=false
--------------------------------------------------------------------------------------------------------------------------------------------------------------------------------------------------------
--------------------------------------------------------------------------------------------------------------------------------------------------------------------------------------------------------
--------------------------------------------------------------------------------------------------------------------------------------------------------------------------------------------------------
--------------------------------------------------------------------------------------------------------------------------------------------------------------------------------------------------------
--------------------------------------------------------------------------------------------------------------------------------------------------------------------------------------------------------
--------------------------------------------------------------------------------------------------------------------------------------------------------------------------------------------------------
--------------------------------------------------------------------------------------------------------------------------------------------------------------------------------------------------------
--------------------------------------------------------------------------------------------------------------------------------------------------------------------------------------------------------
------------------------------------------------g-------------------------------------------------------------------------------------------------------------------------------------------------------
-----------------------------------------------%%%%%%---------------------------------------------------------------------------------------------------------------------------------------------------
-----------------------------------------------||||||--------------------Tt--tt--tt-----%%%-------------------------------------------------------------------------------------------------------------
---------------------------#--#----------------||||||--------------------tt--tt--tt-----|||--------------------------------tt----Tt---------------------------------------------------------------------
%%%%%%%%%%%%%%%%---%%%%---##--##------#---#---%%%%%%%%%%%%%-------------%%%%%%%%%%%%%%--|||--------------------------------tt----tt-%%%%%%%-------------------------------------------------------------
||||||||||||||||---||||--###--###----##---##--|||||||||||||%%%%%---%%%%%||||||||||||||--|||--k------%%--%%%%---%%------%%%%%%%%%%%%%|||||||%%%%%%%%F%%%%%%%%%%%%%%%%%%%%%%%%%%%%%%%%%%%%%%%%%%%%%%%%%%%%
||||||||||||||||---||||%%%%%--%%%%%%%%%---%%%%||||||||||||||||||---|||||||||||||||||||%%%%%%%%%%%%%%||--||||---||------||||||||||||||||||||||||||||%||||||||||||||||||||||||||||||||||||||||||||||||||||
||||||||||||||||---|||||||||--|||||||||---||||||||||||||||||||||---|||||||||||||||||||||||||||||||||||--||||---||XX--XX|||||||||||||||||||||||||||||||||||||||||||||||||||||||||||||||||||||||||||||||||
