HEIGHT=16;WIDTH=201;THEME=0;OVERRIDE=false
--------------------------------------------------------------------------------------------------------------------------------------------------------------------------------------------------------
--------------------------------------------------------------------------------------------------------------------------------------------------------------------------------------------------------
--------------------------------------------------------------------------------------------------------------------------------------------------------------------------------------------------------
--------------------------------------------------------------------------------------------------------------------------------------------------------------------------------------------------------
--------------------------------------------------------------------------------------------------------------------------------------------------------------------------------------------------------
--------------------------------------------------------------------------------------------------------------------------------------------------------------------------------------------------------
--------------------------------------------------------------------------------------------------------------------------------------------------------------------------------------------------------
------------------------------------------2SSSS----------------------------------------------------yy---------------------------------------------------------------------------------------------------
--------------------------------------------------------------------------------SC-S--------------%%%---------------------------------------------------------------------------------------------------
--------------------------------------------------------------------------------------------------|||-----SSSC------------------------------------------------------------------------------------------
------------------------------------------y---r-----------------------------------%---------------|||---------------------------------------------------------------------------------------------------
-----------------tt-----------------------%%%%%%--------------------------------r-|-----g-----y---||g---------------------------------------------------------------------------------------------------
-----------------tt-Tt-----%%%%%---%%%%%--||||||----%%--%%-------------------%%%%%%%--%%%%%%%%%%%%%%%%%%---------%%%%%%%--------------------------------------------------------------------------------
-----------------tt-tt-----|||||---|||||--|||kg|--r-||--||--------%%--%%-----|||||||--||||||||||||||||||%%%%%%%%%|||||||%%%%--%%%%----------------------------------------------------------------------
--------------%%%%%%%%%%%%%|||||---|||||%%%%%%%%%%%%||--||%%%--%%%||--||-----|||||||--||||||||||||||||||||||||||||||||||||||--||||%%%--%%%--------------------------------------------------------------
XXXXXXXXXXXXXX||||||||||||||||||---|||||||||||||||||||--|||||--|||||--||XXXXXXXXXXXXXX||||||||||||||||||||||||||||||||||||||--|||||||--|||XXXXXXXXFXXXXXXXXXXXXXXXXXXXXXXXXXXXXXXXXXXXXXXXXXXXXXXXXXXXXX
