HEIGHT=16;WIDTH=201;THEME=0;OVERRIDE=false
--------------------------------------------------------------------------------------------------------------------------------------------------------------------------------------------------------
--------------------------------------------------------------------------------------------------------------------------------------------------------------------------------------------------------
--------------------------------------------------------------------------------------------------------------------------------------------------------------------------------------------------------
--------------------------------------------------------------------------------------------------------------------------------------------------------------------------------------------------------
--------------------------------------------------------------------------------------------------------------------------------------------------------------------------------------------------------
--------------------------------------------------------------------------------------------------------------------------------------------------------------------------------------------------------
--------------------------------------------------------------------------------------------------------------------------------------------------------------------------------------------------------
--------------------------------------------------------------------------------------------------------------------------------------------------------------------------------------------------------
--------------------------------------------------------------------------------------------------------------------------------------------------------------------------------------------------------
-------------------------------------------------------------------------------------------S-CSS--------------------------------------------------------------------------------------------------------
--------------------------------------------------------------------------------------------------------------------------------------------------------------------------------------------------------
---------------------------------------------------------------#--#-------------------------%-----------------------------------------------------------------------------------------------------------
-------------------------------------------------------------%%%--%%%-----------------------|------------------------------------------%%%--------------------------------------------------------------
------------%%%%---%%%%%%---%%--------%%---%%%%---%%---------|||--|||%%%%---%%%%----------%%%%%%%%%----------------------------------%%|||--------------------------------------------------------------
%%%%%%%%%%%%||||---||||||---||%%%--%%%||---||||---||---------|||--|||||||---||||--------k-|||||||||%%%%%---%%%%%---------------------|||||%%%%%%%%F%%%%%%%%%%%%%%%%%%%%%%%%%%%%%%%%%%%%%%%%%%%%%%%%%%%%%
||||||||||||||||---||||||---|||||--|||||---||||---||XXX---XXX|||--|||||||---||||XXXXXXXXXX||||||||||||||---|||||XXXXXXXXXXXXXX--XXXXX|||||||||||||X|||||||||||||||||||||||||||||||||||||||||||||||||||||
