HEIGHT=16;WIDTH=201;THEME=0;OVERRIDE=false
--------------------------------------------------------------------------------------------------------------------------------------------------------------------------------------------------------
--------------------------------------------------------------------------------------------------------------------------------------------------------------------------------------------------------
--------------------------------------------------------------------------------------------------------------------------------------------------------------------------------------------------------
--------------------------------------------------------------------------------------------------------------------------------------------------------------------------------------------------------
--------------------------------------------------------------------------------------------------------------------------------------------------------------------------------------------------------
--------------------------------------------------------------------------------------------------------------------------------------------------------------------------------------------------------
--------------------------------------------------------------------------------------------------------------------------------------------------------------------------------------------------------
--------------------------------------------------------------------------------------------------------------------------------------------------------------------------------------------------------
---------------------------------------------------------------------SSCC------------------------------------------------------U2CCS--------------------------------------------------------------------
----------------------------------------------------------------------------------------------------------SCCS------------------------------------------------------------------------------------------
--------------------------------------------------------------------------------------------------------------------------------------------------------------------------------------------------------
------------------------------------------------------------------------------------------------------------------------------g-y--g--------------------------------------------------------------------
--------------------------------------------------------------------%%%%%%------%%%--------%%%%%--%%%%%------r---------------%%%%%%%%%%-----------------------------------------------------------------
-------------------------------------------------#--#------#--#-----||||r|--y---|||-----g--|||||--|||||%%%%%%%%-------%%---%%||||||||||----------%%%%%%%%F%%%%%%%%%%%%%%%%%%%%%%%%%%%%%%%%%%%%%%%%%%%%%%
------------------------------------------------##--##----##--##--%%%%%%%%%%%%%%%%%%%%%%%%%|||||--|||||||||||||-------||---||||||||||||%%%%--%%%%||||||||%||||||||||||||||||||||||||||||||||||||||||||||
XXXXXXXXXXXXXXX--XXXXXXXXXX--XXXXXXXXXX--XXXXXXXXX--XXXXXXXX--XXXX||||||||||||||||||||||||||||||--|||||||||||||XX---XX||---||||||||||||||||--|||||||||||||||||||||||||||||||||||||||||||||||||||||||||||
