HEIGHT=16;WIDTH=201;THEME=0;OVERRIDE=false
--------------------------------------------------------------------------------------------------------------------------------------------------------------------------------------------------------
--------------------------------------------------------------------------------------------------------------------------------------------------------------------------------------------------------
--------------------------------------------------------------------------------------------------------------------------------------------------------------------------------------------------------
--------------------------------------------------------------------------------------------------------------------------------------------------------------------------------------------------------
--------------------------------------------------------------------------------------------------------------------------------------------------------------------------------------------------------
--------------------------------------------------------------------------------------------------------------------------------------------------------------------------------------------------------
--------------------------------------------------------------------------------------------------------------------------------------------------------------------------------------------------------
--------------------------------------------------------------------------------------------------------------------------------------------------------------------------------------------------------
--------------------------------------------------------------------------------------------------------------------------------------------------------------------------------------------------------
--------------------------------------------------------Tt----------------------------------------------------------------------------------------------------------------------------------------------
--------------------------------------------------------tt----tt----------------------------tt----------------------------------------------------------------------------------------------------------
--------------------------------------------------------tt----tt----------------------------tt----------------------------------------------------------------------------------------------------------
------------------------------------------------------%%%%%%%%%%%%%----#---#------#---#-----tt-%%%%%--%%%%%--------%%---%%%%%%---%%%%%%---%%%%%%%%%%F%%%%%%%%%%%%%%%%%%%%%%%%%%%%%%%%%%%%%%%%%%%%%%%%%%%
%%%%%%%%%%%%%----------------------------%%%--%%%%%%%%|||||||||||||---##---##---%%%---%%%%%%%%%|||||--|||||--------||---||||||---||||||---||||||||||%|||||||||||||||||||||||||||||||||||||||||||||||||||
|||||||||||||%%%%--%%%%%%--%%------------|||--|||||||||||||||||||||--###---###--|||---||||||||||||||--|||||--------||---||||||---||||||---||||||||||||||||||||||||||||||||||||||||||||||||||||||||||||||
|||||||||||||||||--||||||--||XXXXX--XXXXX|||--|||||||||||||||||||||XXXXX---XXXXX|||---||||||||||||||--|||||XXX--XXX||---||||||---||||||---||||||||||||||||||||||||||||||||||||||||||||||||||||||||||||||
