HEIGHT=16;WIDTH=201;THEME=0;OVERRIDE=false
--------------------------------------------------------------------------------------------------------------------------------------------------------------------------------------------------------
--------------------------------------------------------------------------------------------------------------------------------------------------------------------------------------------------------
--------------------------------------------------------------------------------------------------------------------------------------------------------------------------------------------------------
--------------------------------------------------------------------------------------------------------------------------------------------------------------------------------------------------------
--------------------------------------------------------------------------------------------------------------------------------------------------------------------------------------------------------
--------------------------------------------------------------------------------------------------------------------------------------------------------------------------------------------------------
----------------------------------------------------------------------------------------------------------------SCC2U-----------------------------------------------------------------------------------
--------------------------------------------------------------------------------------------------------------------------------------------------------------------------------------------------------
--------------------------------------------------------------------------------------------------------------------------------------------------------------------------------------------------------
-----------------------------------------------------------------------------------------------------------------k-------------------2UCS---------------------------------------------------------------
----------------------------------------------------------------------------------------------------------------%%%%%%%---------------------------------------------------------------------------------
--------------------------------------------------------------------------------------------------tt---tt---Tt--|||||||---------------------------------------------------------------------------------
-----------------#--#----%%%%%--%%%%%--#---#--------%%---%%---------------#--#--------------------tt---tt---tt--|||||g|---------%%----------------------------------------------------------------------
%%%%%%%%%%%%%---##--##---|||||--|||||%%%---%%%%%%%%%||---||-------------%%%--%%%--#--#-----------%%%%%%%%%%%%%%%%%%%%%%%%%%%%%%%||%%%%%%%%%%%%%%%%F%%%%%%%%%%%%%%%%%%%%%%%%%%%%%%%%%%%%%%%%%%%%%%%%%%%%%
|||||||||||||--###--###--|||||--||||||||---|||||||||||---||%%%%%---%%%%%|||--|||%%%--%%%%%%---%%%|||||||||||||||||||||||||||||||||||||||||||||||||%|||||||||||||||||||||||||||||||||||||||||||||||||||||
|||||||||||||XXXXX--XXXXX|||||--||||||||---|||||||||||---|||||||---||||||||--||||||--||||||---||||||||||||||||||||||||||||||||||||||||||||||||||||||||||||||||||||||||||||||||||||||||||||||||||||||||||
