HEIGHT=16;WIDTH=201;THEME=0;OVERRIDE=false
--------------------------------------------------------------------------------------------------------------------------------------------------------------------------------------------------------
--------------------------------------------------------------------------------------------------------------------------------------------------------------------------------------------------------
--------------------------------------------------------------------------------------------------------------------------------------------------------------------------------------------------------
--------------------------------------------------------------------------------------------------------------------------------------------------------------------------------------------------------
--------------------------------------------------------------------------------------------------------------------------------------------------------------------------------------------------------
--------------------------------------------------------------------------------------------------------------------------------------------------------------------------------------------------------
--------------------------------------------------------------------------------------------------------------------------------------------------------------------------------------------------------
--------------------------------------------------------------------------------------------------------------------------------------------------------------------------------------------------------
--------------------------------------------------------------------------------------------------------------------------------------------------------------------------------------------------------
-------------------------------------------------%%%----------------------------------------------------------------------------------------------------------------------------------------------------
----------------%%%------------------------------|||----------------------------------------------------------------------------------------------------------------------------------------------------
----------------|||--------k---------------------|||----------------------tt----------------------------------#--#--------------------------------------------------------------------------------------
----------------|||------%%%%--------------------|||----------------------tt---------------------------------##--##-------------------------------------------------------------------------------------
%%%%%%%%%%------||g-r----||||---------%%%--------|||----------------------tt----------%%%%%---%%%%%---------###--###--%%%%%--%%%%%-------%%%%%%%%F%%%%%%%%%%%%%%%%%%%%%%%%%%%%%%%%%%%%%%%%%%%%%%%%%%%%%%
||||||||||%%%%%%%%%%%%---||y|r--%%%%%-|||--------|||---------%%%%--%%%%%%%%%%%%%%---%%|||||---|||||-------%%%%%--%%%%%|||||--|||||-------||||||||%||||||||||||||||||||||||||||||||||||||||||||||||||||||
||||||||||||||||||||||XXXXXXXXXX|||||XXXXXXXXXXXXXXXXXXX---XX||||--||||||||||||||---|||||||---|||||XX---XX|||||--||||||||||--|||||XX---XX|||||||||||||||||||||||||||||||||||||||||||||||||||||||||||||||
