HEIGHT=16;WIDTH=201;THEME=0;OVERRIDE=false
--------------------------------------------------------------------------------------------------------------------------------------------------------------------------------------------------------
--------------------------------------------------------------------------------------------------------------------------------------------------------------------------------------------------------
--------------------------------------------------------------------------------------------------------------------------------------------------------------------------------------------------------
--------------------------------------------------------------------------------------------------------------------------------------------------------------------------------------------------------
-------------------------------------------------------------------------------r---------------------SS2SC2---------SSSS--------------------------------------------------------------------------------
----------------------------------------------------------------------------%%%%%%----------------------------------------------------------------------------------------------------------------------
----------------------------------------------------------------------------||||||----------------------------------------------------------------------------------------------------------------------
----------------------------------------------------------------------------||||||--------------------rk-ry---------------------------------------------------------------------------------------------
----------------------------------------------------------------------------|r||||------------------%%%%%%%---------%%%%--------------------------------------------------------------------------------
--------------------------------------------------------------------------%%%%||||------------------|||||||---------||||--------------------------------------------------------------------------------
--------------------------------------------------------------------------||||||||------------------|||||||---------||||--------------------------------------------------------------------------------
--------------------------------------------------------------------------||||r|||----------------g-g||||||---------||y|--k-----------------------------------------------------------------------------
------------%%%%%---%%%%%---------------%%%%---%%%%---#--#-----------%%%%%%%%%%%%%%%%------------%%%%%%%%%%%%%%%%%%%%%%%%%%%----------------------------------------------------------------------------
------------|||||---|||||%%%---%%%------||||---||||--##--##--%%%--%%%||||||||||||||||%%%%%--%%%%%|||||||||||||||||||||||||||%%%%%%%%%%%----%%%%%%%%F%%%%%%%%%%%%%%%%%%%%%%%%%%%%%%%%%%%%%%%%%%%%%%%%%%%%
%%%%%%%%%%%%|||||---||||||||---|||%%%%%%||||---||||%%%%--%%%%|||--||||||||||||||||||||||||--|||||||||||||||||||||||||||||||||||||||||||%%%%||||||||%||||||||||||||||||||||||||||||||||||||||||||||||||||
|||||||||||||||||---||||||||---|||||||||||||---||||||||--|||||||--||||||||||||||||||||||||--||||||||||||||||||||||||||||||||||||||||||||||||||||||||||||||||||||||||||||||||||||||||||||||||||||||||||||
