HEIGHT=16;WIDTH=201;THEME=0;OVERRIDE=false
--------------------------------------------------------------------------------------------------------------------------------------------------------------------------------------------------------
--------------------------------------------------------------------------------------------------------------------------------------------------------------------------------------------------------
--------------------------------------------------------------------------------------------------------------------------------------------------------------------------------------------------------
--------------------------------------------------------------------------------------------------------------------------------------------------------------------------------------------------------
--------------------------------------------------------------------------------------------------------------------------------------------------------------------------------------------------------
--------------------------------------------------------------------------------------------------------------------------------------------------------------------------------------------------------
--------------------------------------------------------------------------------------------------------------------------------------------------------------------------------------------------------
--------------------------------------------------------------------------------------------------------------------------------------------------------------------------------------------------------
--------------------------------------------------------------------------------CCS---------------------------------%%%%%%------------------------------------------------------------------------------
----------------CSSSCC2-------------------------------tt------------------------------------------------------------||||||------------------------------------------------------------------------------
-------------------------------------#---#------------tt-tt--tt-----------------------------------------------------||||||------#---#-------------------------------------------------------------------
------------------------------------##---##-----------tt-tt--tt-------#--#---------kg---------------------------%%%%%%||||-----##---##------------------------------------------------------------------
------------------g---y------------###---###---------%%%%%%%%%%%%%%--##--##--%%%%%%%%%%%--%%-------------------k||||||||||----###---###-----------------------------------------------------------------
%%%%%%%%%%%%%%%%%%%%%%%%---------%%%%%---%%%%%-------||||||||||||||%%%%--%%%%|||||||||||--||-----#--#---------%%%%||||||||--%%%%%---%%%%%---------------------------------------------------------------
||||||||||||||||||||||||%%%---%%%|||||---|||||%%---%%||||||||||||||||||--|||||||||||||||--||%%%%%%--%%%%%%%%--||||y|||k|||--|||||---|||||%%%%%%%%F%%%%%%%%%%%%%%%%%%%%%%%%%%%%%%%%%%%%%%%%%%%%%%%%%%%%%%
|||||||||||||||||||||||||||---||||||||---|||||||---||||||||||||||||||||--|||||||||||||||--||||||||--||||||||XXXXXXXXXXXXXXXX|||||---|||||||||||||X||||||||||||||||||||||||||||||||||||||||||||||||||||||
