HEIGHT=16;WIDTH=201;THEME=0;OVERRIDE=false
--------------------------------------------------------------------------------------------------------------------------------------------------------------------------------------------------------
--------------------------------------------------------------------------------------------------------------------------------------------------------------------------------------------------------
--------------------------------------------------------------------------------------------------------------------------------------------------------------------------------------------------------
--------------------------------------------------------------------------------------------------------------------------------------------------------------------------------------------------------
--------------------------------------------------------------------------------------------------------------------------------------------------------------------------------------------------------
--------------------------------------------------------------------------------------------------------------------------------------------------------------------------------------------------------
--------------------------------------------------------------------------------------------------------------------------------------------------------------------------------------------------------
--------------------------------------------------------------------------------------------------------------------------------------------------------------------------------------------------------
----------------------------------------------------------------SSS2SS-------k--------------------------------------------------------------------------------------------------------------------------
-----------------%%%------------------------------------------------------%%%%%-------------------------------------Tt----------------------------------------------------------------------------------
-----------------|||--------2SSUSS------------------------------------%---|||||-------------#---#-------------------tt----------------------------------------------------------------------------------
-----------------|||--------------------------------------------------|---|||k|------------##---##------------------tt---------------#---#--------------------------------------------------------------
-----------------|||-------%-----------------------------------%%%%%%%%%%%%%%%%%%%%%%%%%--###---###------#--#----%%%%%%%------------##---##---%%%%%%%%F%%%%%%%%%%%%%%%%%%%%%%%%%%%%%%%%%%%%%%%%%%%%%%%%%
%%%%%%%%%%%%%%-%%%%%%%-----|-------%%%-------------------------|||||||||||||||||||||||||%%%%%---%%%%%---##--##---|||||||-----------###---###--||||||||%|||||||||||||||||||||||||||||||||||||||||||||||||
||||||||||||||-|||||||--%%%%%%%%%%%|||%%%%%--%%%%%%%%%%---%%%%%||||||||||||||||||||||||||||||---|||||--###--###--|||||||%%%---%%%%%%%%---%%%%%||||||||||||||||||||||||||||||||||||||||||||||||||||||||||
||||||||||||||XXXXXXXXXX|||||||||||||||||||--||||||||||---|||||||||||||||||||||||||||||||||||---|||||XXXXX--XXXXX||||||||||---||||||||---|||||||||||||||||||||||||||||||||||||||||||||||||||||||||||||||
