HEIGHT=16;WIDTH=201;THEME=0;OVERRIDE=false
--------------------------------------------------------------------------------------------------------------------------------------------------------------------------------------------------------
--------------------------------------------------------------------------------------------------------------------------------------------------------------------------------------------------------
--------------------------------------------------------------------------------------------------------------------------------------------------------------------------------------------------------
--------------------------------------------------------------------------------------------------------------------------------------------------------------------------------------------------------
--------------------------------------------------------------------------------------------------------------------------------------------------------------------------------------------------------
--------------------------------------------------------------------------------------------------------------------------------------------------------------------------------------------------------
--------------------------------------------------------------------------------------------------------------------------------------------------------------------------------------------------------
--------------------------------------------------------------------------------------------------------------------------------------------------------------------------------------------------------
--------------------------------------------------------------------------------------------------------------------------------------------------------------------------------------------------------
--------------------------------------------------------------------------------------------------------------------------------------------------------------------------------------------------------
--------------------------------------------------------------------------r-----------------------------------------------%%%%--------------------------------------------------------------------------
-----------------------------------------------------------------------%%%%%--------------------------tt----Tt------------||||--------------------------------------------------------------------------
-----------%%%--%%%---------%%%%%--%%%%%%%---%%------------------------|||||--------------------------tt----tt---Tt-------||||----------%%%%%%%%F%%%%%%%%%%%%%%%%%%%%%%%%%%%%%%%%%%%%%%%%%%%%%%%%%%%%%%%
-----------|||--|||---------|||||--|||||||---||%%%---%%%%%%%--%%%%-----y||||----k-----------------%%%%%%%%%%%%%%-tt-------||||r-----krr-||||||||%|||||||||||||||||||||||||||||||||||||||||||||||||||||||
-----------|||--|||---------|||||--|||||||---|||||---|||||||--||||%%%%%%%%%%%%%%%%%%%%%%%%---%%%%%||||||||||||||-tt------%%%%%%%%%%%%%%%||||||||||||||||||||||||||||||||||||||||||||||||||||||||||||||||
XXXXXXXXXXX|||--|||XXXXXXXXX|||||--|||||||---|||||---|||||||--||||||||||||||||||||||||||||---|||||||||||||||||||XXXXXXXXX|||||||||||||||||||||||||||||||||||||||||||||||||||||||||||||||||||||||||||||||
