HEIGHT=16;WIDTH=201;THEME=0;OVERRIDE=false
--------------------------------------------------------------------------------------------------------------------------------------------------------------------------------------------------------
--------------------------------------------------------------------------------------------------------------------------------------------------------------------------------------------------------
--------------------------------------------------------------------------------------------------------------------------------------------------------------------------------------------------------
--------------------------------------------------------------------------------------------------------------------------------------------------------------------------------------------------------
--------------------------------------------------------------------------------------------------------------------------------------------------------------------------------------------------------
--------------------------------------------------------------------------------------------------------------------------------------------------------------------------------------------------------
--------------------------------------------------------------------------------------------------------------------------------------------------------------------------------------------------------
--------------------------------------------------------------------------------------------------------------------------------------------------------------------------------------------------------
---------------------------------------------------------------------------------------------------------------------------K----------------------------------------------------------------------------
-------------------------------------%%%%-----------S2SSCCS-------------------------------------------------------------%%%%----------------------------------------------------------------------------
----------------2S2------------------||||-------------------------------------------------#--#--------------------------||||----------------%%%%%-------------------------------------------------------
-------------------------#--#--------||||------------------------------------------------##--##-------------------------||||--%%%%%------y--|||r|-------------------------------------------------------
%%%%%%%%%%%%%%----------##--##-------||y|-K-%%--%%--------------------#--#-------------%%%%--%%%%---------------#---#---||||--|||||----%%%%%%%%%%%%%%%%%%%%%%%F%%%%%%%%%%%%%%%%%%%%%%%%%%%%%%%%%%%%%%%%%
||||||||||||||---------###--###--%%%%%%%%%%%||--||%%%%%%%%%%%%%--%%%%%%--%%%%%%%---%%%%||||--||||-------------%%%---%%%-g|||--|||||----|||||||||||||||||||||||%|||||||||||||||||||||||||||||||||||||||||
||||||||||||||%%%%%%%%%%%%--%%%%%|||||||||||||--|||||||||||||||--||||||--|||||||---||||||||--||||------%%---%%|||---|||%%%%%%%%%%%%%%%%|||||||||||||||||||||||||||||||||||||||||||||||||||||||||||||||||
||||||||||||||||||||||||||--||||||||||||||||||--|||||||||||||||--||||||--|||||||---||||||||--||||XX--XX||---|||||---||||||||||||||||||||||||||||||||||||||||||||||||||||||||||||||||||||||||||||||||||||
