HEIGHT=16;WIDTH=201;THEME=0;OVERRIDE=false
--------------------------------------------------------------------------------------------------------------------------------------------------------------------------------------------------------
--------------------------------------------------------------------------------------------------------------------------------------------------------------------------------------------------------
--------------------------------------------------------------------------------------------------------------------------------------------------------------------------------------------------------
--------------------------------------------------------------------------------------------------------------------------------------------------------------------------------------------------------
--------------------------------------------------------------------------------------------------------------------------------------------------------------------------------------------------------
--------------------------------------------------------------------------------------------------------------------------------------------------------------------------------------------------------
--------------------------------------------------------------------------------------------------------------------------------------------------------------------------------------------------------
--------------------------------------------------------------------------------------------------------------------------------------------------------------------------------------------------------
--------------------------------------------------------------------------------------------------------------------------------------------------------------------------------------------------------
-----------------------------------------------------------------------------------------------------------------------------SSCSCSS--------------------------------------------------------------------
--------------------------------------------------------------------------------------------------------------------------------------------------------------------------------------------------------
--------------------------------------SCCSS---------------------------------------------------------------------------2SS-------------------------------------------------------------------------------
--------------------------------------------------------------------------------------------------%%%%---%%%%%%--%%---------------yy----------%%%%%%%%F%%%%%%%%%%%%%%%%%%%%%%%%%%%%%%%%%%%%%%%%%%%%%%%%%
%%%%%%%%%%-----------%%---%%%%---%%---------------------------%%--%%---g----%%%%%%%---------------||||---||||||--||--------%%%%%%%%%%%%%---%%%||||||||%|||||||||||||||||||||||||||||||||||||||||||||||||
||||||||||-----------||---||||---||-----y----%%--%%-----------||--||%%%%%%%%|||||||%%%%%%%%%------||||---||||||--||--------|||||||||||||---|||||||||||||||||||||||||||||||||||||||||||||||||||||||||||||
||||||||||XXXX---XXXX||---||||---||XXXXXXXXXX||--||XXXX---XXXX||--||||||||||||||||||||||||||XX--XX||||---||||||--||XXXXXXXX|||||||||||||---|||||||||||||||||||||||||||||||||||||||||||||||||||||||||||||
