HEIGHT=16;WIDTH=201;THEME=0;OVERRIDE=false
--------------------------------------------------------------------------------------------------------------------------------------------------------------------------------------------------------
--------------------------------------------------------------------------------------------------------------------------------------------------------------------------------------------------------
--------------------------------------------------------------------------------------------------------------------------------------------------------------------------------------------------------
--------------------------------------------------------------------------------------------------------------------------------------------------------------------------------------------------------
---------------------------%%%-------------------------------%%%%%--------------------------------------------------------------------------------------------------------------------------------------
---------------------------|||-------------------------------|||||--------------------------------------------------------------------------------------------------------------------------------------
---------------------------|||---%%%%------------------------|||||--------------------------------------------------------------------------------------------------------------------------------------
---------------------------|||---||||------------------------|||||--------------------------------------------------------------------------------------------------------------------------------------
---------------------------|||---||||------------------------||||%%%%%%---------------------------------------------------------------------------------------------------------------------------------
---------------------------|||---|||y------------------------||||||||||-----------------------------------------------------------%%%-------------------------------------------------------------------
-------------------#--#----|||---|%%%%%%%--------------------||||||||||-------------------#--#------------------------------------|||-------------------------------------------------------------------
------------------##--##---|||---||||||||--------------------||y||||||k------------------##--##-------------------------------y---|||-------------------------------------------------------------------
----------------%%%%--%%%%-|||---|||%%%||-----------------%%%%%%%%%%%%%%%%--------------###--###---------%%%---%%%-----------%%%%%%||-------------------------------------------------------------------
----------------||||--||||-|||---||||||||-----------------||||||||||||||||------------%%%%%--%%%%%%%---%%|||---|||-----------|||||g|rr-y----------------------------------------------------------------
----------%%--%%||||--||||-|||---||||||||kg---------#--#--||||||||||||||||%%--%%%%%%%%|||||--|||||||---|||||---|||---------%%%%%%%%%%%%%%%%-------------------------------------------------------------
XXXXXXXXXX||--||||||--||||XXXXXXXXXXXXXXXXXXXX--XXXXX--XXX||||||||||||||||||--|||||||||||||--|||||||---|||||---|||XXX---XXX||||||||||||||||XXXXXXXXFXXXXXXXXXXXXXXXXXXXXXXXXXXXXXXXXXXXXXXXXXXXXXXXXXXXX
