HEIGHT=16;WIDTH=201;THEME=0;OVERRIDE=false
--------------------------------------------------------------------------------------------------------------------------------------------------------------------------------------------------------
--------------------------------------------------------------------------------------------------------------------------------------------------------------------------------------------------------
--------------------------------------------------------------------------------------------------------------------------------------------------------------------------------------------------------
--------------------------------------------------------------------------------------------------------------------------------------------------------------------------------------------------------
--------------------------------------------------------------------------------------------------------------------------------------------------------------------------------------------------------
--------------------------------------------------------------------------------------------------------------------------------------------------------------------------------------------------------
------------------------------------------------------------------------------------SUSS----------------------------------------------------------------------------------------------------------------
--------------------------------------------------------------------------------------------------------------------------------------------------------------------------------------------------------
-----------------------------------2CS-2C---------------------------------------------------------------------------------------------------------------------------------------------------------------
---------------------------------------------------------------------------------yg--r------------------------------------------------------------------------------------------------------------------
--------------------------------------%------------------------------------------%%%%%%%-------------------------------------------#---#----------------------------------------------------------------
-------------------------tt-tt-tt-----|-------Y----------------------------------|||||||------------------------2S2---------------##---##---------------------------------------------------------------
----------------------tt-tt-tt-tt-%%%%%%%%%-%%%%%%%-------#--#--------#---#------|||||||----------------------------------------%%%%---%%%%-------------------------------------------------------------
----------------------tt-tt-tt-tt-|||||||||-||g||||------##--##------##---##-----||||||g--------%%%%%--%%%%%--------------------||||---||||%%%%%%%%F%%%%%%%%%%%%%%%%%%%%%%%%%%%%%%%%%%%%%%%%%%%%%%%%%%%%
---------------------%%%%%%%%%%%%%|||||||||%%%%%%%%%%%--###--###----###---###--%%%%%%%%%%%%%%%%%|||||--|||||-----k----%%%%--%%%%||||---||||||||||||%||||||||||||||||||||||||||||||||||||||||||||||||||||
XXXXXXXXXXXXXX---XXXX|||||||||||||||||||||||||||||||||XXXXX--XXXXXXXXXX---XXXXX||||||||||||||||||||||--|||||XXXXXXXXXX||||--||||||||---|||||||||||||||||||||||||||||||||||||||||||||||||||||||||||||||||
