HEIGHT=16;WIDTH=201;THEME=0;OVERRIDE=false
--------------------------------------------------------------------------------------------------------------------------------------------------------------------------------------------------------
--------------------------------------------------------------------------------------------------------------------------------------------------------------------------------------------------------
--------------------------------------------------------------------------------------------------------------------------------------------------------------------------------------------------------
--------------------------------------------------------------------------------------------------------------------------------------------------------------------------------------------------------
--------------------------------------------------------------------------------------------------------------------------------------------------------------------------------------------------------
--------------------------------------------------------------------------------------------------------------------------------------------------------------------------------------------------------
--------------------------------------------------------------------------------------------------------------------------------------------------------------------------------------------------------
--------------------------------------------------------------------------------------------------------------------------------------------------------------------------------------------------------
--------------------------------------------------------------------------------------------------------------------------------------------------------------------------------------------------------
--------------------------------------------------------------------------------------------------------------------------------------------------------------------------------------------------------
--------------------------------------------------------------------------Tt----------------------------------------------------------------------------------------------------------------------------
--------------------------------------------------------------------------tt------------------------------------------------------------SSSCUS----------------------------------------------------------
--------------%%%--%%%--#---#----------------------%%%%--%%%%-------------tt-------#---#--------------------------------------------------------%%%%%%%%F%%%%%%%%%%%%%%%%%%%%%%%%%%%%%%%%%%%%%%%%%%%%%%%
--------------|||--|||%%%---%%%--------------------||||--||||%%%%%%%%%%%%%%%%-----##---##---%%%%%--%%%%%----------------------#--#--------------||||||||%|||||||||||||||||||||||||||||||||||||||||||||||
--------------|||--||||||---|||%%%%%---%%%%%-------||||--||||||||||||||||||||----###---###--|||||--|||||%%%--%%%%%%%---%%%%--##--##--------g--r-||||||||||||||||||||||||||||||||||||||||||||||||||||||||
XXXXXXXXXXXXXX|||--||||||---||||||||---|||||XX---XX||||--||||||||||||||||||||XXXXXXX---XXXXX|||||--||||||||--|||||||---||||XXXX--XXXXXXXXXXXXXXX||||||||||||||||||||||||||||||||||||||||||||||||||||||||
