HEIGHT=16;WIDTH=201;THEME=0;OVERRIDE=false
--------------------------------------------------------------------------------------------------------------------------------------------------------------------------------------------------------
--------------------------------------------------------------------------------------------------------------------------------------------------------------------------------------------------------
--------------------------------------------------------------------------------------------------------------------------------------------------------------------------------------------------------
--------------------------------------------------------------------------------------------------------------------------------------------------------------------------------------------------------
--------------------------------------------------------------------------------------------------------------------------------------------------------------------------------------------------------
--------------------------------------------------------------------------------------------------------------------------------------------------------------------------------------------------------
------------------------gy------------------------------------------------------------------------------------------------------------------------------------------------------------------------------
-----------------------%%%%-----------------------------------------------------------------------------------------------------------------------------------------------------------------------------
-----------------------||||----------------------------------------------SCSS---------------------------------------------------------------------------------------------------------------------------
------------------%%%%%%|||-----------------------------------------------------------------------------------------------------------------------------------------------------------------------------
------------------|||||||||-----------------------------------------------------------------------------------SSSUCC------------------------------------------------------------------------------------
------------------|||||||||-------------------k----------------------------yg---------------------------------------------------------------------------------------------------------------------------
---------------y--|||kg|||r-----%%%%%--%%%%%%%%%%%-----------------------%%%%%%%------tt-------------#---#-------------------------------------%%%%%%%%F%%%%%%%%%%%%%%%%%%%%%%%%%%%%%%%%%%%%%%%%%%%%%%%%
--------------%%%%%%%%%%%%%%%%%%|||||--|||||||||||%%--%%-----------------|||||||------tt--%%%%%%%%%%%%---%%%-----y-----------------------------||||||||%||||||||||||||||||||||||||||||||||||||||||||||||
--------------|||||||||||||||||||||||--|||||||||||||--||%%%%%--%%%%%----r|||||||---%%%%%%%||||||||||||---|||%%%%%%%%%%%%%%%%%%%%---%%%%%%%--%%%|||||||||||||||||||||||||||||||||||||||||||||||||||||||||
XXXXXXXXXXXXXX|||||||||||||||||||||||--|||||||||||||--|||||||--|||||XXXXXXXXXXXXXXX|||||||||||||||||||---|||||||||||||||||||||||---|||||||--||||||||||||||||||||||||||||||||||||||||||||||||||||||||||||
