HEIGHT=16;WIDTH=201;THEME=0;OVERRIDE=false
--------------------------------------------------------------------------------------------------------------------------------------------------------------------------------------------------------
--------------------------------------------------------------------------------------------------------------------------------------------------------------------------------------------------------
--------------------------------------------------------------------------------------------------------------------------------------------------------------------------------------------------------
--------------------------------------------------------------------------------------------------------------------------------------------------------------------------------------------------------
--------------------------------------------------------------------------------------------------------------------------------------------------------------------------------------------------------
--------------------------------------------------------------------------------------------------------------------------------------------------------------------------------------------------------
-----------------USS------------------------------------------------------------------------------------------------------------------------------------------------------------------------------------
--------------------------------------------------------------------------------------------------------------------------------------------------------------------------------------------------------
--------------------------------------------------------------------------------------------------------------------------------------------------------------------------------------------------------
---------------------------------------------2C2U-------------------------------------------------------------------------------------------------------------------------------------------------------
----------------%%%%---------------------------------------------------------------------------------------Tt-------------------------------------------------------------------------------------------
----------------||||---------------------------------------------------------------------------------------tt-------------------------------------------------------------------------------------------
%%%%%%%%%%%%%%%%%%%%%%%--------------------------y-------------------------------%%%---%%%----tt--------%%%%%%-------------------------------%%%%%%%%F%%%%%%%%%%%%%%%%%%%%%%%%%%%%%%%%%%%%%%%%%%%%%%%%%%
|||||||||||||||||||||||-------------%%%%%%%%%%%%%%%%%----------------------------|||---|||----tt--------||||||---------%%%%---%%%%-----------||||||||%||||||||||||||||||||||||||||||||||||||||||||||||||
|||||||||||||||||||||||-------------|||||||||||||||||---------%%%%--%%%%-----g---|||---|||----tt--%%--%%||||||%%%%%%%%%||||---||||%%%%---%%%%|||||||||||||||||||||||||||||||||||||||||||||||||||||||||||
|||||||||||||||||||||||XXXXXXXX--XXX|||||||||||||||||XXXXXXXXX||||--||||XXXXXXXXX|||---|||XXXXXXXX||--|||||||||||||||||||||---||||||||---|||||||||||||||||||||||||||||||||||||||||||||||||||||||||||||||
