HEIGHT=16;WIDTH=201;THEME=0;OVERRIDE=false
--------------------------------------------------------------------------------------------------------------------------------------------------------------------------------------------------------
--------------------------------------------------------------------------------------------------------------------------------------------------------------------------------------------------------
--------------------------------------------------------------------------------------------------------------------------------------------------------------------------------------------------------
--------------------------------------------------------------------------------------------------------------------------------------------------------------------------------------------------------
--------------------------------------------------------------------------------------------------------------------------------------------------------------------------------------------------------
--------------------------------------------------------------------------------------------------------------------------------------------------------------------------------------------------------
--------------------------------------------------------------------------------------------------------------------------------------------------------------------------------------------------------
--------------------------------------------------------------------------------------------------------------------------------------------------------------------------------------------------------
--------------------------------------------------------------------------------------------------------------------------------------------------------------------------------------------------------
--------------------------------------------------------------------------------------------------------------------------------------------------------------------------------------------------------
------------------------#--#----------------------------------------------------------------------------------------------------------------------------------------------------------------------------
---------------k-------##--##---------------------------------------------------------------------#--#-----------y-----------------tt-------------------------------------------------------------------
%%%%%%%%%%%%%%%%%%%%--###--###---------------------%%--%%--tt--Tt---------------------%%%--%%%---##--##--------%%%-----------------tt----%%%%%%%%F%%%%%%%%%%%%%%%%%%%%%%%%%%%%%%%%%%%%%%%%%%%%%%%%%%%%%%
||||||||||||||||||||%%%%%--%%%%%------------#--#---||--||--tt--tt---------------------|||--|||--###--###-------|||--------------%%%%%%%%%||||||||%||||||||||||||||||||||||||||||||||||||||||||||||||||||
|||||||||||||||||||||||||--|||||-----%%%%--##--##--||--||%%%%%%%%%---%%%--%%%---------|||--|||%%%%%--%%%%%-----|||---%%---------||||||||||||||||||||||||||||||||||||||||||||||||||||||||||||||||||||||||
|||||||||||||||||||||||||--|||||XXXXX||||XXXX--XXXX||--|||||||||||XXX|||--|||XXX---XXX|||--||||||||--|||||XXXXXXXXXXX||XXX---XXX||||||||||||||||||||||||||||||||||||||||||||||||||||||||||||||||||||||||
