HEIGHT=16;WIDTH=201;THEME=0;OVERRIDE=false
--------------------------------------------------------------------------------------------------------------------------------------------------------------------------------------------------------
--------------------------------------------------------------------------------------------------------------------------------------------------------------------------------------------------------
--------------------------------------------------------------------------------------------------------------------------------------------------------------------------------------------------------
--------------------------------------------------------------------------------------------------------------------------------------------------------------------------------------------------------
--------------------------------------------------------------------------------------------------------------------------------------------------------------------------------------------------------
--------------------------------------------------------------------------------------------------------------------------------------------------------------------------------------------------------
-----------------------------------------------------------------------------------------------------------------------------%%%------------------------------------------------------------------------
-----------------------------------------------------------------------------------------------------------------------------||r------------------------------------------------------------------------
-----------------------------------------------------------------------------------------------------------------------------|%%%%%%--------------------------------------------------------------------
-----------------------------------------------------------------------------------------------------------------------------|||||||--------------------------------------------------------------------
--------------------------------------------------------------------------------------tt----------------------------C2C------||||r||--------------------------------------------------------------------
----------------#--#------------------------------------------------------------tt----tt-----------------------------------%%%%%%%||--------------------------------------------------------------------
--------------%%%--%%%----------------%%%%%%-------%%%%%--%%%%%%%%%%%%---%%%----tt----tt--%%--%%%%%%%--%%%%%---------------|||||||||---%%%%-------------------------------------------------------------
--------------|||--|||----------------||||||-------|r||g--||||||||||||---|||%%%%%%%%%%%%%%||--|||||||--|||||-------------%%%%%%%%%%%%%%||||%%%%%%%%F%%%%%%%%%%%%%%%%%%%%%%%%%%%%%%%%%%%%%%%%%%%%%%%%%%%%
%%%%%%%%%%%%%%|||--|||%%%---%%%%%---%%||||||----%%%%%%%%%%||||||||||||---|||||||||||||||||||--|||||||--|||||------%%%%%%%||||||||||||||||||||||||||%||||||||||||||||||||||||||||||||||||||||||||||||||||
|||||||||||||||||--||||||---|||||---||||||||XXXX||||||||||||||||||||||---|||||||||||||||||||--|||||||--|||||XX--XX||||||||||||||||||||||||||||||||||||||||||||||||||||||||||||||||||||||||||||||||||||||
