HEIGHT=16;WIDTH=201;THEME=0;OVERRIDE=false
--------------------------------------------------------------------------------------------------------------------------------------------------------------------------------------------------------
--------------------------------------------------------------------------------------------------------------------------------------------------------------------------------------------------------
--------------------------------------------------------------------------------------------------------------------------------------------------------------------------------------------------------
--------------------------------------------------------------------------------------------------------------------------------------------------------------------------------------------------------
--------------------------------------------------------------------------------------------------------------------------------------------------------------------------------------------------------
--------------------------------------------------------------------------------------------------------------------------------------------------------------------------------------------------------
--------------------------------------------------------------------------------------------------------------------------------------------------------------------------------------------------------
--------------------------------------------------------------------------------------------------------------------------------------------------------------------------------------------------------
-----------------------------------------------------------------------------------------------------------------CCSSU----------------------------------------------------------------------------------
--------------------------------------------------------------------------------------------------------------------------------------------------------------------------------------------------------
--------------------------------------------------------------------------------------------------------------------------------------------------------------------------------------------------------
----------------Tt---------------------------------------------------------------------------------------------g-k--------------------------------------------------------------------------------------
----------------tt-----------------%%--%%------%%---%%---------------------------------------Tt--------------%%%%%%%%%%%------#---#-------------%%%%%%%%F%%%%%%%%%%%%%%%%%%%%%%%%%%%%%%%%%%%%%%%%%%%%%%%
------------%%%%%%%%%%%------------||--||------||---||-------------------%%--%%%%%%---%%%%---tt--------------|||||||||||----%%%---%%%---#---#---||||||||%|||||||||||||||||||||||||||||||||||||||||||||||
------------|||||||||||%%%%%--%%%%%||--||%%--%%||---||%%%%--%%%%---------||--||||||---||||%%%%%%%------------|||||||||||----|||---|||--##---##--||||||||||||||||||||||||||||||||||||||||||||||||||||||||
XXXXXXXXXXXX||||||||||||||||--|||||||--||||--||||---||||||--||||XXX---XXX||--||||||---|||||||||||XX--XXXX--XX|||||||||||XXXX|||---|||XXXX---XXXX||||||||||||||||||||||||||||||||||||||||||||||||||||||||
