HEIGHT=16;WIDTH=201;THEME=0;OVERRIDE=false
--------------------------------------------------------------------------------------------------------------------------------------------------------------------------------------------------------
--------------------------------------------------------------------------------------------------------------------------------------------------------------------------------------------------------
--------------------------------------------------------------------------------------------------------------------------------------------------------------------------------------------------------
--------------------------------------------------------------------------------------------------------------------------------------------------------------------------------------------------------
--------------------------------------------------------------------------------------------------------------------------------------------------------------------------------------------------------
-------------------------------------------------------------------%%%%%%%------------------------------------------------------------------------------------------------------------------------------
-------------------------------------------------------------------|||||||------------------------------------------------------------------------------------------------------------------------------
-------------------------------------------------------------------|||||||------------------------------------------------------------------------------------------------------------------------------
-------------------------------------------------------------------|g|||||------------------------------------------------------------------------------------------------------------------------------
-----------------------------------------------------------------%%%%%%%||------------------------------------------------------------------------------------------------------------------------------
---------------------------------------------#--#----------------|||||||||------------------------------------------------------------------------------------------------------------------------------
---------------#---#------------------------##--##---222CS2SS---k|||||||||------------------------------------------------------------------------------------------------------------------------------
--------------##---##---------------------%%%%--%%%%----------%%%%%%%%%%%%%%--#--#-------------%%--%%---------------------------------------------------------------------------------------------------
%%%%%%%%%%%%%%%%---%%%%%%%%%%%%---%%%%%---||||--||||----------||||||||||||||%%%--%%%-----------||--||------%%%%--%%%%%%--%%-----------------------------------------------------------------------------
||||||||||||||||---||||||||||||---|||||%%%||||--||||----------|||||||||||||||||--|||-----------||--||------||||--||||||--||%%%%--%%%%%%%--%%%-----------------------------------------------------------
||||||||||||||||---||||||||||||---||||||||||||--||||XXXXXXXXXX|||||||||||||||||--|||XXXX---XXXX||--||XX--XX||||--||||||--||||||--|||||||--|||XXXXXXXXFXXXXXXXXXXXXXXXXXXXXXXXXXXXXXXXXXXXXXXXXXXXXXXXXXX
