HEIGHT=16;WIDTH=201;THEME=0;OVERRIDE=false
--------------------------------------------------------------------------------------------------------------------------------------------------------------------------------------------------------
--------------------------------------------------------------------------------------------------------------------------------------------------------------------------------------------------------
--------------------------------------------------------------------------------------------------------------------------------------------------------------------------------------------------------
--------------------------------------------------------------------------------------------------------------------------------------------------------------------------------------------------------
--------------------------------------------------------------------------------------------------------------------------------------------------------------------------------------------------------
--------------------------------------------------------------------------------------------------------------------------------------------------------------------------------------------------------
--------------------------------------------------------------------------------------------------------------------------------------------------------------------------------------------------------
------------------------------------------------------------------------------%%%%%%--------------------------------------------------------------------------------------------------------------------
------------------------------------------------------------------------------||||||--------------------------------------------------------------------------------------------------------------------
------------------------------------------------------------------------------||||||--------------------------------------------------------------------------------------------------------------------
-------------------------------------%%%--------------------------------2S----|||||r--------------------------------------------------------------------------------------------------------------------
-------------------------------------|r|---Y----------------------------------|||%%%%%%%----------------------------------------------------------------------------------------------------------------
---------------#--#-----------%%%%%%%%%%%%%%%%--------------#---#------%------||||r|||||-----------------------------#---#------------------------------------------------------------------------------
-------------%%%--%%%%%%---%%%||||||||||||||||---#--#------##---##-----|----%%%%%%%%%%%%%%%%%%%%%--%%%%%------------##---##------------------%%%%%%%%F%%%%%%%%%%%%%%%%%%%%%%%%%%%%%%%%%%%%%%%%%%%%%%%%%%
-------------|||--||||||---|||||||||||||||||||--##--##----###---###--%%%%%%%|||||||||||||||||||||--|||||-----------###---###--%%%---%%%------||||||||%||||||||||||||||||||||||||||||||||||||||||||||||||
XXXXXXXXXXXXX|||--||||||---|||||||||||||||||||XXXX--XXXXXXXXX---XXXXX||||||||||||||||||||||||||||--|||||XXX---XXXXXXXX---XXXXX|||---|||XX--XX|||||||||||||||||||||||||||||||||||||||||||||||||||||||||||
