HEIGHT=16;WIDTH=201;THEME=0;OVERRIDE=false
--------------------------------------------------------------------------------------------------------------------------------------------------------------------------------------------------------
--------------------------------------------------------------------------------------------------------------------------------------------------------------------------------------------------------
--------------------------------------------------------------------------------------------------------------------------------------------------------------------------------------------------------
--------------------------------------------------------------------------------------------------------------------------------------------------------------------------------------------------------
--------------------------------------------------------------------------------------------------------------------------------------------------------------------------------------------------------
--------------------------------------------------------------------------------------------------------------------------------------------------------------------------------------------------------
--------------------------------------------------------------------------------------------------------------------------------------------------------------------------------------------------------
--------------------------------------------------------------------------------------------------------------------------------------------------------------------------------------------------------
----------------------------------------------------------------------------------SCUSS-----------------------------------------------------------------------------------------------------------------
--------------------------------------------------------------------------------------------------------------------------------------------------------------------------------------------------------
---------------------------------------------------------------------------------%------------------------------------------------------tt--------------------------------------------------------------
-------------------------------------------------------------------------C-SS----|--k-----------------------------------------------tt--tt--------------------------------------------------------------
------------%%%%--%%%%-----------------------------------------------------------%%%%%%%--------#---#------------------#--#---------tt--tt--------------------------------------------------------------
%%%%%%%%%%%%||||--||||%%---#---#---%%%%%%%%%%%---%%%%--%%%%---#---#-------%------|||||||-------##---##----------------##--##------%%%%%%%%%%%-----------------------------------------------------------
||||||||||||||||--||||||--##---##--|||||||||||---||||--||||--##---##------|------|g|||||g-----###---###--------------###--###-----|||||||||||%%%%%%%%F%%%%%%%%%%%%%%%%%%%%%%%%%%%%%%%%%%%%%%%%%%%%%%%%%%
||||||||||||||||--||||||XXXX---XXXX|||||||||||XXX||||--||||XXXX---XXXXXXXXXXXXXXXXXXXXXXXXXXXXXXX---XXXXXXXXX--XXXXXXXXX--XXXXXXXX|||||||||||||||||||X||||||||||||||||||||||||||||||||||||||||||||||||||
