HEIGHT=16;WIDTH=201;THEME=0;OVERRIDE=false
--------------------------------------------------------------------------------------------------------------------------------------------------------------------------------------------------------
--------------------------------------------------------------------------------------------------------------------------------------------------------------------------------------------------------
--------------------------------------------------------------------------------------------------------------------------------------------------------------------------------------------------------
--------------------------------------------------------------------------------------------------------------------------------------------------------------------------------------------------------
--------------------------------------------------------------------------------------------------------------------------------------------------------------------------------------------------------
--------------------------------------------------------------------------------------------------------------------------------------------------------------------------------------------------------
--------------------------------------------------------------------------------------------------------------------------------------------------------------------------------------------------------
--------------------------------------------------------------------------------------------------------------------------------------------------------------------------------------------------------
-------------------------------------------------------------------------------%%%---------------------------SSCS2--------------------------------------------------------------------------------------
-------------------------------------------------------------------------------|||----------------------------------------------------------------------------------------------------------------------
-------------------------------------------------------------------------------|||--------------------------------------------CSS-----------------------------------------------------------------------
-------------------------------------------------------------------#--#--------|||----------------------------r-y---------------------------------------------------------------------------------------
%%%%%%%%%%%%%%%%--------------------------------------------------##--##---%%%%%%%%%%-----------------------%%%%%%%%%-----------------------------------------------------------------------------------
||||||||||||||||-------------------%%%---%%%%%%---%%%%%%%--%%%%--###--###--||||||||||---%%%---%%%-----------|||||||||-----------y-----------------------------------------------------------------------
||||||||||||||||------------#---#--|||---||||||---|||||||--||||%%%%%--%%%%%||||||||||%%%|||---|||-----------|||||||||%%--%%%%%%%%%%%%%%%%---%%%%%-------------------------------------------------------
||||||||||||||||XXXXXXXXXXXXX---XXX|||---||||||---|||||||--|||||||||--|||||||||||||||||||||---|||XXXX---XXXX|||||||||||--||||||||||||||||---|||||XXXXXXXXFXXXXXXXXXXXXXXXXXXXXXXXXXXXXXXXXXXXXXXXXXXXXXX
