HEIGHT=16;WIDTH=201;THEME=0;OVERRIDE=false
--------------------------------------------------------------------------------------------------------------------------------------------------------------------------------------------------------
--------------------------------------------------------------------------------------------------------------------------------------------------------------------------------------------------------
--------------------------------------------------------------------------------------------------------------------------------------------------------------------------------------------------------
--------------------------------------------------------------------------------------------------------------------------------------------------------------------------------------------------------
--------------------------------------------------------------------------------------------------------------------------------------------------------------------------------------------------------
--------------------------------------------------------------------------------------------------------------------------------------------------------------------------------------------------------
--------------------------------------------------------------------------------------------------------------------------------------------------------------------------------------------------------
--------------------------------------------------------------------------------------------------------------------------------------------------------------------------------------------------------
--------------------------------------------------------------------------------------------------------------------------------------------------------------------------------------------------------
--------------------------------------------------------------------------------------------------------------------------------------------------------------------------------------------------------
----------------------------------------------------------------------------------r---------------------------------------------------------------------------------------------------------------------
----------------------------------------------------------------------------------%%%---------------------#---#-----------------------------------------------------------------------------------------
%%%%%%%%%%%%%%%%--%%%%%-------------------------%%--%%--tt------------------------|||-------------------%%%---%%%%%%%%---%%%%%--------------------------------------------------------------------------
||||||||||||||||--|||||----y--------------%%--%%||--||--tt-%%%%%---%%%%%--#---#---|||G--g---------------|||---||||||||---|||||-------%%%%---%%%%%%%%%%%%F%%%%%%%%%%%%%%%%%%%%%%%%%%%%%%%%%%%%%%%%%%%%%%%
||||||||||||||||--|||||%%%%%%%%%%%%--%%%%%||--||||--||--tt-|||||---|||||%%%---%%%%%%%%%%%%%%%%%---------|||---||||||||---|||||-------||||---||||||||||||%|||||||||||||||||||||||||||||||||||||||||||||||
||||||||||||||||--|||||||||||||||||--|||||||--||||--||XXXXX|||||---||||||||---|||||||||||||||||XXX---XXX|||---||||||||---|||||XXXXXXX||||---||||||||||||||||||||||||||||||||||||||||||||||||||||||||||||
