HEIGHT=16;WIDTH=201;THEME=0;OVERRIDE=false
--------------------------------------------------------------------------------------------------------------------------------------------------------------------------------------------------------
--------------------------------------------------------------------------------------------------------------------------------------------------------------------------------------------------------
--------------------------------------------------------------------------------------------------------------------------------------------------------------------------------------------------------
--------------------------------------------------------------------------------------------------------------------------------------------------------------------------------------------------------
--------------------------------------------------------------------------------------------------------------------------------------------------------------------------------------------------------
--------------------------------------------------------------------------------------------------------------------------------------------------------------------------------------------------------
--------------------------------------------------------------------------------------------------------------------------------------------------------------------------------------------------------
--------------------------------------------------------------------------------------------------------------------------------------------------------------------------------------------------------
--------------------------------------------------------------------------------------------------------------------------------------------------------------------------------------------------------
--------------------------------------------------------------------------------------------------------------------------------------------------------------------------------------------------------
--------------------------------------------------------------------------------%%%%%%-----------------------------------------#---#--------------------------------------------------------------------
------------SSSUSS--------------------------------------------------------------||||||----------------Tt----------------------##---##-------------------------------------------------------------------
-------------------------------#---#-----%%%--%%%------#---#----------%%---%%---||||||----------------tt---Tt--%%%%%%--------###---###------------------------------------------------------------------
------------------------------##---##----|||--|||-----##---##---------||---||---||||||----------------tt---tt--||||||-y--k-%%%%%---%%%%%----------------------------------------------------------------
%%%%%%%%%%%-----r-k------g--%%%%---%%%%--|||--|||%%%%%%%---%%%%%%%%%%%||---||%%%%%%%%%%%------------%%%%%%%%%%%||||||%%%%%%|||||---|||||%%%%%%%%F%%%%%%%%%%%%%%%%%%%%%%%%%%%%%%%%%%%%%%%%%%%%%%%%%%%%%%%
|||||||||||XXXXXXXXXXXXXXXXX||||---||||XX|||--||||||||||---|||||||||||||---|||||||||||||XXXXX--XXXXX||||||||||||||||||||||||||||---|||||||||||||X|||||||||||||||||||||||||||||||||||||||||||||||||||||||
