HEIGHT=16;WIDTH=201;THEME=0;OVERRIDE=false
--------------------------------------------------------------------------------------------------------------------------------------------------------------------------------------------------------
--------------------------------------------------------------------------------------------------------------------------------------------------------------------------------------------------------
--------------------------------------------------------------------------------------------------------------------------------------------------------------------------------------------------------
--------------------------------------------------------------------------------------------------------------------------------------------------------------------------------------------------------
--------------------------------------------------------------------------------------------------------------------------------------------------------------------------------------------------------
--------------------------------------------------------------------------------------------------------------------------------------------------------------------------------------------------------
--------------------------------------------------------------------------------------------------------------------------------------------------------------------------------------------------------
--------------------------------------------------------------------------------------------------------------------------------------------------------------------------------------------------------
-----------------------------------------------------------------------------------------USSSS2---------------------------------------------------------------------------------------------------------
--------------------------------------------------------------------------------------------------------------------------------------------------------------------------------------------------------
--------------------------------------------------------------------------------------------------------------------------------------------------------------------------------------------------------
--------------------------------------------------------------------------------------------------------------------------------------------------------------------------------------------------------
--------------------------%%%%---%%%%%%%%--%%%%-----%%%%%--%%%%%-----------%%%%---%%%%%%%%%%%%%%%%%%--%%%-------------%%---%%---------------------------------------------------------------------------
--------------------------||||---||||||||--||||%%%%%|||||--|||||%%%---%%%--||||---||||||||||||||||||--|||%%%%%---%%%%%||---||---------------------------------------------------------------------------
--------------%%--%%------||||---||||||||--||||||||||||||--||||||||---|||%%||||---||||||||||||||||||--||||||||---|||||||---||------------%%%%%%%%F%%%%%%%%%%%%%%%%%%%%%%%%%%%%%%%%%%%%%%%%%%%%%%%%%%%%%%
XXXXXXXXXXXXXX||--||XXXXXX||||---||||||||--||||||||||||||--||||||||---|||||||||---||||||||||||||||||--||||||||---|||||||---||XXXXX--XXXXX||||||||X||||||||||||||||||||||||||||||||||||||||||||||||||||||
