HEIGHT=16;WIDTH=201;THEME=0;OVERRIDE=false
--------------------------------------------------------------------------------------------------------------------------------------------------------------------------------------------------------
--------------------------------------------------------------------------------------------------------------------------------------------------------------------------------------------------------
--------------------------------------------------------------------------------------------------------------------------------------------------------------------------------------------------------
--------------------------------------------------------------------------------------------------------------------------------------------------------------------------------------------------------
--------------------------------------------------------------------------------------------------------------------------------------------------------------------------------------------------------
--------------------------------------------------------------------------------------------------------------------------------------------------------------------------------------------------------
--------------------------------------------------------------------------------------------------------------------------------------------------------------------------------------------------------
--------------------------------------------------------------------------------------------------------------------------------------------------------------------------------------------------------
---------------------------------------------------------------------------------------------------------------------------%%%--------------------------------------------------------------------------
-----------------------------------------------SCS------------------------------g------------------------------------------|||k-------------------------------------------------------------------------
-----------------------------------------------------------------------------%%%%%----------------------#--#----SUS2-----%%%%%%%------------------------------------------------------------------------
----------------------r------------------------------------------------------||||y---------------------##--##------------|||||||------------------------------------------------------------------------
---------------------%%%---------------------------------#---#----%%%%%%%%%%%%%%%%%%%----------%%--%%%%%%--%%%%--------%%%%%%%%%%%%------%%%%%%%%F%%%%%%%%%%%%%%%%%%%%%%%%%%%%%%%%%%%%%%%%%%%%%%%%%%%%%%
---------------------|||-------------------%%%%%%%%-----##---##---|||||||||||||||||||%%%%--%%%%||--||||||--||||--------||||||||||||%%--%%||||||||%||||||||||||||||||||||||||||||||||||||||||||||||||||||
%%%%%%%%%%%%%---r----|||--y--%%%%--%%%%%%%%||||||||----###---###--|||||||||||||||||||||||--||||||--||||||--||||%%%%%%%%||||||||||||||--|||||||||||||||||||||||||||||||||||||||||||||||||||||||||||||||||
|||||||||||||XXXXXXXXXXXXXXXX||||--||||||||||||||||XXXXXXX---XXXXX|||||||||||||||||||||||--||||||--||||||--||||||||||||||||||||||||||--|||||||||||||||||||||||||||||||||||||||||||||||||||||||||||||||||
