HEIGHT=16;WIDTH=201;THEME=0;OVERRIDE=false
--------------------------------------------------------------------------------------------------------------------------------------------------------------------------------------------------------
--------------------------------------------------------------------------------------------------------------------------------------------------------------------------------------------------------
--------------------------------------------------------------------------------------------------------------------------------------------------------------------------------------------------------
--------------------------------------------------------------------------------------------------------------------------------------------------------------------------------------------------------
--------------------------------------------------------------------------------------------------------------------------------------------------------------------------------------------------------
--------------------------------------------------------------------------------------------------------------------------------------------------------------------------------------------------------
--------------------------------------------------------------------------------------------------------------------------------------------------------------------------------------------------------
--------------------------------------------------------------------------------------------------------------------------------------------------------------------------------------------------------
--------------------------------------------------------------------------------------------------------------------------------------------------------------------------------------------------------
--------------------------------------------------------------------------------------------------------------------------------------------------------------------------------------------------------
--------------------------------------------------------------------------------------------------------------------------------------------------------------------------------------------------------
-------------------------SUC----------------------------------------------%%%%%%%---------------------------------------------------------#---#---------------------------------------------------------
%%%%%%%%%%%%%%-----------------------------#---#--------------------------|||y|||-----------------------%%%%---%%%%-------------#---#----##---##--%%%%%%%%F%%%%%%%%%%%%%%%%%%%%%%%%%%%%%%%%%%%%%%%%%%%%%
||||||||||||||%%%%--%%%%------------------##---##-----------%%%%%--------%%%%%%%%%%---------------------||||---||||%%%%---%%%%%%%---%%%%%%%---%%%%||||||||%|||||||||||||||||||||||||||||||||||||||||||||
||||||||||||||||||--||||------%%%---%%%--###---###----------|||||--------||||||||||----------%%%%%%%%%%%||||---||||||||---|||||||---|||||||---||||||||||||||||||||||||||||||||||||||||||||||||||||||||||
||||||||||||||||||--||||XXXXXX|||---|||XXXXX---XXXXXXXXXXXXX|||||XXX--XXX||||||||||XXXX--XXXX|||||||||||||||---||||||||---|||||||---|||||||---||||||||||||||||||||||||||||||||||||||||||||||||||||||||||
