HEIGHT=16;WIDTH=201;THEME=0;OVERRIDE=false
--------------------------------------------------------------------------------------------------------------------------------------------------------------------------------------------------------
--------------------------------------------------------------------------------------------------------------------------------------------------------------------------------------------------------
--------------------------------------------------------------------------------------------------------------------------------------------------------------------------------------------------------
--------------------------------------------------------------------------------------------------------------------------------------------------------------------------------------------------------
--------------------------------------------------------------------------------------------------------------------------------------------------------------------------------------------------------
--------------------------------------------------------------------------------------------------------------------------------------------------------------------------------------------------------
--------------------------------------------------------------------------------------------------------------------------------------------------------------------------------------------------------
--------------------------------------------------------------------------------------------------------------------------------------------------------------------------------------------------------
--------------------------------------------------------------------------------------------------------------------------------------------------------------------------------------------------------
-----------------------------#---#-------------------------------------------------------------------------------------------------------------g--------------------------------------------------------
----------------------------##---##----------------------------------------------------------------------------------------------------------%%%%%%%----------------------------------------------------
--------------------SSCS---###---###---tt-------------------------------------tt-----#--#-------------------------tt----Tt-------------------k||||r|g---------------------------------------------------
-------------------------%%%%%---%%%%%-tt-----------%%%%%--%%%%%----------tt--tt---%%%--%%%--#--#-----------------tt----tt----------%%%%%%%%%%%%%%%%%%--------------------------------------------------
-------------------------|||||---|||||-tt-----------|||||--|||||----------tt--tt---|||--|||%%%--%%%---------------tt----tt----------||||||||||||||||||%%%%%%%%F%%%%%%%%%%%%%%%%%%%%%%%%%%%%%%%%%%%%%%%%%
--------------%%%-y------|||||---|||||%%%%%%%%%%--%%|||||--|||||-------%%%%%%%%%%%%|||--||||||--|||%%%%%---%%%%%%%%%%%%%%%%%%%------||||||||||||||||||||||||||%|||||||||||||||||||||||||||||||||||||||||
XXXXXXXXXXXXXX|||XXXXXXXX|||||---|||||||||||||||--|||||||--|||||XXXXXXX|||||||||||||||--||||||--||||||||---|||||||||||||||||||XX--XX||||||||||||||||||||||||||||||||||||||||||||||||||||||||||||||||||||
