HEIGHT=16;WIDTH=201;THEME=0;OVERRIDE=false
--------------------------------------------------------------------------------------------------------------------------------------------------------------------------------------------------------
--------------------------------------------------------------------------------------------------------------------------------------------------------------------------------------------------------
--------------------------------------------------------------------------------------------------------------------------------------------------------------------------------------------------------
--------------------------------------------------------------------------------------------------------------------------------------------------------------------------------------------------------
--------------------------------------------------------------------------------------------------------------------------------------------------------------------------------------------------------
--------------------------------------------------------------------------------------------------------------------------------------------------------------------------------------------------------
--------------------------------------------------------------------------------------------------------------------------------------------------------------------------------------------------------
--------------------------------------------------------------------------------------------------------------------------------------------------------------------------------------------------------
---------------------------------------------------------------------------------------------------%%%%%------------------------------------------------------------------------------------------------
-----------------------------------------------------------------y---------------------------------|||||------------------------------------------------------------------------------------------------
-----------------------------------------------------------------%%%-------------------------------|||||------------------------------------------------------------------------------------------------
-------------------------------------------CCS-------------------k||g-----------------------------y|y|||------------------------------------------------------------------------------------------------
-------------------------%%%%%------------------%%---------%%%%%%%%%%%%--------------------------%%%%%%|-------------------------#---#------------------------------------------------------------------
%%%%%%%%%%%%%------------|||||%%%%---%%%%-------||---------||||||||||||--#--#--------------------|||||||--------%%%%---%%%%-----##---##-----------------------------------------------------------------
|||||||||||||%%%%%--%%%%%|||||||||---||||-------||%%%---%%%||||||||||||%%%--%%%------------------||y|y||--%%--%%||||---||||%%%%%%%---%%%%---------------------------------------------------------------
||||||||||||||||||--||||||||||||||---||||XXXXXXX|||||---||||||||||||||||||--|||XX---XXXXXX--XXXXXXXXXXXXXX||--||||||---|||||||||||---||||XXXXXXXXFXXXXXXXXXXXXXXXXXXXXXXXXXXXXXXXXXXXXXXXXXXXXXXXXXXXXXX
