HEIGHT=16;WIDTH=201;THEME=0;OVERRIDE=false
--------------------------------------------------------------------------------------------------------------------------------------------------------------------------------------------------------
--------------------------------------------------------------------------------------------------------------------------------------------------------------------------------------------------------
--------------------------------------------------------------------------------------------------------------------------------------------------------------------------------------------------------
--------------------------------------------------------------------------------------------------------------------------------------------------------------------------------------------------------
--------------------------------------------------------------------------------------------------------------------------------------------------------------------------------------------------------
--------------------------------------------------------------------------------------------------------------------------------------------------------------------------------------------------------
--------------------------------------------------------------------------------------------------------------------------------------------------------------------------------------------------------
--------------------------------------------------------------------------------------------------------------------------------------------------------------------------------------------------------
----------------------------------------S2SSSC-------------------------------------------------------------------------SUCUUS-SS------------------------------------------------------------------------
--------------------------------------------------------------------------------------------------------------tt----------------------------------------------------------------------------------------
--------------------------------------------------------------------------------------------------------------tt-Tt----------|--------------------------------------------------------------------------
------------------------------------------rk-k---------------------%%%%%--------------------------------------tt-tt----------Y--------------------------------------------------------------------------
----------------#--#------------------%%%%%%%%%%%----Tt---%%%--%%%-|||||-----------------------%%%%---%%%%%%%%%%%%%%%%%%%%%%%%%%%-----------------------------------------------------------------------
%%%%%%%%%%%%%--##--##-----------------|||||||||||----tt---|||--|||-|k|||------%%%%%%%%%---%%%%%||||---|||||||||||||||||||||||||||%%%%%---%%%%%----------------------------------------------------------
|||||||||||||%%%%--%%%%%%%%%%%%%--%%%%|||||||||||%%%%%%%%%|||--|||%%%%%%%%%%%%|||||||||---|||||||||---||||||||||||||||||||||||||||||||---|||||%%%%%%%%F%%%%%%%%%%%%%%%%%%%%%%%%%%%%%%%%%%%%%%%%%%%%%%%%%
|||||||||||||||||--|||||||||||||--|||||||||||||||||||||||||||--||||||||||||||||||||||||---|||||||||---||||||||||||||||||||||||||||||||---|||||||||||||X|||||||||||||||||||||||||||||||||||||||||||||||||
