HEIGHT=16;WIDTH=201;THEME=0;OVERRIDE=false
--------------------------------------------------------------------------------------------------------------------------------------------------------------------------------------------------------
--------------------------------------------------------------------------------------------------------------------------------------------------------------------------------------------------------
--------------------------------------------------------------------------------------------------------------------------------------------------------------------------------------------------------
--------------------------------------------------------------------------------------------------------------------------------------------------------------------------------------------------------
--------------------------------------------------------------------------------------------------------------------------------------------------------------------------------------------------------
--------------------------------------------------------------------------------------------------------------------------------------------------------------------------------------------------------
--------------------------------------------------------------------------------------------------------------------------------------------------------------------------------------------------------
-----------------------------------------------------------------------------------------------------------SSSS-----------------------------------------------------------------------------------------
-------------------------------------------------------%%%%%%%------------------------------------------------------------------------------------------------------------------------------------------
-------------------------------------------------------|||||||------------------------------------------------------------------------------------------------------------------------------------------
-------------------------------------------------------|||||||------S-SCCUS-----------------------------------------------------------------------------------------------------------------------------
----------------------------#---#----------------------|%%%%||---------------------------------------------%%%%-----------------------------------------------------------------------------------------
---------------------------##---##----#--#--%%%%--%%%%-|||||||-------%------%%%%---%%%%--------------------||||-g--k-----------------Tt-----%%%%%%%%F%%%%%%%%%%%%%%%%%%%%%%%%%%%%%%%%%%%%%%%%%%%%%%%%%%%
%%%%%%%%%%%%%%%%%%--%%%%%%%%%---%%%%%%%--%%%||||--||||-|||||||-------|---rg-||||---||||%%%%%--%%%%%%%---%%%%%%%%%%%%%%%%%---#--#-----tt-----||||||||%|||||||||||||||||||||||||||||||||||||||||||||||||||
||||||||||||||||||--|||||||||---|||||||--|||||||--||||-|yg||||-----%%%%%%%%%||||---|||||||||--|||||||---|||||||||||||||||--##--##--%%%%%%%%%||||||||||||||||||||||||||||||||||||||||||||||||||||||||||||
||||||||||||||||||--|||||||||---|||||||--|||||||--||||XXXXXXXXXXXXX|||||||||||||---|||||||||--|||||||---|||||||||||||||||XXXX--XXXX|||||||||||||||||||||||||||||||||||||||||||||||||||||||||||||||||||||
