HEIGHT=16;WIDTH=201;THEME=0;OVERRIDE=false
--------------------------------------------------------------------------------------------------------------------------------------------------------------------------------------------------------
--------------------------------------------------------------------------------------------------------------------------------------------------------------------------------------------------------
--------------------------------------------------------------------------------------------------------------------------------------------------------------------------------------------------------
--------------------------------------------------------------------------------------------------------------------------------------------------------------------------------------------------------
----------------SSS-------------------------------------------------------------------------------------------------------------------------------------------------------------------------------------
----------------------------------------------------------------------r---------------------------------------------------------------------------------------------------------------------------------
-------------------------------------------------------------------%%%%%%-------------------------------------------------------------------------------------------------------------------------------
-------------------------------------------------------------------||||||-------------------------------------------------------------------------------------------------------------------------------
---------------%%%%----------------------------------------------%%%%%|||-------------------------------------------------------------------------------------------------------------------------------
---------------||||----------------------------------------------||||||||-------------------------------------------------------------------------------------------------------------------------------
---------------||||--y-------------------------------------------||||||||-------------------------------------------------------------------------------------------------------------------------------
---------------||%%%%%%------------------------------------------||||||||------------------------------------------------------------#---#--------------------------------------------------------------
%%%%%%%%%%%%%%-||||||||------------------------------------------||||%%%|-----------------------%%--%%%%%%%%%%%%------%%%%%--%%%%%--##---##-------------------------------------------------------------
||||||||||||||-|||||g||--r-------------------------%%%%%--%%%%%--|||||||r----------%%%%%---%%%%%||--||||||||||||------|||||--|||||%%%%---%%%%-----------------------------------------------------------
||||||||||||||%%%%%%%%%%%%%%%%%%%%%--%%%%%%%%---%%%|||||--|||||%%%%%%%%%%%%%%%--%%%|||||---|||||||--||||||||||||------|||||--|||||||||---||||%%%%%%%%F%%%%%%%%%%%%%%%%%%%%%%%%%%%%%%%%%%%%%%%%%%%%%%%%%%
|||||||||||||||||||||||||||||||||||--||||||||---||||||||--||||||||||||||||||||--||||||||---|||||||--||||||||||||XX--XX|||||--|||||||||---||||||||||||X||||||||||||||||||||||||||||||||||||||||||||||||||
