HEIGHT=16;WIDTH=201;THEME=0;OVERRIDE=false
--------------------------------------------------------------------------------------------------------------------------------------------------------------------------------------------------------
--------------------------------------------------------------------------------------------------------------------------------------------------------------------------------------------------------
--------------------------------------------------------------------------------------------------------------------------------------------------------------------------------------------------------
--------------------------------------------------SSSS--------------------------------------------------------------------------------------------------------------------------------------------------
--------------------------------------------------------------------------------------------------------------------------------------------------------------------------------------------------------
--------------------------------------------------------------------------------------------------------------------------------------------------------------------------------------------------------
----------------------------------------------------ygg-------------------------------------------------------------------------------------------------------------------------------------------------
--------------------------------------------------%%%%%%---------------------------------------------------SSS------------------------------------------------------------------------------------------
--------------------------------------------------||||||------------------------------------------------------------------------------------------------------------------------------------------------
--------------------------------------------------||||||------------Tt----------------------------------------%-----------------------------------------------------------------------------------------
--------------------------------------------------||||||---------tt-tt----------------------------------------|-----------------------------------------------------------------------------------------
-----------------------------------------------%%%%|||||---------tt-tt-------------------------------------%%%%-----------------------------------------------------------------------------------------
-----------------------------------------------|||||||||-------%%%%%%%%%----------------------%%%%--%%%%--y|r||--g---yk---------%%%%%%%%----------------------------------------------------------------
%%%%%%%%%%%-----------%%%%---------------------|||||||||-------|||||||||---------%%%%%---%%%%%||||--||||%%%%%%%%%%%%%%%%%%%---%%||||||||----------------------------------------------------------------
|||||||||||%%%%---%%%%||||-------------%%--%%--|||||||||----r--|||||||||%%%---%%%|||||---|||||||||--|||||||||||||||||||||||---||||||||||%%%%%%%%F%%%%%%%%%%%%%%%%%%%%%%%%%%%%%%%%%%%%%%%%%%%%%%%%%%%%%%%
|||||||||||||||---||||||||XXX---XXXXXXX||--||XXXXXXXXXXXXXXXXXX||||||||||||---||||||||---|||||||||--|||||||||||||||||||||||---||||||||||||||||||X|||||||||||||||||||||||||||||||||||||||||||||||||||||||
