HEIGHT=16;WIDTH=201;THEME=0;OVERRIDE=false
--------------------------------------------------------------------------------------------------------------------------------------------------------------------------------------------------------
--------------------------------------------------------------------------------------------------------------------------------------------------------------------------------------------------------
--------------------------------------------------------------------------------------------------------------------------------------------------------------------------------------------------------
--------------------------------------------------------------------------------------------------------------------------------------------------------------------------------------------------------
--------------------------------------------------------------------------------------------------------------------------------------------------------------------------------------------------------
--------------------------------------------------------------------------------------------------------------------------------------------------------------------------------------------------------
--------------------------------------------------------------------------------------------------------------------------------------------------------------------------------------------------------
--------------------------------------------------------------------------------------------------------------------------------------------------------------------------------------------------------
--------------------------------------------------------------------------------------------------------------------------------------------------------------------------------------------------------
---------------------------------------------------------%%%--------S-CS--------------------------------------------------------------------------------------------------------------------------------
-------------------------------------Tt---tt---%%%%------|||--------------------------------------------------------------------------------------------------------------------------------------------
-------------------------------------tt---tt---||||------|r|k--------%----------------------------------------------------------------------------------------------------------------------------------
%%%%%%%%%%%%%--------------#---#-----tt---tt---||%%%%--%%%%%%%%%%----|--y---------------------------------------%%%--%%%------------------------%%%%%%%%F%%%%%%%%%%%%%%%%%%%%%%%%%%%%%%%%%%%%%%%%%%%%%%%
|||||||||||||%%%%---%%%%--##---##--%%%%%%%%%%--||||||--||||||||||%%%%%%%%%%%------------------------------------|||--|||----------------#---#---||||||||%|||||||||||||||||||||||||||||||||||||||||||||||
|||||||||||||||||---||||%%%%---%%%%||||||||||%%%%%%%%%%|||||||||||||||||||||----%%%%---%%%%%%%--%%%%%---%%------|||--|||---------------##---##--||||||||||||||||||||||||||||||||||||||||||||||||||||||||
|||||||||||||||||---||||||||---|||||||||||||||||||||||||||||||||||||||||||||XXXX||||---|||||||--|||||---||XX--XX|||--|||XX--XXXX---XXXXXX---XXXX||||||||||||||||||||||||||||||||||||||||||||||||||||||||
