HEIGHT=16;WIDTH=201;THEME=0;OVERRIDE=false
--------------------------------------------------------------------------------------------------------------------------------------------------------------------------------------------------------
--------------------------------------------------------------------------------------------------------------------------------------------------------------------------------------------------------
--------------------------------------------------------------------------------------------------------------------------------------------------------------------------------------------------------
--------------------------------------------------------------------------------------------------------------------------------------------------------------------------------------------------------
--------------------------------------------------------------------------------------------------------------------------------------------------------------------------------------------------------
--------------------------------------------------------------------------------------------------------------------------------------------------------------------------------------------------------
--------------------------------------------------------------------------------------------------------------------------------------------------------------------------------------------------------
--------------------------------------------------------------------------------------------------------------------------------------------------------------------------------------------------------
--------------------------------------------------------------------------------------------------------------------------------------------------------------------------------------------------------
---------------------------------------------tt--------------------S2SS-S-------------------------------------------------------------------------------------------------------------------------------
---------------------------------------Tt----tt---------------------------------------------------------------------------------------------------------------------------------------------------------
---------------------------------------tt----tt------------------------%-------tt---Tt-----------------------#--#---------------------------------------------------------------------------------------
------------------------------------%%%%%%%%%%%%%%------------------r--|-------tt---tt---------------------%%%--%%%%%--%%-----------%%---%%-------------------------------------------------------------
------------------------------------||||||||||||||------------%%%%%%%%%%%%%%%%%%%%%%%%%%%------------------|||--|||||--||%%%%---%%%%||---||-------------------------------------------------------------
%%%%%%%%%%%--------%%%%---%%%%------||||||||||||||%%%%%--%%%%%|||||||||||||||||||||||||||%%%--%%%----------|||--|||||--||||||---||||||---||%%%%%%%%F%%%%%%%%%%%%%%%%%%%%%%%%%%%%%%%%%%%%%%%%%%%%%%%%%%%%
|||||||||||XXX--XXX||||---||||XX--XX|||||||||||||||||||--|||||||||||||||||||||||||||||||||||--|||XXXX--XXXX|||--|||||--||||||---||||||---||||||||||X||||||||||||||||||||||||||||||||||||||||||||||||||||
