HEIGHT=16;WIDTH=201;THEME=0;OVERRIDE=false
--------------------------------------------------------------------------------------------------------------------------------------------------------------------------------------------------------
--------------------------------------------------------------------------------------------------------------------------------------------------------------------------------------------------------
--------------------------------------------------------------------------------------------------------------------------------------------------------------------------------------------------------
--------------------------------------------------------------------------------------------------------------------------------------------------------------------------------------------------------
--------------------------------------------------------------------------------------------------------------------------------------------------------------------------------------------------------
--------------------------------------------------------------------------------------------------------------------------------------------------------------------------------------------------------
--------------------------------------------------------------------------------------------------------------------------------------------------------------------------------------------------------
------------------------------------------------------------------------------------------SSCS----------------------------------------------------------------------------------------------------------
--------------------------------------------------------------------------------------------------------------------------------------------------------------------------------------------------------
-----------------------------------------------------------------------------------------------------------------CSS2S----------------------------------------------------------------------------------
--------------------------------------------------------------------------------------------gy-----------------------------#---#------------------------------------------------------------------------
-------------------------U2S---------------------#---#------------------------------------%%%%%---------------------------##---##-----------------------------------------------------------------------
------------------------------------------------##---##-----------------------------------|||||---%%%%---%%%%------------###---###----------------------------------------------------------------------
%%%%%%%%%%---#---#---------------------#---#--%%%%---%%%%---------%%%---%%%-------------%%%||||---||||---||||%%%%%%%%%%%%%%%---%%%%%--------------------------------------------------------------------
||||||||||--##---##------------%%--%%%%%---%%%||||---||||%%%---%%%|||---|||-----------g-||||k||-r-||||---|||||||||||||||||||---|||||%%---%%%%%%%%%%F%%%%%%%%%%%%%%%%%%%%%%%%%%%%%%%%%%%%%%%%%%%%%%%%%%%%
||||||||||XXXX---XXXXXXXXXXXXXX||--|||||---|||||||---|||||||---||||||---|||XXXXXXXXXXXXXXXXXXXXXXX||||---|||||||||||||||||||---|||||||---||||||||||X||||||||||||||||||||||||||||||||||||||||||||||||||||
