HEIGHT=16;WIDTH=201;THEME=0;OVERRIDE=false
--------------------------------------------------------------------------------------------------------------------------------------------------------------------------------------------------------
--------------------------------------------------------------------------------------------------------------------------------------------------------------------------------------------------------
--------------------------------------------------------------------------------------------------------------------------------------------------------------------------------------------------------
--------------------------------------------------------------------------------------------------------------------------------------------------------------------------------------------------------
--------------------------------------------------------------------------------------------------------------------------------------------------------------------------------------------------------
--------------------------------------------------------------------------------------------------------------------------------------------------------------------------------------------------------
--------------------------------------------------------------------------------------------------------------------------------------------------------------------------------------------------------
--------------------------------------------------------------------------------------------------------------------------------------------------------------------------------------------------------
---------------CSSC-------------------------------------------------------------------------------------------------------------------------------------------------------------------------------------
------------------------------------#--#-------------------------------------------------------------SSUS2-------gk-------------------------------------------------------------------------------------
-----------------------------------##--##--------------------------------------------------------------------%%%%%%%------------------------------------------------------------------------------------
---------------r--------#---#-----###--###-----------tt---Tt-tt----------------------------------------------|r|rry|-k-------------r--------------------------------------------------------------------
-------------%%%%%%%%--##---##--%%%%%--%%%%%%%---%%--tt---tt-tt-%%%%%--%%%%%-------%%--%%---#---#--------g--%%%%%%%%%%%%%%--------%%%---%%%%%%%%F%%%%%%%%%%%%%%%%%%%%%%%%%%%%%%%%%%%%%%%%%%%%%%%%%%%%%%%
-------------||||||||%%%%---%%%%|||||--|||||||---||%%%%%%%%%%%%%|||||--|||||-------||--||--##---##--%%%%%%%%||||||||||||||----k---|||gK-||||||||%|||||||||||||||||||||||||||||||||||||||||||||||||||||||
-------------||||||||||||---|||||||||--|||||||---||||||||||||||||||||--|||||-------||--||%%%%---%%%%||||||||||||||||||||||%%%%%%%%%%%%%%||||||||||||||||||||||||||||||||||||||||||||||||||||||||||||||||
XXXXXXXXXXXXX||||||||||||---|||||||||--|||||||---||||||||||||||||||||--|||||XX---XX||--||||||---||||||||||||||||||||||||||||||||||||||||||||||||||||||||||||||||||||||||||||||||||||||||||||||||||||||||
