HEIGHT=16;WIDTH=201;THEME=0;OVERRIDE=false
--------------------------------------------------------------------------------------------------------------------------------------------------------------------------------------------------------
--------------------------------------------------------------------------------------------------------------------------------------------------------------------------------------------------------
--------------------------------------------------------------------------------------------------------------------------------------------------------------------------------------------------------
--------------------------------------------------------------------------------------------------------------------------------------------------------------------------------------------------------
--------------------------------------------------------------------------------------------------------------------------------------------------------------------------------------------------------
--------------------------------------------------------------------------------------------------------------------------------------------------------------------------------------------------------
--------------------------------------------------------------------------------------------------------------------------------------------------------------------------------------------------------
------------------------------------------------------------------------------------------------------------Y-------------------------------------------------------------------------------------------
------------------------------------------------------------------------------------------------------%%%%%%%-------------------------------------------------------------------------------------------
-----------------SSS----------------------------------------------------------------------2CS---------|||||||--------------------SC2--------------------------------------------------------------------
-------------------------------------------------------------------#---#------------------------------|||||||-------------------------------------------------------------------------------------------
------------------------------------------------------------------##---##-----------------------------|||||||-----------------------%-------------------------------------------------------------------
------------------------------%%%--%%%--#---#----------%%%---%%%%%%%---%%%%-------------------------%%%||||||----------%%%---%%%---G|g------------------------------------------------------------------
--------------%%%%%%%%%%%%--%%|||--|||%%%---%%%--------|||---|||||||---||||-%%%---------%%%%%%%%----|||k||||y----------|||---|||%%%%%%%%%---------------------------------------------------------------
--------------||||||||||||--|||||--||||||---|||%%%--%%%|||---|||||||---||||-|||-------r-||||||||%%%%%%%%%%%%%%%%%%--%%%|||---||||||||||||---------------------------------------------------------------
XXXXXXXXXXXXXX||||||||||||--|||||--||||||---||||||--||||||---|||||||---||||XXXXXXXXXXXXX||||||||||||||||||||||||||--||||||---||||||||||||XXXXXXXXFXXXXXXXXXXXXXXXXXXXXXXXXXXXXXXXXXXXXXXXXXXXXXXXXXXXXXX
