HEIGHT=16;WIDTH=201;THEME=0;OVERRIDE=false
--------------------------------------------------------------------------------------------------------------------------------------------------------------------------------------------------------
--------------------------------------------------------------------------------------------------------------------------------------------------------------------------------------------------------
--------------------------------------------------------------------------------------------------------------------------------------------------------------------------------------------------------
--------------------------------------------------------------------------------------------------------------------------------------------------------------------------------------------------------
--------------------------------------------------------------------------------------------------------------------------------------------------------------------------------------------------------
--------------------------------------------------------------------------------------------------------------------------------------------------------------------------------------------------------
--------------------------------------------------------------------------------------------------------------------------------------------------------------------------------------------------------
--------------------------------------------------------------------------------------------------------------------------------------------------------------------------------------------------------
--------------------------------------------------------------------------------------------------------------------------------------------------------------------------------------------------------
------------------------------------------------%%%-----------------------------------------------------------------------------------------------------------------------------------------------------
------------------------------------------------|||--------------------------------------------------------------------------------#---#----------------------------------------------------------------
------------------------#---#-------------------|||-----------------------------------------------------------SUSC2---------------##---##---------------------------------------------------------------
-----------------------##---##------------------|%%%%----------------------------%%%%%%%%--%%%----------------------------------%%%%---%%%%-------------------------------------------------------------
%%%%%%%%%%%%%%---%%%--###---###--%%%%%--%%%%%---|||||---------%%---%%------%%%---||||||||--|||%%%%------------------------------||||---||||-------------------------------------------------------------
||||||||||||||---|||%%%%%---%%%%%|||||--|||||-y-r||||---------||---||--y---|||---||||||||--|||||||------------------------------||||---||||%%%%%%%%F%%%%%%%%%%%%%%%%%%%%%%%%%%%%%%%%%%%%%%%%%%%%%%%%%%%%
||||||||||||||---||||||||---||||||||||--|||||XXXXXXXXXXXXXXXXX||---||XXXXXXXXXXXX||||||||--|||||||XXXX---XXXXXXXXXXXXXXXX--XXXXX||||---||||||||||||X||||||||||||||||||||||||||||||||||||||||||||||||||||
