HEIGHT=16;WIDTH=201;THEME=0;OVERRIDE=false
--------------------------------------------------------------------------------------------------------------------------------------------------------------------------------------------------------
--------------------------------------------------------------------------------------------------------------------------------------------------------------------------------------------------------
--------------------------------------------------------------------------------------------------------------------------------------------------------------------------------------------------------
--------------------------------------------------------------------------------------------------------------------------------------------------------------------------------------------------------
--------------------------------------------------------------------------------------------------------------------------------------------------------------------------------------------------------
--------------------------------------------------------------------------------------------------------------------------------------------------------------------------------------------------------
--------------------------------------------------------------------------------------------------------------------------------------------------------------------------------------------------------
--------------------------------------------------------------------------------------------------------------------------------------------------------------------------------------------------------
--------------------------------------------------------------------------------------------------------------------------------------------------------------------------------------------------------
------------------------------------------------------------------------%%%%%-------2SSS22--------------------------------------------------------------------------------------------------------------
-----------------------------#---#-------#---#------------------SS-C----|||||---------------------------------------------------------------------------------------------------------------------------
----------------------------##---##-----##---##-------------------------|||||---------------------------------------------------------------------------------------------------------------------------
---------------------------###---###--%%%%---%%%%-----------------%----%%%%%%%%%%%%---k--y------------%%%%%%%%------------------------------------------------------------------------------------------
-------------------------%%%%%---%%%%%||||---||||%%--%%-----------|----||||||||||||%%%%%%%%%%%--------||||||||-----------------%%%%---%%%%%%%%%%%%F%%%%%%%%%%%%%%%%%%%%%%%%%%%%%%%%%%%%%%%%%%%%%%%%%%%%%
------------%%%%%---%%%%%|||||---|||||||||---||||||--||%%---%%%%%%%%%%%|||||||||||||||||||||||--------||||||||-----------------||||---||||||||||||%|||||||||||||||||||||||||||||||||||||||||||||||||||||
XXXXXXXXXXXX|||||---||||||||||---|||||||||---||||||--||||---||||||||||||||||||||||||||||||||||XXX--XXX||||||||XX---XXXXXX--XXXX||||---||||||||||||||||||||||||||||||||||||||||||||||||||||||||||||||||||
