HEIGHT=16;WIDTH=201;THEME=0;OVERRIDE=false
--------------------------------------------------------------------------------------------------------------------------------------------------------------------------------------------------------
--------------------------------------------------------------------------------------------------------------------------------------------------------------------------------------------------------
--------------------------------------------------------------------------------------------------------------------------------------------------------------------------------------------------------
--------------------------------------------------------------------------------------------------------------------------------------------------------------------------------------------------------
--------------------------------------------------------------------------------------------------------------------------------------------------------------------------------------------------------
--------------------------------------------------------------%%%%%%------------------------------------------------------------------------------------------------------------------------------------
--------------------------------------------------------------||||||------------------------------------------------------------------------------------------------------------------------------------
-------------------------%%%%%--------------------------------||||||------------------------------------------------------------------------------------------------------------------------------------
------------------------g|||||--------------------------------||||||------------------------------------------------------------------------------------------------------------------------------------
-----------%%%%%%%-----%%%%%%|--------------------------------|||%%%%%%---------Y-----------------------------------------------------------------------------------------------------------------------
-----------|||||||-----|||||||--------------------------------|||||||||-----%%%%%%----------SSS---------------------------------------------------------------------------------------------------------
-----------|||||%%%%---|||||||--------------------------------gy||||g||-----||||||----------------------------------------------------------------------------------------------------------------------
-----------|||||||||---|||||||------------------------------%%%%%%%%%%%%%-G-||||||----y----------------------------#---#-------------%%%%%--%%%%%-------------------------------------------------------
-----------|||||||||--%%%%%%%%%%%%%%%%%%%%%%%%%%%%%---------|||||||||||||%%%%%%%%%%%%%%%%%--------%%%%%%%%%%--%%%%%%---%%%-----------|||||--|||||-------------------------------------------------------
-----------||k||||||--|||||||||||||||||||||||||||||%%%---%%%||||||||||||||||||||||||||||||%%%%%%%%||||||||||--||||||---|||%%%%---%%%%|||||--|||||%%%%%%%%F%%%%%%%%%%%%%%%%%%%%%%%%%%%%%%%%%%%%%%%%%%%%%%
XXXXXXXXXXXXXXXXXXXXXX||||||||||||||||||||||||||||||||---|||||||||||||||||||||||||||||||||||||||||||||||||||--||||||---|||||||---|||||||||--|||||||||||||X||||||||||||||||||||||||||||||||||||||||||||||
