HEIGHT=16;WIDTH=201;THEME=0;OVERRIDE=false
--------------------------------------------------------------------------------------------------------------------------------------------------------------------------------------------------------
--------------------------------------------------------------------------------------------------------------------------------------------------------------------------------------------------------
--------------------------------------------------------------------------------------------------------------------------------------------------------------------------------------------------------
--------------------------------------------------------------------------------------------------------------------------------------------------------------------------------------------------------
--------------------------------------------------------------------------------------------------------------------------------------------------------------------------------------------------------
--------------------------------------------------------------------------------------------------------------------------------------------------------------------------------------------------------
--------------------------------------------------------------------------------------------------------------------------------------------------------------------------------------------------------
--------------------------------------------------------------------------------------------------------------------------------------------------------------------------------------------------------
--------------------------------------------------------------------------------------------------------------------------------------------------------------------------------------------------------
--------------------------------------------------------------------------------------------------------------------------------------------------------------------------------------------------------
-------------------------------------------------------------------#---#--------------#---#-------------------------------------------------------------------------------------------------------------
------------------------------------------------------------------##---##------------##---##-----%%%%%%%------------------------------------------------------------------------------------------------
------------%%%%%%%%%%%%%--%%%%%----------%%%%---%%%%%%%%%%--%%--###---###----------###---###----|||||||------------------------------------------------------------------------------------------------
------------|||||||||||||--|||||----------||||---||||||||||--||%%%%%---%%%%%------%%%%%---%%%%%--|||||||------------#---#-------------------------------------------------------------------------------
------------|||||||||||||--|||||----------||||---||||||||||--|||||||---|||||------|||||---|||||--|||||||----------%%%---%%%-----------------------------------------------------------------------------
XXXXXXXXXXXX|||||||||||||--|||||XXXXXXXXXX||||---||||||||||--|||||||---|||||XXXXXX|||||---|||||XXXXXXXXXXXXXXXXXXX|||---|||XXXXXXX--XXXX--XXXXXXXXXXFXXXXXXXXXXXXXXXXXXXXXXXXXXXXXXXXXXXXXXXXXXXXXXXXXXX
