HEIGHT=16;WIDTH=201;THEME=0;OVERRIDE=false
--------------------------------------------------------------------------------------------------------------------------------------------------------------------------------------------------------
--------------------------------------------------------------------------------------------------------------------------------------------------------------------------------------------------------
--------------------------------------------------------------------------------------------------------------------------------------------------------------------------------------------------------
---------------y---g------------------------------------------------------------------------------------------------------------------------------------------------------------------------------------
---------------%%%%%%%----------------------------------------------------------------------------------------------------------------------------------------------------------------------------------
---------------|||||||----------------------------------------------------------------------------------------------------------------------------------------------------------------------------------
---------------|||||||-g--------------------------------------------------------------------------------------------------------------------------------------------------------------------------------
---------------||||%%%%%--------------------------------------------------------------------------------------------------------------------------------------------------------------------------------
--------------r|||||||||--------------------------------------------------------------------------------------------------------------------------------------------------------------------------------
-------------%%%||||||||--------SSU---------------------------------------------------------------------g--------------#--#-----------------------------------------------------------------------------
-------------|||||||||||----------------------------#---#--------------------------------------------%%%%%------------##--##----------------------------------------------------------------------------
-------------|||||||||||---------------------------##---##-------------------------------------------|||||-----------###--###---------------------------------------------------------------------------
-----------%%%%%%%%%%%%%%%%%%%----g------#---#----###---###--%%%%%---%%%%%------------------------k--|||||g--------%%%%%--%%%%%-------------------------------------------------------------------------
-----------|||||||||||||||||||%%%%%%%%%%%%---%%%%%%%%---%%%%%|||||---|||||-----------------%%%%%%%%%%%%%%%%%%%%%%%%|||||--|||||-------------------------------------------------------------------------
-----------|||||||||||||||||||||||||||||||---||||||||---||||||||||---|||||%%%---%%%%%%--%%%|||||||||||||||||||||||||||||--|||||-------------------------------------------------------------------------
XXXXXXXXXXX|||||||||||||||||||||||||||||||---||||||||---||||||||||---||||||||---||||||--||||||||||||||||||||||||||||||||--|||||XXXX---XXXXXXXXXXXXFXXXXXXXXXXXXXXXXXXXXXXXXXXXXXXXXXXXXXXXXXXXXXXXXXXXXX
