HEIGHT=16;WIDTH=201;THEME=0;OVERRIDE=false
--------------------------------------------------------------------------------------------------------------------------------------------------------------------------------------------------------
--------------------------------------------------------------------------------------------------------------------------------------------------------------------------------------------------------
--------------------------------------------------------------------------------------------------------------------------------------------------------------------------------------------------------
--------------------------------------------------------------------------------------------------------------------------------------------------------------------------------------------------------
--------------------------------------------------------------------------------------------------------------------------------------------------------------------------------------------------------
--------------------------------------------------------------------------------------------------------------------------------------------------------------------------------------------------------
--------------------------------------------------------------------------------------------------------------------------------------------------------------------------------------------------------
-------------------------------------------------------------------------2SSSS--------------------------------------------------------------------------------------------------------------------------
--------------------------------------------------------------------------------------------------------------------------------------------------------------------------------------------------------
--------------------------------------------------------------------------------------------------------------------------------------------------------------------------------------------------------
-------------------------------------------------------------------------y--k---------------------------------------------------------------------------------------------------------------------------
--------------SSSS-----------------------------------------------------%%%%%%%--------------------------------------------------------------------------------------------------------------------------
------------------------------------------------%%%--%%%%%--%%---------|||||||-------------------%%%---%%%----------------K-%%--%%----------------------------------------------------------------------
--------------------%%---%%---------------------|||--|||||--||--#--#---|||||||---------%%%-------|||---|||----------%%%%%%%%||--||%%%%%---%%%%%%%%%%%%%F%%%%%%%%%%%%%%%%%%%%%%%%%%%%%%%%%%%%%%%%%%%%%%%%
%%%%%%%%%%--r-------||---||%%---%%%%---%%%%%%%%%|||--|||||--||%%%--%%%%%%%%%%%%%-------|||-g-----|||---|||%%%%%%--%%||||||||||--|||||||---|||||||||||||%||||||||||||||||||||||||||||||||||||||||||||||||
||||||||||XXXXXXXXXX||---||||---||||---||||||||||||--|||||--|||||--|||||||||||||XXXXXXXXXXXXXXXXX|||---|||||||||--||||||||||||--|||||||---||||||||||||||||||||||||||||||||||||||||||||||||||||||||||||||
