HEIGHT=16;WIDTH=201;THEME=0;OVERRIDE=false
--------------------------------------------------------------------------------------------------------------------------------------------------------------------------------------------------------
--------------------------------------------------------------------------------------------------------------------------------------------------------------------------------------------------------
--------------------------------------------------------------------------------------------------------------------------------------------------------------------------------------------------------
--------------------------------------------------------------------------------------------------------------------------------------------------------------------------------------------------------
--------------------------------------------------------------------------------------------------------------------------------------------------------------------------------------------------------
--------------------------------------------------------------------------------------------------------------------------------------------------------------------------------------------------------
----------------------------------------------------------------------------------------------------------------------------------y---------------------------------------------------------------------
-------------------------r----------------------------------------------------------------------------------------------------%%%%%%%-------------------------------------------------------------------
---------------------%%%%%%%--------------------------------------------------------------------------------------------------|||||||-------------------------------------------------------------------
---------------------|||||||--------------------------------------------------------------------------------------------------|||||||-------------------------------------------------------------------
---------------------|||||||------------------------------------------------------------------------------------r-------------|||%%%|-------------------------------------------------------------------
---------------------|||||||----------------tt-----------------2-CCCSS-------------------------------------%%%%%%-------------||||y||-------------------------------------------------------------------
---------------------|||||||---%%%-------tt-tt-------------------------------------------------------------||||||------------%%%%%%%%%%--------%%%%%%%%F%%%%%%%%%%%%%%%%%%%%%%%%%%%%%%%%%%%%%%%%%%%%%%%%
-------------%%--%%--|||||||g--|||k------tt-tt---------%%--%%---%------------------------------------------||||||g-------r---||||||||||%%%%%%%%||||||||%||||||||||||||||||||||||||||||||||||||||||||||||
-------------||--||%%%%%%%%%%%%%%%%%%%%%%%%%%%%%-------||--||-g-|----k-%%---%%-----------%%---%%---------%%%%%%%%%%%%%%%%%%--|||||||||||||||||||||||||||||||||||||||||||||||||||||||||||||||||||||||||||
XXXXXXXXXXXXX||--|||||||||||||||||||||||||||||||XX---XX||--||XXXXXXXXXX||---||XXXXXXXXXXX||---||XXX---XXX||||||||||||||||||XX|||||||||||||||||||||||||||||||||||||||||||||||||||||||||||||||||||||||||||
