HEIGHT=16;WIDTH=201;THEME=0;OVERRIDE=false
--------------------------------------------------------------------------------------------------------------------------------------------------------------------------------------------------------
--------------------------------------------------------------------------------------------------------------------------------------------------------------------------------------------------------
--------------------------------------------------------------------------------------------------------------------------------------------------------------------------------------------------------
--------------------------------------------------------------------------------------------------------------------------------------------------------------------------------------------------------
--------------------------------------------------------------------------------------------------------------------------------------------------------------------------------------------------------
--------------------------------------------------------------------------------------------------------------------------------------------------------------------------------------------------------
--------------------------------------------------------------------------------------------------------------------------------------------------------------------------------------------------------
--------------------------------------------------------------------------------------------------------------------------------------------------------------------------------------------------------
--------------------------------------------------------------------------------------------------------------------------------------------------------------------------------------------------------
--------------------------------------------------------------------------------------------------------------------------------------------------------------------------------------------------------
---------------------------------------------------------------------------------------------%%%----S-CSCCCC--------------------------------------------------------------------------------------------
----------------%%%-----------------------------------------------#---#----------------------|||--------------------------------------------------------------------------------------------------------
----------------|||--------------%%---%%---------------%%%---%%%%%%---%%%--------------------|||-----%--------%%--%%%%%%---%%%%-------%%%%%--%%%%%%%%%%%%%F%%%%%%%%%%%%%%%%%%%%%%%%%%%%%%%%%%%%%%%%%%%%%
%%%%%%%%%%%%%%--|||--------------||---||---------------|||---||||||---|||---#--#---------r---|||-----|--------||--||||||---||||%%%%%%%|||||--|||||||||||||%|||||||||||||||||||||||||||||||||||||||||||||
||||||||||||||--|rky--r----------||---||---------------|||---||||||---|||--##--##--%%%%%%%%%%%%%%%%%%%%%%%%%%%||--||||||---||||||||||||||||--|||||||||||||||||||||||||||||||||||||||||||||||||||||||||||
||||||||||||||XXXXXXXXXXXXXXXXXXX||---||XXXXXXXXXX---XX|||---||||||---|||XXXX--XXXX|||||||||||||||||||||||||||||--||||||---||||||||||||||||--|||||||||||||||||||||||||||||||||||||||||||||||||||||||||||
