HEIGHT=16;WIDTH=201;THEME=0;OVERRIDE=false
--------------------------------------------------------------------------------------------------------------------------------------------------------------------------------------------------------
--------------------------------------------------------------------------------------------------------------------------------------------------------------------------------------------------------
--------------------------------------------------------------------------------------------------------------------------------------------------------------------------------------------------------
--------------------------------------------------------------------------------------------------------------------------------------------------------------------------------------------------------
--------------------------------------------------------------------------------------------------------------------------------------------------------------------------------------------------------
--------------------------------------------------------------------------------------------------------------------------------------------------------------------------------------------------------
--------------------------------------------------------------------------------------------------------------------------------------------------------------------------------------------------------
--------------------------------------------------------------------------------------------------------------------------------------------------------------------------------------------------------
----------------------------------------------------------------------------------------------------------------%%%%%-----------------------------------------------------------------------------------
-----------------------------%%%--------------------------------tt----------------------------------------------|||||-----------------------------------------------------------------------------------
-----------------------------|||--------------------------------tt----------------------------------------------|||||-----------------------------------------------------------------------------------
-------------2SSC2--%%%%%%%--|||--------------------------------tt--------------Tt---------------%%%------------|y|||-----------------------------------------------------------------------------------
--------------------|||||||--|||---------------------%%%%---%%%%%%%%------------tt-tt------------|||--------%%%%%%%%%%%%%%%%%--%%%%%--------------------------------------------------------------------
%%%%%%%%%%----------|||||||--|||--------------%%---%%||||%%%||||||||------------tt-tt------------|||--------|||||||||||||||||--|||||------%%%%%%%%F%%%%%%%%%%%%%%%%%%%%%%%%%%%%%%%%%%%%%%%%%%%%%%%%%%%%%
||||||||||--r-------g|r||||--|||--------------||---|||||||||||||||||%%%%--%%%%%%%%%%%%%%%%%------|||------y-|||||||||||||||||--|||||%%--%%||||||||%|||||||||||||||||||||||||||||||||||||||||||||||||||||
||||||||||XXXXXXXXXXXXXXXXXXXXXXXXXXXXXX--XXXX||---|||||||||||||||||||||--|||||||||||||||||XXXXXXXXXXXXXXXXX|||||||||||||||||--|||||||--||||||||||||||||||||||||||||||||||||||||||||||||||||||||||||||||
