HEIGHT=16;WIDTH=201;THEME=0;OVERRIDE=false
--------------------------------------------------------------------------------------------------------------------------------------------------------------------------------------------------------
--------------------------------------------------------------------------------------------------------------------------------------------------------------------------------------------------------
--------------------------------------------------------------------------------------------------------------------------------------------------------------------------------------------------------
--------------------------------------------------------------------------------------------------------------------------------------------------------------------------------------------------------
--------------------------------------------------------------------------------------------------------------------------------------------------------------------------------------------------------
--------------------------------------------------------------------------------------------------------------------------------------------------------------------------------------------------------
--------------------------------------------------------------------------------------------------------------------------------------------------------------------------------------------------------
--------------------------------------------------------------------------------------------------------------------------------------------------------------------------------------------------------
--------------------------------------------------------------------------------------------------------------------------------------------------------------------------------------------------------
--------------------------------------------------------------------------------------------------------------------------------------------------------------------------------------------------------
--------------------------------------------------------------------------------------------------------------------------------------------------------------------------------------------------------
------------------------------------------------gg--------------------------------------------------#--#-----22S----------------------------------------------------------------------------------------
%%%%%%%%%%%%%%%---%%-------------------------%%%%%-----%%%%%-----------------------%%%%%%%---------##--##----------%%%%%---%%----#--#----%%%%%%%%F%%%%%%%%%%%%%%%%%%%%%%%%%%%%%%%%%%%%%%%%%%%%%%%%%%%%%%
|||||||||||||||---||%%%%%--%%%%%-------------|||||-----|||||----------%%%%--%%%%%%%|||||||%%---%%%%%%--%%%%--------|||||---||---##--##---||||||||%||||||||||||||||||||||||||||||||||||||||||||||||||||||
|||||||||||||||---|||||||--|||||------%%--%%-|||||---y-|||||----------||||--||||||||||||||||---||||||--||||-----k--|||||---||--###--###--|||||||||||||||||||||||||||||||||||||||||||||||||||||||||||||||
|||||||||||||||---|||||||--|||||XX--XX||--||XXXXXXXXXXX|||||XXXX--XXXX||||--||||||||||||||||---||||||--||||XXXXXXXX|||||---||XXXXX--XXXXX|||||||||||||||||||||||||||||||||||||||||||||||||||||||||||||||
