HEIGHT=16;WIDTH=201;THEME=0;OVERRIDE=false
--------------------------------------------------------------------------------------------------------------------------------------------------------------------------------------------------------
--------------------------------------------------------------------------------------------------------------------------------------------------------------------------------------------------------
--------------------------------------------------------------------------------------------------------------------------------------------------------------------------------------------------------
--------------------------------------------------------------------------------------------------------------------------------------------------------------------------------------------------------
----------------------------------------SSS-------------------------------------------------------------------------------------------------------------------------------------------------------------
--------------------------------------------------------------------------------------------------------------------------------------------------------------------------------------------------------
--------------------------------------------------------------------------------------------------------------------------------------------------------------------------------------------------------
--------------------------------------------------------------------------------------------------------------------------------------------------------------------------------------------------------
-------------------------------------%%%%%%----------U22C------------------------------------------------2SSS-S-----------------------------------------------------------------------------------------
------------------------------------k||||||-------------------------------------------------------------------------------------------------------------------------------------------------------------
-----------------------------------%%%|||||--------------%---------------------------------------------------%------------------------------------------------------------------------------------------
-----------------------------------||||||||---------r----|---------------------------------------------------|-----------SSU----------------------------------------------------------------------------
%%%%%%%%%%--------%%--%%%%---%%----||||||||-------%%%%%%%%%%%--%%---------------Tt----------------------%%%%%%%%----------------------------------------------------------------------------------------
||||||||||--------||--||||---||%%%%%%%%%%%%%%%%%%%|||||||||||--||---------------tt----------------------||||||||---------------%%--%%-------%%%%%%%%F%%%%%%%%%%%%%%%%%%%%%%%%%%%%%%%%%%%%%%%%%%%%%%%%%%%
||||||||||--------||--||||---||||||||||||||||||||||||||||||||--||%%--%%%%---%%%%%%%%%%%-------%%%%--%%%%||||||||---------------||--||-------||||||||%|||||||||||||||||||||||||||||||||||||||||||||||||||
||||||||||XXX--XXX||--||||---||||||||||||||||||||||||||||||||--||||--||||---|||||||||||XX---XX||||--||||||||||||XX--XXXXXXXXXXX||--||XXXXXXX||||||||||||||||||||||||||||||||||||||||||||||||||||||||||||
