HEIGHT=16;WIDTH=201;THEME=0;OVERRIDE=false
--------------------------------------------------------------------------------------------------------------------------------------------------------------------------------------------------------
--------------------------------------------------------------------------------------------------------------------------------------------------------------------------------------------------------
--------------------------------------------------------------------------------------------------------------------------------------------------------------------------------------------------------
--------------------------------------------------------------------------------------------------------------------------------------------------------------------------------------------------------
--------------------------------------------------------------------------------------------------------------------------------------------------------------------------------------------------------
--------------------------------------------------------------------------------------------------------------------------------------------------------------------------------------------------------
--------------------------------------------------------------------------------------------------------------------------------------------------------------------------------------------------------
--------------------------------------------------------------------------------------------------------------------------------------------------------------------------------------------------------
--------------------------------------------------------------------------------------------------------------------------------%%%%%%------------------------------------------------------------------
-------------------------------CCSSCSS---U-C2USS--------------------------------------------------------------------------------||||||------------------------------------------------------------------
---------------------2CCSCSS-----------------------------------------tt---------------------------------------------%%%%%%------||||||------------------------------------------------------------------
------------------------------------------%----------------------Tt--tt--------------------------------SCS----------||||||----%%%%%%%|------------------------------------------------------------------
------------------------------------------|--y-------------------tt--tt------------%%%--%%%--#--#-------------------||||||----||||||||------------------------------------------------------------------
--------------------k--------%%%%%%%%%%%%%%%%%%%%%------%%%--%%%%%%%%%%%%%%--#--#--|||--|||%%%--%%%--------%%%%%%%%%%%%%%%%%--||||||||------------------------------------------------------------------
-------------------%%%%%%%%%%|||||||||||||||||||||%%--%%|||--||||||||||||||%%%--%%%|||--||||||--|||--------|||||||||||||||||--y||||||k------------------------------------------------------------------
XXXXXXXXXXXXXXXXXXX|||||||||||||||||||||||||||||||||--|||||--|||||||||||||||||--||||||--||||||--|||XXXXXXXX|||||||||||||||||XXXXXXXXXXXXXXXXXXXXFXXXXXXXXXXXXXXXXXXXXXXXXXXXXXXXXXXXXXXXXXXXXXXXXXXXXXXX
