HEIGHT=16;WIDTH=201;THEME=0;OVERRIDE=false
--------------------------------------------------------------------------------------------------------------------------------------------------------------------------------------------------------
--------------------------------------------------------------------------------------------------------------------------------------------------------------------------------------------------------
--------------------------------------------------------------------------------------------------------------------------------------------------------------------------------------------------------
--------------------------------------------------------------------------------------------------------------------------------------------------------------------------------------------------------
--------------------------------------------------------------------------------------------------------------------------------------------------------------------------------------------------------
--------------------------------------------------------------------------------------------------------------------------------------------------------------------------------------------------------
--------------------------------------------------------------------------------------------------------------------------------------------------------------------------------------------------------
---------------------------------------------------------------------------------------------------CUSSS2-----------------------------------------------------------------------------------------------
--------------------------------------------------------------------------------------------------------------------------------------------------------------------------------------------------------
------------------------------------------------------------------------------------------------------------SSS-----------------------------------------------------------------------------------------
--------------------------------SSSC2-------------------------------------------------------------y---g-------------------------------------------------------------------------------------------------
---------------SCC----------------------CS2CS2----------------------------------------------------%%%%%%%-----------------------------------------------------------------------------------------------
--------------------------------------------------tt----tt---------------------------%%%--%%%-----|||||||------------#---#------------------------------------------------------------------------------
%%%%%%%%%%%%%-%-----------------------------------tt----tt---------------------------|||--|||----g|||||||--%%%%%%%%%%%---%%%%%%%%--%%%%%%%%%%%%%F%%%%%%%%%%%%%%%%%%%%%%%%%%%%%%%%%%%%%%%%%%%%%%%%%%%%%%%
|||||||||||||-|------%%%%--%%%%%%%%%%%------------tt----tt---------------------------|||--|||%%%%%%%%%%%%%%|||||||||||---||||||||--|||||||||||||%|||||||||||||||||||||||||||||||||||||||||||||||||||||||
|||||||||||||XXXXXXXX||||--|||||||||||XXXXXXXXXXXXXXXXXXXXXXXXXX--XXXX--XXXXXX---XXXX|||--||||||||||||||||||||||||||||---||||||||--|||||||||||||||||||||||||||||||||||||||||||||||||||||||||||||||||||||
