HEIGHT=16;WIDTH=201;THEME=0;OVERRIDE=false
--------------------------------------------------------------------------------------------------------------------------------------------------------------------------------------------------------
--------------------------------------------------------------------------------------------------------------------------------------------------------------------------------------------------------
--------------------------------------------------------------------------------------------------------------------------------------------------------------------------------------------------------
--------------------------------------------------------------------------------------------------------------------------------------------------------------------------------------------------------
--------------------------------------------------------------------------------------------------------------------------------------------------------------------------------------------------------
--------------------------------------------------------------------------------------------------------------------------------------------------------------------------------------------------------
--------------------------------------------------------------------------------------------------------------------------------------------------------------------------------------------------------
--------------------------------------------------------------------------------------------------------------------------------------------------------------------------------------------------------
----------------------------------------------------------------------------------------------------------2UCS2S----------------------------------------------------------------------------------------
-------------r------------------------------------------------------------------------------------------------------------------------------------------------------------------------------------------
-------------%%%%%%--------------------------------------------------------------------------------------%----------------------------------------------------------------------------------------------
-------------||||||--------------------------------------------------------------------------------------|----Gy-----------------------#--#-------------------------------------------------------------
%%%%%%%%%%%%-||||||-------------------------------------------------%%%--------------#---#------------%%%%%%%%%%%---------------------##--##------------------------------------------------------------
||||||||||||-||||||-----y-----------%%%%---%%%%---------------------|||k--%%---%%---##---##-----------|||||||||||-------%%%%---%%%%--###--###-----------------------------------------------------------
||||||||||||%%%%%%%%%%%%%%%%%-------||||---||||%%%%%---%%%%%%%%%%%%%%%%%%%||---||--###---###----------|||||||||||%%---%%||||---||||%%%%%--%%%%%%%%%%%%%F%%%%%%%%%%%%%%%%%%%%%%%%%%%%%%%%%%%%%%%%%%%%%%%%
|||||||||||||||||||||||||||||XXXXXXX||||---|||||||||---|||||||||||||||||||||---||XXXXX---XXXXXXXX--XXX|||||||||||||---||||||---|||||||||--|||||||||||||X||||||||||||||||||||||||||||||||||||||||||||||||
