HEIGHT=16;WIDTH=201;THEME=0;OVERRIDE=false
--------------------------------------------------------------------------------------------------------------------------------------------------------------------------------------------------------
--------------------------------------------------------------------------------------------------------------------------------------------------------------------------------------------------------
--------------------------------------------------------------------------------------------------------------------------------------------------------------------------------------------------------
--------------------------------------------------------------------------------------------------------------------------------------------------------------------------------------------------------
--------------------------------------------------------------------------------------------------------------------------------------------------------------------------------------------------------
--------------------------------------------------------------------------------------------------------------------------------------------------------------------------------------------------------
--------------------------------------------------------------------------------------------------------------------------------------------------------------------------------------------------------
--------------------------------------------------------------------------------------------------------------------------------------------------------------------------------------------------------
--------------------------------------------------------------------------------------------------C-SS--------------------------------------------------------------------------------------------------
--------------------------------------------------------------------------------------------------------------#--#--------------------------------------------------------------------------------------
-----------------------------------------#---#-----------------------------------------------------%---------##--##-------#--#--------------------------------------------------------------------------
----------------------------------------##---##----------------------------------------------------|--------###--###-----##--##-------------------------------------------------------------------------
---------------------------------------###---###-------------------------------%%%%%%%%%%%---%%%%%%%%%%%%%%%%%%--%%%%%--###--###------------------------------------------------------------------------
-------------#--#--------------------%%%%%---%%%%%---------------%%%%%%%-------|||||||||||---||||||||||||||||||--|||||%%%%%--%%%%%%%%%%---%%%%%---------------------------------------------------------
------------##--##--%%%%---%%%%%%--%%|||||---|||||%%%%%---%%%%%--|||||||-------|||||||||||---||||||||||||||||||--||||||||||--||||||||||---|||||%%%%%%%%F%%%%%%%%%%%%%%%%%%%%%%%%%%%%%%%%%%%%%%%%%%%%%%%%
XXXXXXXXXXXXXX--XXXX||||---||||||--|||||||---||||||||||---|||||XXXXXXXXXXXXXXXX|||||||||||---||||||||||||||||||--||||||||||--||||||||||---|||||||||||||X||||||||||||||||||||||||||||||||||||||||||||||||
