HEIGHT=16;WIDTH=201;THEME=0;OVERRIDE=false
--------------------------------------------------------------------------------------------------------------------------------------------------------------------------------------------------------
--------------------------------------------------------------------------------------------------------------------------------------------------------------------------------------------------------
--------------------------------------------------------------------------------------------------------------------------------------------------------------------------------------------------------
--------------------------------------------------------------------------------------------------------------------------------------------------------------------------------------------------------
--------------------------------------------------------------------------------------------------------------------------------------------------------------------------------------------------------
--------------------------------------------------------------------------------------------------------------------------------------------------------------------------------------------------------
--------------------------------------------------------------------------------------------------------------------------------------------------------------------------------------------------------
-----------------------------------------------------------------------------------------------------%%%%%----------------------------------------------------------------------------------------------
-----------------------------------------------------------SCS---------------------------------------|||||----------------------------------------------------------------------------------------------
-------------------------------------------------------------------------------------------CCSCSSS---|||||----------------------------------------------------------------------------------------------
--------------------------------------------------S2-US2S-------------------Tt-----------------------|K|||----------------------------------------------------------------------------------------------
----------------------------------------------------------------------------tt-----------------------|%%%%%%%-------------------------------------------------------------------------------------------
------------%%%%--%%%%------------------------------%-----%%%%%%%%----------tt------------y--r---K---k|||||||-k-----------------------------------------------------------------------------------------
------------||||--||||-------%%---%%----------------|-----||||||||-------%%%%%%%%--------%%%%%%%%%%%%%%%%%%%%%%%%---------------------------------------------------------------------------------------
------------||||--||||%%---%%||---||%%%%%%%%%%%%%%%%%%%%%%||||||||-------||||||||%%%--%%%||||||||||||||||||||||||%%%%%---%%%%%-g-------%%%--%%%%%%%%%%%F%%%%%%%%%%%%%%%%%%%%%%%%%%%%%%%%%%%%%%%%%%%%%%%%
XXXXXXXXXXXX||||--||||||---||||---||||||||||||||||||||||||||||||||XX---XX|||||||||||--||||||||||||||||||||||||||||||||---|||||XXXXXXXXX|||--|||||||||||X||||||||||||||||||||||||||||||||||||||||||||||||
