HEIGHT=16;WIDTH=201;THEME=0;OVERRIDE=false
--------------------------------------------------------------------------------------------------------------------------------------------------------------------------------------------------------
--------------------------------------------------------------------------------------------------------------------------------------------------------------------------------------------------------
--------------------------------------------------------------------------------------------------------------------------------------------------------------------------------------------------------
--------------------------------------------------------------------------------------------------------------------------------------------------------------------------------------------------------
--------------------------------------------------------------------------------------------------------------------------------------------------------------------------------------------------------
--------------------------------------------------------------------------------------------------------------------------------------------------------------------------------------------------------
--------------------------------------------------------------------------------------------------------------------------------------------------------------------------------------------------------
--------------------------------------------------------------------------------------------------------------------------------------------------------------------------------------------------------
--------------------------------------------------------------------------------------------------------------------------------------------------------------------------------------------------------
-------------------------------------SSS----------------------------------------------------------------------------------------------------------------------------------------------------------------
-------------------------------------------SSSC---------------------------------------------------------------------------------------------------------------------------------------------------------
------------------------------------------------------------------------------------------------------#---#---------------------------------------------------------------------------------------------
---------------------------#---#---------------%-%%%%--%%%%%%%%%%-----------------------------------%%%---%%%%%%%---%%%%%%%%%---%%%%%----------%%%%%%%%F%%%%%%%%%%%%%%%%%%%%%%%%%%%%%%%%%%%%%%%%%%%%%%%%
--------------------------##---##--%%%%%%------|-||||--||||||||||-------------%%%%--%%%%------------|||---|||||||---|||||||||---|||||----------||||||||%||||||||||||||||||||||||||||||||||||||||||||||||
------------------------%%%%---%%%%||||||%%%%%%%%||||--||||||||||%%%%%---%%%%%||||--||||------------|||---|||||||---|||||||||---|||||----------|||||||||||||||||||||||||||||||||||||||||||||||||||||||||
XXXXXXXXXXXXXXXXX---XXXX||||---||||||||||||||||||||||--|||||||||||||||---|||||||||--||||XXXXX--XXXXX|||---|||||||---|||||||||---|||||XXXX--XXXX|||||||||||||||||||||||||||||||||||||||||||||||||||||||||
