HEIGHT=16;WIDTH=201;THEME=0;OVERRIDE=false
--------------------------------------------------------------------------------------------------------------------------------------------------------------------------------------------------------
--------------------------------------------------------------------------------------------------------------------------------------------------------------------------------------------------------
--------------------------------------------------------------------------------------------------------------------------------------------------------------------------------------------------------
--------------------------------------------------------------------------------------------------------------------------------------------------------------------------------------------------------
--------------------------------------------------------------------------------------------------------------------------------------------------------------------------------------------------------
--------------------------------------------------------------------------------------------------------------------------------------------------------------------------------------------------------
--------------------------------------------------------------------------------------------------------------------------------------------------------------------------------------------------------
----------------------------------------------------------------------------------------------------y-----------------------------------------%%%%%%----------------------------------------------------
-------------------------------------------------------------------------------------------------%%%%-----------------------------------------||||||----------------------------------------------------
-------------------------C2SSCSS--------------------------------------------------USS------------||||-----------------------CCSSCSS--------r--||||||----------------------------------------------------
-------------------------------------------------------------------------------------------------||||--------------------------------------%%%%%%|||----------------------------------------------------
-------------tt-----------------------------------------------------------------------------%%%%%%%||----------------SS22------------------|||||||||----------------------------------------------------
-------------tt---------r--------------------------------------------------------------r----||y||||||--------------------------------------|||||||||----------------------------------------------------
%%%%%%%%%%%%%%%%%%%%%%%%%%%%%%%%%%----------%%%%--%%%%--#--#-------------------%%%%%%%%%%%%%%%%%%%%%%%%%%%%---%%%%--------%%%%%%%%%%%-g----|||gy||||k---------------------------------------------------
||||||||||||||||||||||||||||||||||----------||||--||||%%%--%%%-----------g-----||||||||||||||||||||||||||||---||||-r------|||||||||||%%%%%%%%%%%%%%%%%%%%%%%%%%%F%%%%%%%%%%%%%%%%%%%%%%%%%%%%%%%%%%%%%%%
||||||||||||||||||||||||||||||||||XXXXXXXXXX||||--|||||||--|||XXX---XXXXXXXXXXX||||||||||||||||||||||||||||---||||XXXXXXXX||||||||||||||||||||||||||||||||||||||X|||||||||||||||||||||||||||||||||||||||
