HEIGHT=16;WIDTH=201;THEME=0;OVERRIDE=false
--------------------------------------------------------------------------------------------------------------------------------------------------------------------------------------------------------
--------------------------------------------------------------------------------------------------------------------------------------------------------------------------------------------------------
--------------------------------------------------------------------------------------------------------------------------------------------------------------------------------------------------------
--------------------------------------------------------------------------------------------------------------------------------------------------------------------------------------------------------
--------------------------------------------------------------------------------------------------------------------------------------------------------------------------------------------------------
--------------------------------------------------------------------------------------------------------------------------------------------------------------------------------------------------------
--------------------------------------------------------------------------------------------------------------------------------------------------------------------------------------------------------
--------------------------------------------------------------------------------------------------------------------------------------------------------------------------------------------------------
--------------------------------------------------------------------------------------------------------------------------------------------------------------------------------------------------------
--------------------------------------------------------------------------------------------------------------------------------------------------------------------------------------------------------
------------------g-------------------------------------------------------------------------------------------------------------------------------------------------------------------------------------
---------------%%%%-----------------------------------------------------------------SCSSSSSS------------------------------------------------------------------------------------------------------------
--------------g||||-K-------------------------------#--#----%%%%%---%%%%%------%%%%---------------------%%%%%--%%%%%------------------------------------------------------------------------------------
-----------%%%%%%%%%%%%%%%%---%%%%%%%%%%---%%%%%---##--##---|||||---|||||------||||---------------------|||||--|||||%%--%%%%%%%%%-----------------------------------------------------------------------
%%%%%%%%%%%||||||||||||||||---||||||||||---|||||--###--###--|||||---|||||------||||--k------------------|||||--|||||||--|||||||||-----------------------------------------------------------------------
|||||||||||||||||||||||||||---||||||||||---|||||XXXXX--XXXXX|||||---|||||XX--XX||||XXXXXXXXXXXXXXX--XXXX|||||--|||||||--|||||||||XXXXX---XXXXXXXXXXXXXFXXXXXXXXXXXXXXXXXXXXXXXXXXXXXXXXXXXXXXXXXXXXXXXXX
