HEIGHT=16;WIDTH=201;THEME=0;OVERRIDE=false
--------------------------------------------------------------------------------------------------------------------------------------------------------------------------------------------------------
--------------------------------------------------------------------------------------------------------------------------------------------------------------------------------------------------------
--------------------------------------------------------------------------------------------------------------------------------------------------------------------------------------------------------
--------------------------------------------------------------------------------------------------------------------------------------------------------------------------------------------------------
--------------------------------------------------------------------------------------------------------------------------------------------------------------------------------------------------------
------------------------------------------------------------------------y-------------------------------------------------------------------------------------------------------------------------------
---------------------------------------------------------------------%%%%-------------------------------------------------------------------------------------------------------------------------------
---------------------------------------------------------------------||||-------------------------------------------------------------------------------------------------------------------------------
---------------------------------------------------------------------||||-------------------------------------------------------------------------------------------------------------------------------
---------------------------------------------------------------------||||---------------------------%%%%%-----------------------------------------------------------------------------------------------
------------------------------------------------kr-----Tt------------|%%%%%-------------------------|||||-----------------------------------------------------------------------------------------------
-------------------------------%%%-----------%%%%%-----tt------------|||K||------k------------------|||||-----------------------Tt---tt-----------------------------------------------------------------
%%%%%%%%%%%%---------------r---r||-----------|||||-----tt---------%%%%%%%%%%%%%%%%%%%-------%%%%%%--|||||------%%%%--%%%%-------tt---tt-----------------------------------------------------------------
||||||||||||%%%%--%%%%%%%%%%%%%%%%%%---------|||||---%%%%%%-------|||||||||||||||||||-------||||||--||%%%%%----||||--||||%%--%%-tt---tt-----------------------------------------------------------------
||||||||||||||||--||||||||||||||||||--k---y--||y||---||||||%%---%%|||||||||||||||||||%%---%%||||||--||k||||-g--||||--||||||--||%%%%%%%%%%%%%%-----------------------------------------------------------
||||||||||||||||--||||||||||||||||||XXXXXXXXXXXXXXXXX||||||||---|||||||||||||||||||||||---||||||||XXXXXXXXXXXXX||||--||||||--||||||||||||||||XXXXXXXXFXXXXXXXXXXXXXXXXXXXXXXXXXXXXXXXXXXXXXXXXXXXXXXXXXX
