HEIGHT=16;WIDTH=201;THEME=0;OVERRIDE=false
--------------------------------------------------------------------------------------------------------------------------------------------------------------------------------------------------------
--------------------------------------------------------------------------------------------------------------------------------------------------------------------------------------------------------
--------------------------------------------------------------------------------------------------------------------------------------------------------------------------------------------------------
--------------------------------------------------------------------------------------------------------------------------------------------------------------------------------------------------------
--------------------------------------------------------------------------------------------------------------------------------------------------------------------------------------------------------
--------------------------------------------------------------------------------------------------------------------------------------------------------------------------------------------------------
--------------------------------------------------------------------------------------------------------------------------------------------------------------------------------------------------------
-----------------------------------------------------------%%%%%%---------------------------------------------------------------------------------------------------------------------------------------
-----------------------------------------------------------||||||-------------------------------------------%%%%----------------------------------------------------------------------------------------
-----------------------------------------------------------||||||---------------------------------%%%%%-----||||------------------%%%%------------------------------------------------------------------
-----------------------------------------------------------||||||---------------------------------|||||-----||||------------------||||------------------------------------------------------------------
-----------------------------------------------------------|%%%%%%%------yr-------------------%%%%%%|||-----||||------%%%---------||||------------------------------------------------------------------
------------------------------------------------%%%---%%%--||||||||------%%%%%%%--------------|||||||||-----||||------|||---------||||------------------------------------------------------------------
------------%%%%%%------------------------------|||---|||%%%%%%%%%%%%----|||||||----%%%%%%%%--||||||||g-----||||------|||--%%%%%%%%%%%%%%---------------------------------------------------------------
%%%%%%%%%%%%||||||%%%---%%%---------------------|||---|||||||||||||||%%%%%%%%%%%%%%%||||||||%%%%%%%%%%%%%%--||||-yg--r|||--||||||||||||||---------------------------------------------------------------
|||||||||||||||||||||---|||XXX--XXXXXXXX---XXXXX|||---||||||||||||||||||||||||||||||||||||||||||||||||||||XXXXXXXXXXXXXXXXX||||||||||||||XXXXXXXXFXXXXXXXXXXXXXXXXXXXXXXXXXXXXXXXXXXXXXXXXXXXXXXXXXXXXXX
