HEIGHT=16;WIDTH=201;THEME=0;OVERRIDE=false
--------------------------------------------------------------------------------------------------------------------------------------------------------------------------------------------------------
--------------------------------------------------------------------------------------------------------------------------------------------------------------------------------------------------------
--------------------------------------------------------------------------------------------------------------------------------------------------------------------------------------------------------
--------------------------------------------------------------------------------------------------------------------------------------------------------------------------------------------------------
--------------------------------------------------------------------------------------------------------------------------------------------------------------------------------------------------------
--------------------------------------------------------------------------------------------------------------------------------------------------------------------------------------------------------
--------------------------------------------------------------------------------------------------------------------------------------------------------------------------------------------------------
--------------------------------------------------------------------------------------------------------------------------------------------------------------------------------------------------------
------------------------------------------------------------------------SS2S----------------------------------------------------------------------------------------------------------------------------
--------------------------------------------------------------------------------------------------------------------------------------------------------------------------------------------------------
---------------------------------------------------------------------------------------2SCS-SS----------------------------------------------------------------------------------------------------------
--------------------------------------#---#----------------------------y--------------------------------------------------------------------------------------------------------------------------------
-------------------------------------##---##---------------------------%%%%%----------%----%-------tt---------------------------------------------------------------------------------------------------
------------%%%%%---%%%%%%%%%%%%%%--###---###--------------------------|||||----------|----|-------tt---%%--%%-----------%%%--%%%-----------------------------------------------------------------------
%%%%%%%%%%%%|||||---||||||||||||||%%%%%---%%%%%%%--%%-------------%%%%%%%%%%%%%%%%%%%%%%%%%%%%%%%%%%%%%%||--||%%%%---%%%%|||--|||-------------%%%%%%%%F%%%%%%%%%%%%%%%%%%%%%%%%%%%%%%%%%%%%%%%%%%%%%%%%%
|||||||||||||||||---|||||||||||||||||||---|||||||--||XX---XXXX--XX||||||||||||||||||||||||||||||||||||||||--||||||---|||||||--|||XXXXX---XXXXX||||||||X|||||||||||||||||||||||||||||||||||||||||||||||||
