HEIGHT=16;WIDTH=201;THEME=0;OVERRIDE=false
--------------------------------------------------------------------------------------------------------------------------------------------------------------------------------------------------------
--------------------------------------------------------------------------------------------------------------------------------------------------------------------------------------------------------
--------------------------------------------------------------------------------------------------------------------------------------------------------------------------------------------------------
--------------------------------------------------------------------------------------------------------------------------------------------------------------------------------------------------------
--------------------------------------------------------------------------------------------------------------------------------------------------------------------------------------------------------
--------------------------------------------------------------------------------------------------------------------------------------------------------------------------------------------------------
--------------------------------------------------------------------------------------------------------------------------------------------------------------------------------------------------------
--------------------------------------------------------------------------------------------------------------------------------------------------------------------------------------------------------
--------------------------------------------------------------------------------------------------------------------------------------------------------------------------------------------------------
--------------------------------------------------------------------------------------------------------------------------------------------------------------------------------------------------------
-----------------SCS2-----------------------------------------------------------------------------------------------------------------------------------------------------------------------------------
---------------------------------------------------SCSSU------------------------------------------------------------------------------------------------------------------------------------------------
-----------------------------------------------------------------------%%%%%%%%%%-------------------%%--%%----------------------------------------------------------------------------------------------
--------------------r--------------------------------------%%%%%%%%----||||||||||%%%---%%%%%%%--%%%%||--||---------------#--#---------------------------------------------------------------------------
%%%%%%%%%%%%%%%%%%%%%%-----------------%%%%--%%%%---g--G-r-||||||||%%%%|||||||||||||---|||||||--||||||--||%%%%%---%%%%%%%%--%%%-------------------------------------------------------------------------
||||||||||||||||||||||XX---XXXXXX--XXXX||||--||||XXXXXXXXXX|||||||||||||||||||||||||---|||||||--||||||--|||||||---||||||||--|||XX---XXXXXX--XXXXXXXXXXXXFXXXXXXXXXXXXXXXXXXXXXXXXXXXXXXXXXXXXXXXXXXXXXXX
