HEIGHT=16;WIDTH=201;THEME=0;OVERRIDE=false
--------------------------------------------------------------------------------------------------------------------------------------------------------------------------------------------------------
--------------------------------------------------------------------------------------------------------------------------------------------------------------------------------------------------------
--------------------------------------------------------------------------------------------------------------------------------------------------------------------------------------------------------
--------------------------------------------------------------------------------------------------------------------------------------------------------------------------------------------------------
---------------------g----------------------------------------------------------------------------------------------------------------------------------------------------------------------------------
--------------------%%%%%-------------------------------------------------------------------------------------------------------------------------------------------------------------------------------
--------------------|||||-------------------------------------------------------------------------------------------------------------------------------------------------------------------------------
----------------y-k-rr|||-------------------------------------------------------------------------------------------------------------------------------------------------------------------------------
----------------%%%%%%%||-------------------------------------------------------------------------------------------------------------------------------------------------------------------------------
----------------|||||||||------------------------------------------------------------------------------#--#---------------------------------------------------------------------------------------------
----------------|||||||||-----------------------------------------------------------------------------##--##--------------------------------------------------------------------------------------------
----------------|||||||||-r-----------------------%%%%------------------------------------k----------###--###-------------------------------------------------------------------------------------------
%%%%%%%%%%%%%%%%%%%%%%%%%%%%%%------------K----r--||||------------------------------------%%%%%%---%%%%%--%%%%%---------%%%%%%%%%%%%%--%%---------------------------------------------------------------
||||||||||||||||||||||||||||||%%%------%%%%%%%%%%%%%%%%%%%%%%---%%%%%%%%%%---------%%%%%--||||||---|||||--|||||--#---#--|||||||||||||--||---------------------------------------------------------------
|||||||||||||||||||||||||||||||||------||||||||||||||||||||||---||||||||||---------|||||%%%%%%%%%%%|||||--|||||%%%---%%%|||||||||||||--||%%%%%%%%F%%%%%%%%%%%%%%%%%%%%%%%%%%%%%%%%%%%%%%%%%%%%%%%%%%%%%%
|||||||||||||||||||||||||||||||||XX--XX||||||||||||||||||||||---||||||||||XXX---XXX|||||||||||||||||||||--||||||||---||||||||||||||||--||||||||||X||||||||||||||||||||||||||||||||||||||||||||||||||||||
