HEIGHT=16;WIDTH=201;THEME=0;OVERRIDE=false
--------------------------------------------------------------------------------------------------------------------------------------------------------------------------------------------------------
--------------------------------------------------------------------------------------------------------------------------------------------------------------------------------------------------------
--------------------------------------------------------------------------------------------------------------------------------------------------------------------------------------------------------
--------------------------------------------------------------------------------------------------------------------------------------------------------------------------------------------------------
--------------------------------------------------------------------------------------------------------------------------------------------------------------------------------------------------------
--------------------------------------------------------------------------------------------------------------------------------------------------------------------------------------------------------
-----------------------------------------------------------------y--------------------------------------------------------------------------------------------------------------------------------------
--------------------------------------------------------------%%%%--------------------------------------------------------------------------------------------------------------------------------------
--------------------------------------------------------------||||--------------------------------------------------------------------------------------------------------------------------------------
--------------------------------------------------------------||||------------------------------------------------y-------------------------------------------------------------------------------------
--------------------------------------------------------------||||----------------------------------------------%%%%%%%---------------------------------------------------------------------------------
------------------------------------------------%%%---%%%%%%--||||----------------------------------------------|||||||---------------------------------------------------------------------------------
---------------------------#--#-----------------|||---||||||--||||----------------------------------------g----r|||||||------k--------------------------------------------------------------------------
-----------%%%---%%%%%%%--##--##--%%%%%%%%%%%%%%%%%%%-||||||--||||--%%%%%%%--%%%%%%%%%--%%%%%%%%%---%%%%%%%%%%%%%%%%%%%%%%--%%%%------------------------------------------------------------------------
%%%%%%%%%%%|||---|||||||%%%%--%%%%|||||||||||||||||||-g|||||--||||--|||||||--|||||||||--|||||||||---||||||||||||||||||||||-k||||----y--y----%%%%%%%%F%%%%%%%%%%%%%%%%%%%%%%%%%%%%%%%%%%%%%%%%%%%%%%%%%%%
||||||||||||||---|||||||||||--|||||||||||||||||||||||XXXXXXXXXXXXXXX|||||||--|||||||||--|||||||||---||||||||||||||||||||||XXXXXXXXXXXXXXXXXX||||||||X|||||||||||||||||||||||||||||||||||||||||||||||||||
