HEIGHT=16;WIDTH=201;THEME=0;OVERRIDE=false
--------------------------------------------------------------------------------------------------------------------------------------------------------------------------------------------------------
--------------------------------------------------------------------------------------------------------------------------------------------------------------------------------------------------------
--------------------------------------------------------------------------------------------------------------------------------------------------------------------------------------------------------
--------------------------------------------------------------------------------------------------------------------------------------------------------------------------------------------------------
--------------------------------------------------------------------------------------------------------------------------------------------------------------------------------------------------------
--------------------------------------------------------------------------------------------------------------------------------------------------------------------------------------------------------
------------------------------------------------------2CSCS----------SSCUS------------------------------------------------------------------------------------------------------------------------------
--------------------------------------------------------------------------------------------------------------------------------------------------------------------------------------------------------
--------------------------------------------------------------------------------------------------------------------------------------------------------------------------------------------------------
-----------------------------------------------------rr---------------g-----------------------------------------------------SSSSS-----------------------------------------------------------------------
----------------------------------------------------%%%%%%%----------%%%%%%---------%%%-----------------------------------------------------------------------------------------------------------------
----------------------------------------------------|||||||----------||||||---------|||----------------------------------------------#---#--------------------------------------------------------------
%%%%%%%%%%-------------------tt---------------------|||||||------%%%%%%%%%%%%%%%%%%%%%%%%%%%%%%%%%--%%%%%---------------------------##---##--%%%%%%%%F%%%%%%%%%%%%%%%%%%%%%%%%%%%%%%%%%%%%%%%%%%%%%%%%%%
||||||||||---#--#------------tt--------%%---%%-G---r|||||||------|||||||||||||||||||||||||||||||||--|||||------------------%%%%%%%%%%%---%%%%||||||||%||||||||||||||||||||||||||||||||||||||||||||||||||
||||||||||--##--##--%%--%%---tt--------||---||%%%%%%%%%%%%%%%%%%%|||||||||||||||||||||||||||||||||--|||||------------r-----|||||||||||---|||||||||||||||||||||||||||||||||||||||||||||||||||||||||||||||
||||||||||XXXX--XXXX||--||XXXXXXXX---XX||---||||||||||||||||||||||||||||||||||||||||||||||||||||||--|||||XXXX---XXXXXXXXXXX|||||||||||---|||||||||||||||||||||||||||||||||||||||||||||||||||||||||||||||
