HEIGHT=16;WIDTH=201;THEME=0;OVERRIDE=false
--------------------------------------------------------------------------------------------------------------------------------------------------------------------------------------------------------
--------------------------------------------------------------------------------------------------------------------------------------------------------------------------------------------------------
--------------------------------------------------------------------------------------------------------------------------------------------------------------------------------------------------------
--------------------------------------------------------------------------------------------------------------------------------------------------------------------------------------------------------
-----------------------------------------------------------------------------------------------%%%%%----------------------------------------------------------------------------------------------------
-----------------------------------------------------------------------------------------------|||||----------------------------------------------------------------------------------------------------
------------------------------------------------------------y----------------------------------|||||----------------------------------------------------------------------------------------------------
----------------------------------------------------------%%%----------------------------------|||||k---------------------------------------------------------------------------------------------------
----------------------------------------------------------|||----------------------------------||%%%%%%%-------------------------------SCC--------------------------------------------------------------
-------------------------------------------------------%%%%%|----------------------------------|||||||||--------tt--------------------------------------------------------------------------------------
-------------------------------------------------------||||||----------------------------------|||||||||--------tt--------------------------------------------------------------------------------------
------------------------------------------------------r|g||||-----#---#------------------------|||||||||r-------tt------------------------k-------------------------------------------------------------
----------------%%%%%%%%%%---------------------%%%%%%%%%%%%%%%%--##---##----------%%%%--------%%%%%%%%%%%%%%%%%%%%%%----------------%%%%%%%%------------------------------------------------------------
%%%%%%%%%%%%%---||||||||||---------------------||||||||||||||||%%%%---%%%%--------||||%%%--%%%||||||||||||||||||||||%%%--%%%--------||||||||%%%%%%%%F%%%%%%%%%%%%%%%%%%%%%%%%%%%%%%%%%%%%%%%%%%%%%%%%%%%
|||||||||||||%%%||||||||||%%%%--%%%%-----------||||||||||||||||||||---||||%%--%%--|||||||--||||||||||||||||||||||||||||--|||--#--#--||||||||||||||||%|||||||||||||||||||||||||||||||||||||||||||||||||||
||||||||||||||||||||||||||||||--||||XXXX---XXXX||||||||||||||||||||---||||||--||XX|||||||--||||||||||||||||||||||||||||--|||XXX--XXX||||||||||||||||||||||||||||||||||||||||||||||||||||||||||||||||||||
