HEIGHT=16;WIDTH=201;THEME=0;OVERRIDE=false
--------------------------------------------------------------------------------------------------------------------------------------------------------------------------------------------------------
--------------------------------------------------------------------------------------------------------------------------------------------------------------------------------------------------------
--------------------------------------------------------------------------------------------------------------------------------------------------------------------------------------------------------
--------------------------------------------------------------------------------------------------------------------------------------------------------------------------------------------------------
--------------------------------------------------------------------------------------------------------------------------------------------------------------------------------------------------------
----------------------------------------------------------------------------------------------------SCU-------------------------------------------------------------------------------------------------
-------------------------------2SC----------------------------------------------------------------------------------------------------------------------------------------------------------------------
--------------------------------------------------------------------------------------------------------------------------------------------------------------------------------------------------------
----------------------------------%-----------------------------------------------------------------k--k------------------------------------------------------------------------------------------------
-------------------------------y--|----------------------------------------------------SSS----------%%%%------------------------------------------------------------------------------------------------
-------------------------------%%%%------------------------------------SCSS-------------------------||||------------------------------------------------------------------------------------------------
-------------------------------||||-----------------------------------------------------------------||||------------------------------------------------------------------------------------------------
%%%%%%%%%%%%%------------------||||--%%%%%%%-------------------------------%--------g----------g-k--||||----tt--Tt--------------------------------------------------------------------------------------
|||||||||||||------------------||||g-|||||||-------------------------------|-------%%%%%%%%%%%%%%%%%%%%%%%--tt--tt--------------------------------------------------------------------------------------
|||||||||||||--#---#--%%%%%%%%%%%%%%%|||||||--------------------------%%%%%%%%%%%%%|||||||||||||||||||||||%%%%%%%%%%%%%%%%--%%%%------------------------------------------------------------------------
|||||||||||||XXX---XXX||||||||||||||||||||||XXXXX---XXXXXXXXXX---XXXXX||||||||||||||||||||||||||||||||||||||||||||||||||||--||||XXX---XXXXXXXXXXXFXXXXXXXXXXXXXXXXXXXXXXXXXXXXXXXXXXXXXXXXXXXXXXXXXXXXXX
