HEIGHT=16;WIDTH=201;THEME=0;OVERRIDE=false
--------------------------------------------------------------------------------------------------------------------------------------------------------------------------------------------------------
--------------------------------------------------------------------------------------------------------------------------------------------------------------------------------------------------------
--------------------------------------------------------------------------------------------------------------------------------------------------------------------------------------------------------
--------------------------------------------------------------------------------------------------------------------------------------------------------------------------------------------------------
--------------------------------------------------------------------------------------------------------------------------------------------------------------------------------------------------------
--------------------------------------------------------------------------------------------------------------------------------------------------------------------------------------------------------
--------------------------------------------------------------------------------------------------------------------------------------------------------------------------------------------------------
--------------------------------------------------------------------------------------------------------------------------------------------------------------------------------------------------------
--------------------------------------------------------------------------------------------------------------------------------------------------------------------------------------------------------
------------------#--#--------------------------------------------------------------%%%%%-----------------------------------------------SSC-------------------------------------------------------------
-----------------##--##-------------------------------------------------------------|||||---------------------------------------------------------------------------------------------------------------
----------------###--###----------------------------------------------CSSCCSS-------|||||------------------------#--#------Tt---------------------------------------------------------------------------
--------------%%%%%--%%%%%----------------------------------------------------------k||||----------------------%%%--%%%----tt---#--#--------------------------------------------------------------------
%%%%%%%%%%%%%%|||||--|||||%%%--%%%%%--%%--------------------------------------%%%%%%%%%%%%%%%%%%--%%%%---------|||--|||%%%%%%%%%%--%%%%%%%%%%%%%%%%%%%F%%%%%%%%%%%%%%%%%%%%%%%%%%%%%%%%%%%%%%%%%%%%%%%%%
|||||||||||||||||||--||||||||--|||||--||--------------------------------------||||||||||||||||||--||||---------|||--|||||||||||||--|||||||||||||||||||%|||||||||||||||||||||||||||||||||||||||||||||||||
|||||||||||||||||||--||||||||--|||||--||XXXX---XXXXXXXX--XXXXXXXXXXXXXXXXXXXXX||||||||||||||||||--||||XXX---XXX|||--|||||||||||||--|||||||||||||||||||||||||||||||||||||||||||||||||||||||||||||||||||||
