HEIGHT=16;WIDTH=201;THEME=0;OVERRIDE=false
--------------------------------------------------------------------------------------------------------------------------------------------------------------------------------------------------------
--------------------------------------------------------------------------------------------------------------------------------------------------------------------------------------------------------
--------------------------------------------------------------------------------------------------------------------------------------------------------------------------------------------------------
--------------------------------------------------------------------------------------------------------------------------------------------------------------------------------------------------------
--------------------------------------------------------------------------------------------------------------------------------------------------------------------------------------------------------
--------------------------------------------------------------------------------------------------------------------------------------------------------------------------------------------------------
--------------------------------------------------------------------------------------------------------------------------------------------------------------------------------------------------------
--------------------------------------------------------------------------------------------------------------------------------------------------------------------------------------------------------
--------------------------------------------------------------------------------------------------------------------------------------------------------------------------------------------------------
---------------------------------------------------------------2US-------------------------------------------------------#---#--------------------------------------------------------------------------
-------------SCSSU--------------------------------------------------------------------------------------------#--#------##---##-------------------------------------------------------------------------
-------------------------------------------------------------------------------------------------------------##--##----###---###------------------------------------------------------------------------
%%%%%%%%%%%---------%%%%---%%%%%%%%%%%%%%--%%%%--------------------------------------%%%%%--%%%%%----------%%%%--%%%%%%%%%---%%%%%---------%%%%%%%%F%%%%%%%%%%%%%%%%%%%%%%%%%%%%%%%%%%%%%%%%%%%%%%%%%%%%
|||||||||||----r-K--||||---||||||||||||||--||||-------------%%%%%%%------------------|||||--|||||----------||||--|||||||||---|||||---------||||||||%||||||||||||||||||||||||||||||||||||||||||||||||||||
|||||||||||%%%%%%%%%||||---||||||||||||||--||||%%%%%---%%%%%|||||||--#---#----#---#--|||||--|||||%%%%--%%%%||||--|||||||||---|||||---------|||||||||||||||||||||||||||||||||||||||||||||||||||||||||||||
||||||||||||||||||||||||---||||||||||||||--|||||||||---||||||||||||XXX---XXXXXX---XXX|||||--|||||||||--||||||||--|||||||||---|||||XXX---XXX|||||||||||||||||||||||||||||||||||||||||||||||||||||||||||||
