HEIGHT=16;WIDTH=201;THEME=0;OVERRIDE=false
--------------------------------------------------------------------------------------------------------------------------------------------------------------------------------------------------------
--------------------------------------------------------------------------------------------------------------------------------------------------------------------------------------------------------
--------------------------------------------------------------------------------------------------------------------------------------------------------------------------------------------------------
--------------------------------------------------------------------------------------------------------------------------------------------------------------------------------------------------------
--------------------------------------------------------------------------------------------------------------------------------------------------------------------------------------------------------
--------------------------------------------------------------------------------------------------------------------------------------------------------------------------------------------------------
------------------------------------------------------------------------------UCC-----------------------------------------------------------------------------------------------------------------------
--------------------------------------------------------------------------------------------------------------------------------------------------------------------------------------------------------
-----------------------------------------------------------------------------%--------------------------------------------------------------------------------------------------------------------------
-----------------------------------------------------------------------------|--r-----------------------------------------------------------------------------------------------------------------------
---------------------------------------------------------------------------%%%%%%%------------------------------#---#-----------------------------------------------------------------------------------
--------------------------------------------tt-----------------------------||r|r|k------y-----------#--#-------##---##----------------------------------------------------------------------------------
-----------------------%%%%--%%%%-----------tt---------------------------%%%%%%%%%%%%%%%%%---------##--##-----###---###---------------------------------------------------------------------------------
-----------------------||||--||||-----------tt--------------#---#--------|||||||||||||||||--------###--###--%%%%%---%%%%%-------------------------------------------------------------------------------
-----------------------||||--||||---------%%%%%%%%%%%--%%%%%%---%%%------|||||||||||||||||------%%%%%--%%%%%|||||---|||||--------%%%%%---%%-------------------------------------------------------------
XXXXXXXXXXXXXXXX--XXXXX||||--||||XXX---XXX|||||||||||--||||||---|||XX--XX|||||||||||||||||XX--XX|||||--||||||||||---|||||XXX--XXX|||||---||XXXXXXXXFXXXXXXXXXXXXXXXXXXXXXXXXXXXXXXXXXXXXXXXXXXXXXXXXXXXX
