HEIGHT=16;WIDTH=201;THEME=0;OVERRIDE=false
--------------------------------------------------------------------------------------------------------------------------------------------------------------------------------------------------------
--------------------------------------------------------------------------------------------------------------------------------------------------------------------------------------------------------
--------------------------------------------------------------------------------------------------------------------------------------------------------------------------------------------------------
--------------------------------------------------------------------------------------------------------------------------------------------------------------------------------------------------------
--------------------------------------------------------------------------------------------------------------------------------------------------------------------------------------------------------
--------------------------------------------------------------------------------------------------------------------------------------------------------------------------------------------------------
--------------------------------------------------------------------------------------------------------------------------------------------------------------------------------------------------------
--------------------------------------------------------------------------------------------------------------------------------------------------------------------------------------------------------
--------------------------------------------------------------------------------------------------------------------------------------------------------------------------------------------------------
--------------------------------------------------------------------------------------------------------------------------------------------------------------------------------------------------------
----------------------------------------------------------------g-------------%%%%%%%-------------------------------------------------------------------------------------------------------------------
---------------------------------------------------------------%%%%%%%--------|||||||-------------------------------------------------------------------------------------------------------------------
---------------------------------------------------------------|||||||--------|||||||------------tt-Tt------#---#---%%%%%---%%%%%-----%%%%%-------------------------------------------------------------
--------------%%%%---%%%%--------------------------------------|||||||------%%%%%%%%%%%%%%%%%%%--tt-tt-----##---##--|||||---|||||%%%%%|||||%%%%%%%%F%%%%%%%%%%%%%%%%%%%%%%%%%%%%%%%%%%%%%%%%%%%%%%%%%%%%
%%%%%%%%%%%%%%||||---||||%%%---%%%--------------#---#--%%---%%-r||||||-r----|||||||||||||||||||--tt-tt---%%%%---%%%%|||||---|||||||||||||||||||||||%||||||||||||||||||||||||||||||||||||||||||||||||||||
||||||||||||||||||---|||||||---|||XXXXX--XXXXXXXX---XXX||---||XXXXXXXXXXXXXX|||||||||||||||||||XXXXXXXXXX||||---|||||||||---||||||||||||||||||||||||||||||||||||||||||||||||||||||||||||||||||||||||||||
