HEIGHT=16;WIDTH=201;THEME=0;OVERRIDE=false
--------------------------------------------------------------------------------------------------------------------------------------------------------------------------------------------------------
--------------------------------------------------------------------------------------------------------------------------------------------------------------------------------------------------------
--------------------------------------------------------------------------------------------------------------------------------------------------------------------------------------------------------
--------------------------------------------------------------------------------------------------------------------------------------------------------------------------------------------------------
--------------------------------------------------------------------------------------------------------------------------------------------------------------------------------------------------------
--------------------------------------------------------------------------------------------------------------------------------------------------------------------------------------------------------
--------------------------------------------------------------------------------------------------------------------------------------------------------------------------------------------------------
--------------------------------------------------------------------------------------------------------------------------------------------------------------------------------------------------------
-------------------------------------------------------------2SSC---------------------------------------------------------------------------------------------------------------------------------------
--------------------------------------------------------------------------------------------------------------------------------------------------------------------------------------------------------
--------------------------------------------------------------------------------------------------------------------------------------------------------------------------------------------------------
------------------------------------------------tt-tt--Tt---------g-----------------------------------------------------------2SSSSUSS------------------------------------------------------------------
%%%%%%%%%%%%------%%---%%-----------------------tt-tt--tt--%%%%%%%%%%---------%%%%%---------k-----%%%%%%%%%%---%%%%%--------------------%%%%%%%%F%%%%%%%%%%%%%%%%%%%%%%%%%%%%%%%%%%%%%%%%%%%%%%%%%%%%%%%
||||||||||||---k--||---||--#---#---------------%%%%%%%%%%%%||||||||||---------|||||-------%%%%----||||||||||---|||||--------------------||||||||%|||||||||||||||||||||||||||||||||||||||||||||||||||||||
||||||||||||%%%%%%||---||%%%---%%%-------------||||||||||||||||||||||---------|||||-----y-||||----||||||||||---|||||%%%---%%%-----------||||||||||||||||||||||||||||||||||||||||||||||||||||||||||||||||
||||||||||||||||||||---|||||---|||XXXXX---XXXXX||||||||||||||||||||||XXXXXXXXXXXXXXXXXXXXXXXXXXXXX||||||||||---||||||||---|||XXXXXXXXXXX||||||||||||||||||||||||||||||||||||||||||||||||||||||||||||||||
