HEIGHT=16;WIDTH=201;THEME=0;OVERRIDE=false
--------------------------------------------------------------------------------------------------------------------------------------------------------------------------------------------------------
--------------------------------------------------------------------------------------------------------------------------------------------------------------------------------------------------------
--------------------------------------------------------------------------------------------------------------------------------------------------------------------------------------------------------
--------------------------------------------------------------------------------------------------------------------------------------------------------------------------------------------------------
--------------------------------------------------------------------------------------------------------------------------------------------------------------------------------------------------------
--------------------------------------------------------------------------------------------------------------------------------------------------------------------------------------------------------
--------------------------------------------------------------------------------------------------------------------------------------------------------------------------------------------------------
--------------------------------------------------------------------------------------------------------------------------------------------------------------------------------------------------------
--------------------------------------------------------------------------------------------------------y-----------------------------------------------------------------------------------------------
-----------------------------#--#---------------------------------------------------------------------%%%%%---------------------------------------------------------------------------------------------
----------------------------##--##--------------------------------------------------------------------|||||----------------------tt---------------------------------------------------------------------
---------------------------###--###-------------------------------------------------------------------|||||-r--g----#--#---------tt---------------------------------------------------------------------
-------------------------%%%%%--%%%%%---------%%---%%------------%%%%---%%%%-------------------------%%%%%%%%%%%%%%%%--%%%----%%%%%%%%%%----------------------------------------------------------------
--------------%%%%---%%%%|||||--|||||---------||---||%%%%%--%%%%%||||---||||%%%%%---%%%%%%%%%%--%%%%%||||||||||||||||--|||%%%%||||||||||%%%%%%%%F%%%%%%%%%%%%%%%%%%%%%%%%%%%%%%%%%%%%%%%%%%%%%%%%%%%%%%%
--------------||||---|||||||||--|||||---------||---|||||||--|||||||||---|||||||||---||||||||||--|||||||||||||||||||||--|||||||||||||||||||||||||%|||||||||||||||||||||||||||||||||||||||||||||||||||||||
XXXXXXXXXXXXXX||||---|||||||||--|||||XXX---XXX||---|||||||--|||||||||---|||||||||---||||||||||--|||||||||||||||||||||--|||||||||||||||||||||||||||||||||||||||||||||||||||||||||||||||||||||||||||||||||
