HEIGHT=16;WIDTH=201;THEME=0;OVERRIDE=false
--------------------------------------------------------------------------------------------------------------------------------------------------------------------------------------------------------
--------------------------------------------------------------------------------------------------------------------------------------------------------------------------------------------------------
--------------------------------------------------------------------------------------------------------------------------------------------------------------------------------------------------------
--------------------------------------------------------------------------------------------------------------------------------------------------------------------------------------------------------
--------------------------------------------------------------------------------------------------------------------------------------------------------------------------------------------------------
--------------------------------------------------------------------------------------------------------------------------------------------------------------------------------------------------------
--------------------------------------------------------------------------------------------------------------------------------------------------------------------------------------------------------
------------------------SS------------------------------------------------------------------------------------------------------------------------------------------------------------------------------
--------------------------------------------------------------------------------------------------------------------------------------------------------------------------------------------------------
-----------------------%------------------------------------------------------------------------------------------------------------------#---#---------------------------------------------------------
-----------------------|--gg--------------------------------------------------------------------------------------#---#------------------##---##--------------------------------------------------------
----------------------%%%%%%%------------------------------------------------------------------------------------##---##----------------###---###-------------------------------------------------------
%%%%%%%%%%%%%---------|||||||--%%%%%---%%%%%--#---#----------%%%%%--%%%%%---------------------------------------###---###-------------%%%%%---%%%%%-----------------------------------------------------
|||||||||||||--rKY----|||||||--|||||---|||||%%%---%%%--#--#--|||||--|||||-----------%%%%---%%%%---------------%%%%%---%%%%%%%%%---%%%%|||||---|||||-----------------------------------------------------
|||||||||||||%%%%%%%%%%%%%%%%%%|||||---||||||||---|||%%%--%%%|||||--|||||%%%%---%%%%||||---||||---------------|||||---|||||||||---|||||||||---|||||%%%%%%%%F%%%%%%%%%%%%%%%%%%%%%%%%%%%%%%%%%%%%%%%%%%%%
||||||||||||||||||||||||||||||||||||---||||||||---||||||--||||||||--|||||||||---||||||||---||||XXX--XXXXX---XX|||||---|||||||||---|||||||||---|||||||||||||X||||||||||||||||||||||||||||||||||||||||||||
