HEIGHT=16;WIDTH=201;THEME=0;OVERRIDE=false
--------------------------------------------------------------------------------------------------------------------------------------------------------------------------------------------------------
--------------------------------------------------------------------------------------------------------------------------------------------------------------------------------------------------------
--------------------------------------------------------------------------------------------------------------------------------------------------------------------------------------------------------
--------------------------------------------------------------------------------------------------------------------------------------------------------------------------------------------------------
--------------------------------------------------------------------------------------------------------------------------------------------------------------------------------------------------------
--------------------------------------------------------------------------------------------------------------------------------------------------------------------------------------------------------
--------------------------------------------------------------------------------------------------------------------------------------------------------------------------------------------------------
--------------------------------------------------------------------------------------------------------------------------------------------------------------------------------------------------------
--------------------------------------------------------------------------------------------------------------------------------------------------------------------------------------------------------
------------------------------------------------------CSUSS---------------------------------------------22S---------------------------------------------------------------------------------------------
-------------------------------------#--#---------------------------------------------------------------------------------------------------------------------------------------------------------------
----------------Tt------------------##--##--------------------------------------------------------------------------------------------------------------------------------------------------------------
----------------tt---tt-----------%%%%--%%%%--#--#------k-------------%%---%%--------#---#--------------------------------------%%--%%------------------------------------------------------------------
%%%%%%%%%%%%----tt---tt----#--#---||||--||||%%%--%%%%%%%%%%%--%%%--%%%||---||------%%%---%%%%%%%%%%%%%%%%%%%%-------------------||--||------------------------------------------------------------------
||||||||||||%%%%%%%%%%%%--##--##--||||--|||||||--|||||||||||--|||--|||||---||------|||---||||||||||||||||||||----------%%%%%%%%%||--||%%%%--%%%%--------------------------------------------------------
||||||||||||||||||||||||XXXX--XXXX||||--|||||||--|||||||||||XX|||--|||||---||XX--XX|||---||||||||||||||||||||XXXX--XXXX|||||||||||--||||||--||||XXXXXXXXFXXXXXXXXXXXXXXXXXXXXXXXXXXXXXXXXXXXXXXXXXXXXXXX
