HEIGHT=16;WIDTH=201;THEME=0;OVERRIDE=false
--------------------------------------------------------------------------------------------------------------------------------------------------------------------------------------------------------
--------------------------------------------------------------------------------------------------------------------------------------------------------------------------------------------------------
--------------------------------------------------------------------------------------------------------------------------------------------------------------------------------------------------------
--------------------------------------------------------------------------------------------------------------------------------------------------------------------------------------------------------
--------------------------------------------------------------------------------------------------------------------------------------------------------------------------------------------------------
--------------------------------------------------------------------------------------------------------------------------------------------------------------------------------------------------------
--------------------------------------------------------------------------------------------------------------------------------------------------------------------------------------------------------
--------------------------------------------------------------------------------------------------------------------------------------------------------------------------------------------------------
--------------------------------------------------------------------------------------------------------------------------------------------------------------------------------------------------------
--------------------------------------------------------------------------------------------------------------------------------------------------------------------------------------------------------
-----------------------------------------------------SSSSSC---------------------------------------------------------------------------------------------------------------------------------------------
--------------------------------------------------------------------------------------------------------------------------------------#---#-------------------------------------------------------------
--------------------------------------------------------------%%---%%--------------------------------tt-----------------#--#---------##---##--%%%%%%%%F%%%%%%%%%%%%%%%%%%%%%%%%%%%%%%%%%%%%%%%%%%%%%%%%%
------------------------------------%%%%%%%%------------------||---||----------%%%%%--%%%%%--tt---Tt-tt----------------##--##---%%%%%%%---%%%%||||||||%|||||||||||||||||||||||||||||||||||||||||||||||||
%%%%%%%%%%%---------%%%%%%%%%---%%%%||||||||-------%%%%%%%%%%%||---||----------|||||--|||||--tt---tt-tt---------------###--###--|||||||---||||||||||||||||||||||||||||||||||||||||||||||||||||||||||||||
|||||||||||XXXXXXXXX|||||||||---||||||||||||XX---XX|||||||||||||---||XXXX--XXXX|||||--|||||XXXXXXXXXXXXXXXXXX--XXXXXXXXXX--XXXXX|||||||---||||||||||||||||||||||||||||||||||||||||||||||||||||||||||||||
