HEIGHT=16;WIDTH=201;THEME=0;OVERRIDE=false
--------------------------------------------------------------------------------------------------------------------------------------------------------------------------------------------------------
--------------------------------------------------------------------------------------------------------------------------------------------------------------------------------------------------------
--------------------------------------------------------------------------------------------------------------------------------------------------------------------------------------------------------
--------------------------------------------------------------------------------------------------------------------------------------------------------------------------------------------------------
--------------------------------------------------------------------------------------------------------------------------------------------------------------------------------------------------------
--------------------------------------------------------------------------------------------------------------------------------------------------------------------------------------------------------
--------------------------------------------------------------------------------------------------------------------------------------------------------------------------------------------------------
--------------------------------------------------------------------------------------------------------------------------------------------------------------------------------------------------------
---------------------------------------------------------CCSSS------------------------------------------------------------------------------------------------------------------------------------------
--------------------------------------------------------------------------------------------------------------------------------------------------------------------------------------------------------
--------------#---#--------------------#---#------------------------------------------------------------------------------------------------------------------------------------------------------------
-------------##---##------------------##---##-----------------------------------------------------------------------------------------------------------------------------------------------------------
------------###---###------#---#----%%%%---%%%%-------%%%%%%%%%%%-----------------------------------------#---#--------------%%%%%--%%%%%---------------------------------------------------------------
----------%%%%%---%%%%%---##---##---||||---||||%%---%%|||||||||||----------------------------%%%%%-------##---##-----#---#---|||||--|||||---------------------------------------------------------------
----------|||||---|||||--###---###--||||---||||||---|||||||||||||-------------------------%%%|||||%%%%%%%%%---%%%%--##---##--|||||--|||||%%%%%%%%F%%%%%%%%%%%%%%%%%%%%%%%%%%%%%%%%%%%%%%%%%%%%%%%%%%%%%%
XXXXXXXXXX|||||---|||||XXXXX---XXXXX||||---||||||---|||||||||||||XX---XXXX--XXXXXXX--XXXXX|||||||||||||||||---||||XXXX---XXXX|||||--|||||||||||||X||||||||||||||||||||||||||||||||||||||||||||||||||||||
