HEIGHT=16;WIDTH=201;THEME=0;OVERRIDE=false
--------------------------------------------------------------------------------------------------------------------------------------------------------------------------------------------------------
--------------------------------------------------------------------------------------------------------------------------------------------------------------------------------------------------------
--------------------------------------------------------------------------------------------------------------------------------------------------------------------------------------------------------
--------------------------------------------------------------------------------------------------------------------------------------------------------------------------------------------------------
-------------------------%%%----------------------------------------------------------------------------------------------------------------------------------------------------------------------------
-------------------------|||----------------------------------------------------------------------------------------------------------------------------------------------------------------------------
-------------------------|||----------------------------------------------------------------------------------------------------------------------------------------------------------------------------
-------------------------|k|----------------------------------------------------------------------------------------------------------------------------------------------------------------------------
-------------------------|%%%%%%------------------------------------------------------------------------------------------------------------------------------------------------------------------------
-------------------------|||||||---------------------------------------------------------------------y--------------------------------------------------------------------------------------------------
-------------------------|||||||---------------------#---#-----------------------------------------%%%------------------------------#---#---------------------------------------------------------------
-------------------------g|||y||--------------------##---##----------------------------------------|||-----------------------------##---##--------------------------------------------------------------
----------------#---#---%%%%%%%%%%-----------------###---###---------------------------------------|||---------------------------%%%%---%%%%------------------------------------------------------------
%%%%%%%%%%%%%--##---##--||||||||||---------------%%%%%---%%%%%-----------------------------------%%%%%%%---------------%%%%--%%%%||||---||||------------------------------------------------------------
|||||||||||||%%%%---%%%%||||||||||-----%%--%%----|||||---|||||--------------y--------------------|||||y|-g-------------||||--||||||||---||||------------------------------------------------------------
|||||||||||||||||---||||||||||||||XXXXX||--||XXXX|||||---|||||XXXXX---XXXXXXXXXXXXXXXXXXX---XXXXXXXXXXXXXXXXXXXX--XXXXX||||--||||||||---||||XXXXXXXXFXXXXXXXXXXXXXXXXXXXXXXXXXXXXXXXXXXXXXXXXXXXXXXXXXXX
