HEIGHT=16;WIDTH=201;THEME=0;OVERRIDE=false
--------------------------------------------------------------------------------------------------------------------------------------------------------------------------------------------------------
--------------------------------------------------------------------------------------------------------------------------------------------------------------------------------------------------------
--------------------------------------------------------------------------------------------------------------------------------------------------------------------------------------------------------
--------------------------------------------------------------------------------------------------------------------------------------------------------------------------------------------------------
--------------------------------------------------------------------------------------------------------------------------------------------------------------------------------------------------------
--------------------------------------------------------------------------------------------------------------------------------------------------------------------------------------------------------
--------------------------------------------------------------------------------------------------------------------------------------------------------------------------------------------------------
--------------------------------------------------------------------------------------------------------------------------------------------------------------------------------------------------------
--------------------------------------SS22------------------------------SSC-SS--------------------------------------------------------------------------------------------------------------------------
--------------------------------------------------------------------------------------------------------------------------------------------------------------------------------------------------------
---------------------------------------------------------------------------%----------------------------------------------------------------------------------------------------------------------------
--------------------------------------------------------------------------y|-g--------------------------------------------------------------------------------------------------------------------------
---------------------#--#------------%%%%%%%%--%%---------------------%%%%%%%%%%%%%%%%%%---%%%%%-------%%---%%---#--#------#--#-------------%%%%%%%%F%%%%%%%%%%%%%%%%%%%%%%%%%%%%%%%%%%%%%%%%%%%%%%%%%%%
-------------------%%%--%%%----------||||||||--||%%%%---%%%%----------||||||||||||||||||---|||||-------||---||--##--##----##--##-----#--#---||||||||%|||||||||||||||||||||||||||||||||||||||||||||||||||
----------%%%---%%%|||--|||%%%%--%%%%||||||||--||||||---||||----------||||||||||||||||||---|||||-------||---||%%%%--%%%%%%%%--%%%%--##--##--||||||||||||||||||||||||||||||||||||||||||||||||||||||||||||
XXXXXXXXXX|||---||||||--|||||||--||||||||||||--||||||---||||XXXX--XXXX||||||||||||||||||---|||||XX---XX||---||||||--||||||||--||||XXXX--XXXX||||||||||||||||||||||||||||||||||||||||||||||||||||||||||||
