HEIGHT=16;WIDTH=201;THEME=0;OVERRIDE=false
--------------------------------------------------------------------------------------------------------------------------------------------------------------------------------------------------------
--------------------------------------------------------------------------------------------------------------------------------------------------------------------------------------------------------
--------------------------------------------------------------------------------------------------------------------------------------------------------------------------------------------------------
--------------------------------------------------------------------------------------------------------------------------------------------------------------------------------------------------------
--------------------------------------------------------------------------------------------------------------------------------------------------------------------------------------------------------
--------------------------------------------------------------------------------------------------------------------------------------------------------------------------------------------------------
--------------------------------------------------------------------------------------------------------------------------------------------------------------------------------------------------------
--------------------------------------------------------------------------------------------------------------------------------------------------------------------------------------------------------
--------------------------------------------------------------------------------------------------------------------------------------------------------------------------------------------------------
--------------------------------------------------------------------------------------------------------------------------------------------------------------------------------------------------------
-----------------------------------------------------------------------------------------------2SCCS----------------------------------------------------------------------------------------------------
----------------#--#---------------------#--#-----------------------------------------------------------------------------------------------------------------------------------------------------------
---------------##--##---------%%%%%%%---##--##------%%%%%--%%%%%---%%--%%-------------------------------------------------------------------------------------------------------------------------------
--------------###--###--------|||||||--###--###--%%%|||||--|||||%%%||--||%%%%--%%%%%%--%%--------G--k----tt--------------#---#--------------------------------------------------------------------------
%%%%%%%%%%%%%%%%%--%%%%%%%--%%|||||||%%%%%--%%%%%||||||||--||||||||||--||||||--||||||--||%%%%%%%%%%%%%---tt--%%%---%%%--##---##--%%--%%%%%%%--%%%%%%%%%%%%%F%%%%%%%%%%%%%%%%%%%%%%%%%%%%%%%%%%%%%%%%%%%%
|||||||||||||||||--|||||||--||||||||||||||--|||||||||||||--||||||||||--||||||--||||||--|||||||||||||||XXXXXXX|||---|||XXXX---XXXX||--|||||||--|||||||||||||X||||||||||||||||||||||||||||||||||||||||||||
