HEIGHT=16;WIDTH=201;THEME=0;OVERRIDE=false
--------------------------------------------------------------------------------------------------------------------------------------------------------------------------------------------------------
--------------------------------------------------------------------------------------------------------------------------------------------------------------------------------------------------------
--------------------------------------------------------------------------------------------------------------------------------------------------------------------------------------------------------
--------------------------------------------------------------------------------------------------------------------------------------------------------------------------------------------------------
--------------------------------------------------------------------------------------------------------------------------------------------------------------------------------------------------------
--------------------------------------------------------------------------------------------------------------------------------------------------------------------------------------------------------
--------------------------------------------------------------------------------------------------------------------------------------------------------------------------------------------------------
--------------------------------------------------------------------------------------------------------------------------------------------------------------------------------------------------------
--------------------------------------------------SSSSCS---------------------------------------------------------y--------------------------------------------------------------------------------------
-------------------------------------------Tt---------------------------#--#-------------------------------------%%%%-----------------------------------------------------------------------------------
-------------------------------------------tt---------------#---#------##--##------------------------------------|||r---r-------------------------------------------------------------------------------
-------------------------------------------tt---r----------##---##----###--###----#--#---------------------------|||%%%%%-------------------------------------------------------------------------------
-----------------------------------------%%%%%%%%%%%%%%%%%%%%---%%%%%%%%%--%%%%%%%%--%%%----------------%%%--%%%-|||g|||r-------------------------------------------------------------------------------
--------------------------------%%%---%%%||||||||||||||||||||---|||||||||--||||||||--|||----------------|||--|||%%%%%%%%%%%%%%%%---%%%%%%%%%%%%%F%%%%%%%%%%%%%%%%%%%%%%%%%%%%%%%%%%%%%%%%%%%%%%%%%%%%%%%
%%%%%%%%%%-------%%%--%%%-------|||---|||||||||||||||||||||||---|||||||||--||||||||--|||%%%%%%%%%%%%--%%|||--|||||||||||||||||||---|||||||||||||%|||||||||||||||||||||||||||||||||||||||||||||||||||||||
||||||||||XX---XX|||--|||XX---XX|||---|||||||||||||||||||||||---|||||||||--||||||||--|||||||||||||||--|||||--|||||||||||||||||||---|||||||||||||||||||||||||||||||||||||||||||||||||||||||||||||||||||||
