HEIGHT=16;WIDTH=201;THEME=0;OVERRIDE=false
--------------------------------------------------------------------------------------------------------------------------------------------------------------------------------------------------------
--------------------------------------------------------------------------------------------------------------------------------------------------------------------------------------------------------
--------------------------------------------------------------------------------------------------------------------------------------------------------------------------------------------------------
--------------------------------------------------------------------------------------------------------------------------------------------------------------------------------------------------------
--------------------------------------------------------------------------------------------------------------------------------------------------------------------------------------------------------
--------------------------------------------------------------------------------------------------------------------------------------------------------------------------------------------------------
--------------------------------------------------------------------------------------------------------------------------------------------------------------------------------------------------------
--------------------------------------------------------------------------------------------------------------------------------------------------------------------------------------------------------
--------------------------------------------------------------------------------------------------------------------------------------------------------------------------------------------------------
-------------------------------------------------------------------------------------------SSCCC--------------Tt------------y---------------------------------------------------------------------------
--------------------------------------------------------------------------------------------------------------tt-----------%%%%%------------------------------------------------------------------------
--------------#---#---------------------------------------------------------------SCSCCSS---------------------tt-----------|||||------------------------------------------------------------------------
-------------##---##------------#---#-----------------------------------------------------------k--%%%%%%%%%%%%%%%---------|||||------------------------------------------------------------------------
%%%%%%%%%%%%%%%---%%%%---------##---##------------------------------%%%%%---%%%%%---------%%%%%%%%%|||||||||||||||-----%%%%%%%%%%%----------------------------------------------------------------------
|||||||||||||||---||||%%--%%--###---###--%%%%--%%%%%%%%---%%%%------|||||---|||||---------||||||||||||||||||||||||%%%%%|||||||||||-------%%%%%%%%F%%%%%%%%%%%%%%%%%%%%%%%%%%%%%%%%%%%%%%%%%%%%%%%%%%%%%%
|||||||||||||||---||||||--||XXXXX---XXXXX||||--||||||||---||||XX--XX|||||---|||||XXXXXXXXX||||||||||||||||||||||||||||||||||||||||XX---XX||||||||X||||||||||||||||||||||||||||||||||||||||||||||||||||||
