HEIGHT=16;WIDTH=201;THEME=0;OVERRIDE=false
--------------------------------------------------------------------------------------------------------------------------------------------------------------------------------------------------------
--------------------------------------------------------------------------------------------------------------------------------------------------------------------------------------------------------
--------------------------------------------------------------------------------------------------------------------------------------------------------------------------------------------------------
--------------------------------------------------------------------------------------------------------------------------------------------------------------------------------------------------------
--------------------------------------------------------------------------------------------------------------------------------------------------------------------------------------------------------
--------------------------------------------------------------------------------------------------------------------------------------------------------------------------------------------------------
--------------------------------------------------------------------------------------------------------------------------------------------------------------------------------------------------------
--------------------------------------------------------------------------------------------------------------------------------------------------------------------------------------------------------
--------------------------------------------------------------------------------------------------------------------------------------------------------------------------------------------------------
-----------------------------------------------------------------------------------------------------------------------------------------------%%%------------------------------------------------------
-----------------------------------------------------------------------------------------------------------------------------------------------|||------------------------------------------------------
-----------S2CUSCSS2------------------------------------------------------------------------SCSC-----------------------------------------------|||------------------------------------------------------
-----------------------------------------%%%%%--%%%%%-----------#--#---------------------------------------------------------------------------Y||------------------------------------------------------
-----------------------------------------|||||--|||||---------%%%--%%%%%%%---%%%%----------------------------------------#---#---%%%%%%%%%%%%%%%%%%%%---------------------------------------------------
%%%%%%%%%%--kr-------%%%%---%%%%--#---#--|||||--|||||%%%---%%%|||--|||||||---||||------------------%%%%%---%%%%%--------##---##--||||||||||||||||||||%%%%%%%%F%%%%%%%%%%%%%%%%%%%%%%%%%%%%%%%%%%%%%%%%%%
||||||||||XXXXXXXXXXX||||---||||XXX---XXX|||||--||||||||---||||||--|||||||---||||XXX--XXXXXXXXXXXXX|||||---|||||XXXXXXXXXX---XXXX||||||||||||||||||||||||||||X||||||||||||||||||||||||||||||||||||||||||
