HEIGHT=16;WIDTH=201;THEME=0;OVERRIDE=false
--------------------------------------------------------------------------------------------------------------------------------------------------------------------------------------------------------
--------------------------------------------------------------------------------------------------------------------------------------------------------------------------------------------------------
--------------------------------------------------------------------------------------------------------------------------------------------------------------------------------------------------------
--------------------------------------------------------------------------------------------------------------------------------------------------------------------------------------------------------
--------------------------------------------------------------------------------------------------------------------------------------------------------------------------------------------------------
--------------------------------------------------------------------------------------------------------------------------------------------------------------------------------------------------------
--------------------------------------------------------------------------------------------------------------------------------------------------------------------------------------------------------
--------------------------------------------------------------------------------------------------------------------------------------------------------------------------------------------------------
--------------------------------------------------------------------------------------------------------------------------------------------------------------------------------------------------------
--------------------------------------------------------------------------------------------------------------------SC22SCS------------#---#------------------------------------------------------------
--------------------------------------------------------------------------------------------------------------------------------------##---##-----------------------------------------------------------
-----------------------%%%-----------------------------------------------#---#--------yg---------------------------------------------###---###----------------------------------------------------------
-----------------------|||-r--r----y-----------------------------------%%%---%%%------%%%%-----------%%%%%---%%%%%-----------------%%%%%---%%%%%--------------------------------------------------------
--------------%%%%%%%%%%%%%%%%%%%-%%%%%%----------------%%---%%------%%|||---|||------||||--%%%---%%%|||||---|||||%%%%%%%%%%%%%%%%%|||||---|||||--------------------------------------------------------
--------------|||||||||||||||||||-||||||----------------||---||------|||||---|||----r-g|||--|||---||||||||---|||||||||||||||||||||||||||---|||||%%%%%%%%F%%%%%%%%%%%%%%%%%%%%%%%%%%%%%%%%%%%%%%%%%%%%%%%
XXXXXXXXXXXXXX|||||||||||||||||||XXXXXXXXXXXXXXX---XXXXX||---||XX--XX|||||---|||XXXXXXXXXXXX|||---||||||||---|||||||||||||||||||||||||||---|||||||||||||X|||||||||||||||||||||||||||||||||||||||||||||||
