HEIGHT=16;WIDTH=201;THEME=0;OVERRIDE=false
--------------------------------------------------------------------------------------------------------------------------------------------------------------------------------------------------------
--------------------------------------------------------------------------------------------------------------------------------------------------------------------------------------------------------
--------------------------------------------------------------------------------------------------------------------------------------------------------------------------------------------------------
--------------------------------------------------------------------------------------------------------------------------------------------------------------------------------------------------------
--------------------------------------------------------------------------------------------------------------------------------------------------------------------------------------------------------
--------------------------------------------------------------------------------------------------------------------------------------------------------------------------------------------------------
--------------------------------------------------------------------------------------------------------------------------------------------------------------------------------------------------------
--------------------------------------------------------------------------------------------------------------------------------------------------------------------------------------------------------
---------------------------------------------------S2S--------------------------------------------------------------------------------------------------------------------------------------------------
--------------------------------------------------------------------------------------------------------------------------------------------------------------------------------------------------------
----------------------------g--------------------------------------------------------------------------------------------------------#---#--------------------------------------------------------------
---------------------------%%%----------------------------------SSSSC2--------------------------------------SS-CS-------------------##---##-------------------------------------------------------------
---------------------------|||------------------%%%%%%%-------------------------------------------------------------%%%%%---%%%%%--###---###------------------------------------------------------------
---------------------------|||------%%%---------|||||||----------------%%--%%%%%%%---%%%%%%%%%%--%%%%%%%%-----%-----|||||---|||||%%%%%---%%%%%----------------------------------------------------------
%%%%%%%%%%%%%%%%%%%-k------|||-----g|||------k--|||||||-------------kk-||--|||||||---||||||||||--||||||||----r|-----|||||---||||||||||---|||||%%%%%%%%F%%%%%%%%%%%%%%%%%%%%%%%%%%%%%%%%%%%%%%%%%%%%%%%%%
|||||||||||||||||||XXXXXXXXXXXXXXXXXXXXXXXXXXXXX|||||||XX--XXXXXXXXXXXX||--|||||||---||||||||||--||||||||XXXXXXXXXXX|||||---||||||||||---|||||||||||||X|||||||||||||||||||||||||||||||||||||||||||||||||
