HEIGHT=16;WIDTH=201;THEME=0;OVERRIDE=false
--------------------------------------------------------------------------------------------------------------------------------------------------------------------------------------------------------
--------------------------------------------------------------------------------------------------------------------------------------------------------------------------------------------------------
--------------------------------------------------------------------------------------------------------------------------------------------------------------------------------------------------------
--------------------------------------------------------------------------------------------------------------------------------------------------------------------------------------------------------
--------------------------------------------------------------------------------------------------------------------------------------------------------------------------------------------------------
--------------------------------------------------------------------------------------------------------------------------------------------------------------------------------------------------------
--------------------------------------------------------------------------------------------------------------------------------------------------------------------------------------------------------
--------------------------------------------------------------------------------------------------------------------------------------------------------------------------------------------------------
--------------------------------------------------------------------------------------------------------------------------------------------------------------------------------------------------------
-------------------------------#--#---------------------------------------------------------------------------------------------------------------------------------------------------------------------
------------------------------##--##--------------------------------------------------------------------------------------------------------------------------------------------------------------------
-----------------------------###--###-----------------------------------------------------#---#---------------------------------------------------------------------------------------------------------
-----------%%%-------------%%%%%--%%%%%--------------------%%%%---%%%%-------------------##---##--------------------------------------%%%%---%%%%-------------------------------------------------------
-----------|||-------------|||||--|||||-------%%%%%---%%%%%||||---||||------------------###---###-------%%%%-------%%%%%--%%%%%-------||||---||||-------------------------------------------------------
-----------|||-------------|||||--|||||%%---%%|||||---|||||||||---||||%%%---%%%%%---%%%%%%%---%%%%%-----||||--g-g--|||||--|||||%%---%%||||---||||%%%%%%%%F%%%%%%%%%%%%%%%%%%%%%%%%%%%%%%%%%%%%%%%%%%%%%%
XXXXXXXXXXX|||XXXXX---XXXXX|||||--|||||||---|||||||---|||||||||---|||||||---|||||---|||||||---|||||XXXXXXXXXXXXXXXX|||||--|||||||---||||||---||||||||||||X||||||||||||||||||||||||||||||||||||||||||||||
