HEIGHT=16;WIDTH=201;THEME=0;OVERRIDE=false
--------------------------------------------------------------------------------------------------------------------------------------------------------------------------------------------------------
--------------------------------------------------------------------------------------------------------------------------------------------------------------------------------------------------------
--------------------------------------------------------------------------------------------------------------------------------------------------------------------------------------------------------
--------------------------------------------------------------------------------------------------------------------------------------------------------------------------------------------------------
--------------------------------------------------------------------------------------------------------------------------------------------------------------------------------------------------------
--------------------------------------------------------------------------------------------------------------------------------------------------------------------------------------------------------
--------------------------------------------------------------------------------------------------------------------------------------------------------------------------------------------------------
--------------------------------------------------------------------------------------------------------------------------------------------------------------------------------------------------------
--------------------------------------------------------------------------------------------------------------------------------------------------------------------------------------------------------
--------------------------------------------------------------------------------------------------------------------------------------------------------------------------------------------------------
----------------tt--------------------------------------------------------------------------------------------------------------------------------------------------------------------------------------
----------------tt-Tt----------#---#-------------------------------------------------------------------------------g----------------#--#----------------------------------------------------------------
----------------tt-tt---------##---##-----#---#-------------------------------------------------------------------%%%%%%%----------##--##---------------------------------------------------------------
-------------%%%%%%%%%%%%%%--###---###--%%%---%%%------%%%%%---%%%%%%%%---%%%%%---%%----------------------#---#---|||||||%%%--%%%%%%%--%%%%%%%%%%%%F%%%%%%%%%%%%%%%%%%%%%%%%%%%%%%%%%%%%%%%%%%%%%%%%%%%%
-------------||||||||||||||%%%%%---%%%%%|||---|||%%--%%|||||---||||||||---|||||---||------------%%---%%--##---##--||||||||||--|||||||--||||||||||||%||||||||||||||||||||||||||||||||||||||||||||||||||||
XXXXXXXXXXXXX|||||||||||||||||||---||||||||---|||||--|||||||---||||||||---|||||---||XXXXX--XXXXX||---||XXXX---XXXX||||||||||--|||||||--|||||||||||||||||||||||||||||||||||||||||||||||||||||||||||||||||
