HEIGHT=16;WIDTH=201;THEME=0;OVERRIDE=false
--------------------------------------------------------------------------------------------------------------------------------------------------------------------------------------------------------
--------------------------------------------------------------------------------------------------------------------------------------------------------------------------------------------------------
--------------------------------------------------------------------------------------------------------------------------------------------------------------------------------------------------------
--------------------------------------------------------------------------------------------------------------------------------------------------------------------------------------------------------
--------------------------------------------------------------------------------------------------------------------------------------------------------------------------------------------------------
---------------------------------------------------------------------------------------------------------------------------G----------------------------------------------------------------------------
--------------------------------------------------------------------------------------------------g-----------------------%%%%--------------------------------------------------------------------------
------------------------------------------------------------------------------------------------%%%-----------------------||||--------------------------------------------------------------------------
-------------------------------------------------------CSSU-------------------------------------|||---------------------r-y|||--------------------------------------------------------------------------
------------------------------------------------------------------------%%%%%----------------%%%%%|--------------------%%%%%||--------------------------------------------------------------------------
----------------------kr------------------------------------------------|||||----------------||||||--------------------|||||||--------------------------------------------------------------------------
---------------------%%%%%--------------------------------r-------------|||||----------------||||||--------------------|||||||--------------------------------------------------------------------------
---------------------|||||-----%%%--%%%%%%%%%--------%%%%%%%%%----------||%%%%%%-----gr--k---||||r|-g------------------||g||||----y----y-%%%%%%%%F%%%%%%%%%%%%%%%%%%%%%%%%%%%%%%%%%%%%%%%%%%%%%%%%%%%%%%
----------%%---%%%%%%%%%%%%%%%%|||--|||||||||%%%--%%%|||||||||%%--%%---y|||r||||---%%%%%%%%%%%%%%%%%%%%%--%%---%%---%%%%%%%%%%%%%%%%%%%%%||||||||%||||||||||||||||||||||||||||||||||||||||||||||||||||||
%%%%%%%%%%||---|||||||||||||||||||--||||||||||||--||||||||||||||--||%%%%%%%%%%%%%%%|||||||||||||||||||||--||---||---||||||||||||||||||||||||||||||||||||||||||||||||||||||||||||||||||||||||||||||||||||
||||||||||||---|||||||||||||||||||--||||||||||||--||||||||||||||--||||||||||||||||||||||||||||||||||||||--||XXX||---||||||||||||||||||||||||||||||||||||||||||||||||||||||||||||||||||||||||||||||||||||
