HEIGHT=16;WIDTH=201;THEME=0;OVERRIDE=false
--------------------------------------------------------------------------------------------------------------------------------------------------------------------------------------------------------
--------------------------------------------------------------------------------------------------------------------------------------------------------------------------------------------------------
--------------------------------------------------------------------------------------------------------------------------------------------------------------------------------------------------------
--------------------------------------------------------------------------------------------------------------------------------------------------------------------------------------------------------
--------------------------------------------------------------------------------------------------------------------------------------------------------------------------------------------------------
--------------------------------------------------------------------------------------------------------------------------------------------------------------------------------------------------------
--------------------------------------------------------------------------------------------------------------------------------------------------------------------------------------------------------
--------------------------------------------------------------------------------------------------------------------------------------------------------------------------------------------------------
--------------------------------------------------------------------------------------------------------------------------------------------------------------------------------------------------------
---------------------------------------------------------------%%%%%%%----------------------------------------------------------------%%%---------------------------------------------------------------
---------------------------------------------------------------|||||||----------------------------------------------------------------|||---------------------------------------------------------------
---------------------------------------------------------------|||||||---------------------------------------#--#--------------------r|||---------------------------------------------------------------
%%%%%%%%%%%%%%---%%--------Tt----------------------------------|||||||---------------------------%%%---%%%--##--##------------------%%%%%%%-------%%%%%%%%F%%%%%%%%%%%%%%%%%%%%%%%%%%%%%%%%%%%%%%%%%%%%%
||||||||||||||---||--Tt----tt-----------------%%%%--%%%%%%--%%%%%%%%%%%%%%%%%--------------------|||---|||%%%%--%%%%----------------||G|||r-------||||||||%|||||||||||||||||||||||||||||||||||||||||||||
||||||||||||||---||--tt----tt-------%%%%--%%%%||||--||||||--|||||||||||||||||--------------------|||---|||||||--||||------------%%%%%%%%%%%%%%%%%%||||||||||||||||||||||||||||||||||||||||||||||||||||||
||||||||||||||---||XXXXXXXXXXXXX--XX||||--||||||||--||||||--|||||||||||||||||XX---XXXXXXX---XXXXX|||---|||||||--||||XXX--XXXXXXX||||||||||||||||||||||||||||||||||||||||||||||||||||||||||||||||||||||||
