HEIGHT=16;WIDTH=201;THEME=0;OVERRIDE=false
--------------------------------------------------------------------------------------------------------------------------------------------------------------------------------------------------------
--------------------------------------------------------------------------------------------------------------------------------------------------------------------------------------------------------
--------------------------------------------------------------------------------------------------------------------------------------------------------------------------------------------------------
--------------------------------------------------------------------------------------------------------------------------------------------------------------------------------------------------------
--------------------------------------------------------------------------------------------------------------------------------------------------------------------------------------------------------
--------------------------------------------------------------------------------------------------------------------------------------------------------------------------------------------------------
--------------------------------------------------------------------------------------------------------------------------------------------------------------------------------------------------------
--------------------------------------------------------------------------------------------------------------------------------------------------------------------------------------------------------
------------------------------------------------UCU2C---SSSSS--------------------------------------------------------------SS---------------------------------------------------------------------------
--------------------------------------------------------------------------------------------------------------------------------------------------------------------------------------------------------
-----------------------------------------------%------------------------------------------#---#------------------------------|--------------------------------------------------------------------------
-----------------------------------------------|------------r----------------------------##---##-----------------------------g--------------------------------------------------------------------------
--------------%%%%%---%%%%%-------------------%%%%%%%%%%%%%%%%%------------------------%%%%---%%%%----------------------%%%%%%%-------------------------------------------------------------------------
--------------|||||---|||||-------------%%--%%|||||||||||||||||---#---#----------------||||---||||%%%%---%%%%-----------|||||||%%---%%%%%%%%%-----------------------------------------------------------
%%%%%%%%%%%%%%|||||---|||||%%%%%---%%%%%||--|||||||||||||||||||--##---##--%%---%%------||||---||||||||---||||-----------|||||||||---|||||||||%%%%%%%%F%%%%%%%%%%%%%%%%%%%%%%%%%%%%%%%%%%%%%%%%%%%%%%%%%%
|||||||||||||||||||---||||||||||---|||||||--|||||||||||||||||||XXXX---XXXX||---||XX--XX||||---||||||||---||||XXXX---XXXX|||||||||---|||||||||||||||||X||||||||||||||||||||||||||||||||||||||||||||||||||
