HEIGHT=16;WIDTH=201;THEME=0;OVERRIDE=false
--------------------------------------------------------------------------------------------------------------------------------------------------------------------------------------------------------
--------------------------------------------------------------------------------------------------------------------------------------------------------------------------------------------------------
--------------------------------------------------------------------------------------------------------------------------------------------------------------------------------------------------------
--------------------------------------------------------------------------------------------------------------------------------------------------------------------------------------------------------
--------------------------------------------------------------------------------------------------------------------------------------------------------------------------------------------------------
--------------------------------------------------------------------------------------------------------------------------------------------------------------------------------------------------------
--------------------------------------------------------------------------------------------------------------------------------------------------------------------------------------------------------
--------------------------------------------------------------------------------------------------------------------------------------------------------------------------------------------------------
-----------------------%%%------------------------------------------------------------------------------------------------------------------------------------------------------------------------------
-----------------------|||---------------------------------------------------------------------------SUCSS----------------tt----------------------------------------------------------------------------
-----------------------|||-------------------#--#-----SSC-----------------------------------------------------------------tt----------------------------------------------------------------------------
--------------g--------|||------------------##--##--------------------------------------------------------%---------------tt----------------------------------------------------------------------------
------------%%%%%%%%%%%%%%%%---------------###--###----------------%%%%%----------------------------------|--%%%------%%%%%%%%%%-----------%%%%%%%%F%%%%%%%%%%%%%%%%%%%%%%%%%%%%%%%%%%%%%%%%%%%%%%%%%%%%
------------||||||||||||||||-------------%%%%%--%%%%%--------------|||||-----------%%%---%%%----y---%%%%%%%%%|||%%--%%||||||||||%%%%%%%%%%%||||||||%||||||||||||||||||||||||||||||||||||||||||||||||||||
%%%%%%%%%%%%||||||||||||||||-------------|||||--|||||%%%%%%%-------|||||-----------|||---|||%%%%%%%%||||||||||||||--||||||||||||||||||||||||||||||||||||||||||||||||||||||||||||||||||||||||||||||||||||
||||||||||||||||||||||||||||XXXXX---XXXXX|||||--||||||||||||XX---XX|||||XXXX---XXXX|||---|||||||||||||||||||||||||--||||||||||||||||||||||||||||||||||||||||||||||||||||||||||||||||||||||||||||||||||||
