HEIGHT=16;WIDTH=201;THEME=0;OVERRIDE=false
--------------------------------------------------------------------------------------------------------------------------------------------------------------------------------------------------------
--------------------------------------------------------------------------------------------------------------------------------------------------------------------------------------------------------
--------------------------------------------------------------------------------------------------------------------------------------------------------------------------------------------------------
--------------------------------------------------------------------------------------------------------------------------------------------------------------------------------------------------------
--------------------------------------------------------------------------------------------------------------------------------------------------------------------------------------------------------
--------------------------------------------------------------------------------------------------------------------------------------------------------------------------------------------------------
--------------------------------------------------------------------------------------------------------------------------------------------------------------------------------------------------------
--------------------------------------------------------------------------------------------------------------------------------------------------------------------------------------------------------
-------------------------------------SS2US-----SSS------------------------------------------------------------------------------------------------------------------------------------------------------
--------------------------------------------------------------------------------------------------------------------------------------------------------------------------------------------------------
----------------------------------------------%-----------------Tt-------------------------------------------------------------------%%%----------------------------------------------------------------
----------------------------------------------|-----------------tt----------------------------------------------Tt------#--#---------|||----------------------------------------------------------------
%%%%%%%%%%%%%%%%--%%%%%-----------%%%%%%%%%%%%%%%%%%---#---#---%%%%%%%%%%---------------------------------------tt-----##--##-----gkk|||----------------------------------------------------------------
||||||||||||||||--|||||-----------||||||||||||||||||--##---##--||||||||||--------------------------------------%%%%%%%%%%--%%%%%%%%%%%%%%%%%%%%---------------------------------------------------------
||||||||||||||||--|||||-----------||||||||||||||||||%%%%---%%%%||||||||||------------%%%%---%%%%%%%%---%%%%----||||||||||--||||||||||||||||||||%%%%%%%%F%%%%%%%%%%%%%%%%%%%%%%%%%%%%%%%%%%%%%%%%%%%%%%%%
||||||||||||||||--|||||XXXX---XXXX||||||||||||||||||||||---||||||||||||||XXXXX--XXXXX||||---||||||||---||||XXXX||||||||||--||||||||||||||||||||||||||||X||||||||||||||||||||||||||||||||||||||||||||||||
