HEIGHT=16;WIDTH=201;THEME=0;OVERRIDE=false
--------------------------------------------------------------------------------------------------------------------------------------------------------------------------------------------------------
--------------------------------------------------------------------------------------------------------------------------------------------------------------------------------------------------------
--------------------------------------------------------------------------------------------------------------------------------------------------------------------------------------------------------
--------------------------------------------------------------------------------------------------------------------------------------------------------------------------------------------------------
--------------------------------------------------------------------------------------------------------------------------------------------------------------------------------------------------------
--------------------------------------------------------------------------------------------------------------------------------------------------------------------------------------------------------
--------------------------------------------------------------------------------------------------------------------------------------------------------------------------------------------------------
--------------------------------------------------------------------------------------------------------------------------------------------------------------------------------------------------------
--------------------------------------------------------------------------------------------------------------------------------------------------------------------------------------------------------
--------------------------------------------------------------------------------------------------------------------------------------------------------------------------------------------------------
---------------------------------------------------------------------------------------------------------#---#------------------------------------------------------------------------------------------
------------------%%%%%-----------------------------------------#--#------------------------------------##---##-----------------------------------------------------------------------------------------
------------------|||||-----%%%%%%%%%%%%%%--%%%%%--------------##--##--------------%%%%---%%%%---------###---###-----------%%%--------------------------------------------------------------------------
%%%%%%%%%%%%%-r-yy|||||g----||||||||||||||--|||||-------------###--###-------------||||---||||%%---%%%%%%%---%%%%%---------|||-----#--#---%%%%%%%%F%%%%%%%%%%%%%%%%%%%%%%%%%%%%%%%%%%%%%%%%%%%%%%%%%%%%%
|||||||||||||%%%%%%%%%%%%%%%||||||||||||||--|||||-----------%%%%%--%%%%%%%%%---%%%%||||---||||||---|||||||---|||||%%%%%%%%%%%%%%--##--##--||||||||%|||||||||||||||||||||||||||||||||||||||||||||||||||||
||||||||||||||||||||||||||||||||||||||||||--|||||XXXX---XXXX|||||--|||||||||---||||||||---||||||---|||||||---|||||||||||||||||||XXXX--XXXX||||||||||||||||||||||||||||||||||||||||||||||||||||||||||||||
