HEIGHT=16;WIDTH=201;THEME=0;OVERRIDE=false
--------------------------------------------------------------------------------------------------------------------------------------------------------------------------------------------------------
--------------------------------------------------------------------------------------------------------------------------------------------------------------------------------------------------------
--------------------------------------------------------------------------------------------------------------------------------------------------------------------------------------------------------
--------------------------------------------------------------------------------------------------------------------------------------------------------------------------------------------------------
--------------------------------------------------------------------------------------------------------------------------------------------------------------------------------------------------------
--------------------------------------------------------------------------------------------------------------------------------------------------------------------------------------------------------
--------------------------------------------------------------------------------------------------------------------------------------------------------------------------------------------------------
--------------------------------------------------------------------------------------------------------------------------------------------------------------------------------------------------------
--------------------------------------------------------------------------------------------------------------------------------------------------------------------------------------------------------
-------------------------------------k----------------------------------------------------------------------SCS2----------------------------------------------------------------------------------------
-----------------------------------%%%------------------------------------------------------------------------------------------------------------------------------------------------------------------
-----------------------------------|g|-------------------------------------------------------------#---#------------------------------------------------------------------------------------------------
---------------------------------%%%%|---------%%%%%--%%%%%------------------%%%%-----------------##---##--------g--------------------------------------------------------------------------------------
---------------------------------|||||--%%---%%|||||--|||||------------------||||-------%%%%%%%%%%%%---%%%%%%%%%%%%%-----%%%-------%%%--%%%-------------------------------------------------------------
-------------%%%---%%%%%---%%%%%%%%%%%%%||---|||||||--|||||----%%%%%---%%%%%%%%%%%%%%%%%||||||||||||---|||||||||||||-y--k||g-K-y---|||--|||-------------------------------------------------------------
XXXXXXXXXXXXX|||---|||||---|||||||||||||||---|||||||--|||||XXXX|||||---|||||||||||||||||||||||||||||---|||||||||||||XXXXXXXXXXXXXXX|||--|||XXXXXXXXFXXXXXXXXXXXXXXXXXXXXXXXXXXXXXXXXXXXXXXXXXXXXXXXXXXXX
