HEIGHT=16;WIDTH=201;THEME=0;OVERRIDE=false
--------------------------------------------------------------------------------------------------------------------------------------------------------------------------------------------------------
--------------------------------------------------------------------------------------------------------------------------------------------------------------------------------------------------------
--------------------------------------------------------------------------------------------------------------------------------------------------------------------------------------------------------
--------------------------------------------------------------------------------------------------------------------------------------------------------------------------------------------------------
--------------------------------------------------------------------------------------------------------------------------------------------------------------------------------------------------------
--------------------------------------------------------------------------------------------------------------------------------------------------------------------------------------------------------
--------------------------------------------------------------------------------------------------------------------------------------------------------------------------------------------------------
--------------------------------------------------------------------------------------------------------------------------------------------------------------------------------------------------------
--------------------------------------------------------------------------------------------------------------------------------------------------------------------------------------------------------
---------------------------SSS--------------------------------------------------------------------------------------------------------------------------------------------------------------------------
--------------------------------------------------------------------------k-----------------------------------------------------------------------------------------------------------------------------
-------------------------------------Tt---Tt------------------------------%%%------------------tt-tt---------------------------Tt-----------------------------------------------------------------------
%%%%%%%%%%%--------------------------tt---tt--------------%%--%%----------|||------------------tt-tt---------------------------tt-----------------------------------------------------------------------
|||||||||||-------------%%%%%%%%%----tt---tt------#---#---||--||----------|||------------------tt-tt----------------%%---%%----tt-----------------------------------------------------------------------
|||||||||||-------------|||||||||%%%%%%%%%%%%%%--##---##--||--||%%%%%%%%%%%%%%%%%%%%---%%%%%%%%%%%%%%%%%%%%%---%%%%%||---||%%%%%%%%---------%%%%%%%%F%%%%%%%%%%%%%%%%%%%%%%%%%%%%%%%%%%%%%%%%%%%%%%%%%%%
|||||||||||XXXXX---XXXXX|||||||||||||||||||||||XXXX---XXXX||--||||||||||||||||||||||---|||||||||||||||||||||---|||||||---||||||||||XXX---XXX||||||||X|||||||||||||||||||||||||||||||||||||||||||||||||||
