HEIGHT=16;WIDTH=201;THEME=0;OVERRIDE=false
--------------------------------------------------------------------------------------------------------------------------------------------------------------------------------------------------------
--------------------------------------------------------------------------------------------------------------------------------------------------------------------------------------------------------
--------------------------------------------------------------------------------------------------------------------------------------------------------------------------------------------------------
--------------------------------------------------------------------------------------------------------------------------------------------------------------------------------------------------------
--------------------------------------------------------------------------------------------------------------------------------------------------------------------------------------------------------
--------------------------------------------------------------------------------------------------------------------------------------------------------------------------------------------------------
--------------------------------------------------------------------------------------------------------------------------------------------------------------------------------------------------------
--------------------------------------------------------------------------------------------------------------------------------------------------------------------------------------------------------
-------------------------------------SCCS----------------------2CC----------------------%%%%%--------------------------------------2CCSUS---------------------------------------------------------------
----------------------------------------------------------------------------------------|||||-----------------------------------------------------------------------------------------------------------
----------------------------------------------------------------------------------------|||||---tt------------------------------------------------------------------------------------------------------
---------------------------y--------------------------------------------------------k---||r||---tt---tt-Tt----------------------------------------------------------------------------------------------
-------------------------%%%%%%%--%%%%%%%%------------------%%%%%%%%%-------%%%%%%%%%%%%%%%%%%%-tt---tt-tt----------------%%--%%%%%%%%%%%%%%%%%%%%F%%%%%%%%%%%%%%%%%%%%%%%%%%%%%%%%%%%%%%%%%%%%%%%%%%%%%
-------------------------|||||||--||||||||------%%%%%--%%%%%|||||||||-------|||||||||||||||||||%%%%%%%%%%%%%------%%%%%%%%||--||||||||||||||||||||%|||||||||||||||||||||||||||||||||||||||||||||||||||||
%%%%%%%%%%%--------------||g|||g--||||||||------|||||--||||||||||||||%%---%%||||||||||||||||||||||||||||||||------||||||||||--||||||||||||||||||||||||||||||||||||||||||||||||||||||||||||||||||||||||||
|||||||||||XXXX---XXXXXXXXXXXXXXXX||||||||XX--XX|||||--||||||||||||||||---||||||||||||||||||||||||||||||||||XX--XX||||||||||--||||||||||||||||||||||||||||||||||||||||||||||||||||||||||||||||||||||||||
