HEIGHT=16;WIDTH=201;THEME=0;OVERRIDE=false
--------------------------------------------------------------------------------------------------------------------------------------------------------------------------------------------------------
--------------------------------------------------------------------------------------------------------------------------------------------------------------------------------------------------------
--------------------------------------------------------------------------------------------------------------------------------------------------------------------------------------------------------
--------------------------------------------------------------------------------------------------------------------------------------------------------------------------------------------------------
--------------------------------------------------------------------------------------------------------------------------------------------------------------------------------------------------------
--------------------------------------------------------------------------------------------------------------------------------------------------------------------------------------------------------
--------------------------------------------------------------------------------------------------------------------------------------------------------------------------------------------------------
------------------------------------------------------%%%%%%--------------------------------------------------------------------------------------------------------------------------------------------
------------------------------------------------------|||y||--------------------------------------------------------------------------------------------------------------------------------------------
------------------------------------------------------|%%%%%%%---------------------------------------#--#-----------------------------------------------------------------------------------------------
------------------------------------------------------||||||||--------------------------------------##--##----------------------------------------------------------------------------------------------
------------------------------------------------------||||||||-------------------------------------###--###-------------------------CS2-----------------------------------------------------------------
%%%%%%%%%%%------------------------------------------r||||||||-----------------------------------%%%%%--%%%%%-------------------------------------------------------------------------------------------
|||||||||||-------------%%%%%%---------%%%%---%%%%%%%%%%%%%%%%%%--------------------------%%---%%|||||--|||||--------------%%---%%------%%%%%%%%F%%%%%%%%%%%%%%%%%%%%%%%%%%%%%%%%%%%%%%%%%%%%%%%%%%%%%%%
|||||||||||%%%%%---%%%%%||||||---------||||---||||||||||||||||||--------%%%---%%%%%%%%%%%%||---|||||||--|||||--------%%--%%||---||------||||||||%|||||||||||||||||||||||||||||||||||||||||||||||||||||||
||||||||||||||||---|||||||||||XXXXXXXXX||||---||||||||||||||||||XXXXXXXX|||---||||||||||||||---|||||||--|||||XXX--XXX||--||||---||XXXXXX||||||||||||||||||||||||||||||||||||||||||||||||||||||||||||||||
