HEIGHT=16;WIDTH=201;THEME=0;OVERRIDE=false
--------------------------------------------------------------------------------------------------------------------------------------------------------------------------------------------------------
--------------------------------------------------------------------------------------------------------------------------------------------------------------------------------------------------------
--------------------------------------------------------------------------------------------------------------------------------------------------------------------------------------------------------
--------------------------------------------------------------------------------------------------------------------------------------------------------------------------------------------------------
--------------------------------------------------------------------------------------------------------------------------------------------------------------------------------------------------------
--------------------------------------------------------------------------------------------------------------------------------------------------------------------------------------------------------
--------------------------------------------------------------------------------------------------------------------------------------------------------------------------------------------------------
--------------------------------------------------------------------------------------------------------------------------------------------------------------------------------------------------------
---------------------------------------------------------------------SSS--------------------------------------------------------------------------------------------------------------------------------
--------------------------------------------------------------------------------------------------------------------------------------------------------------------------------------------------------
-----------------#--#----------------------#--#---------------------------------------------------------------------------------------------------------------------------------------------------------
----------------##--##--------------------##--##--------------------------------------------------------------------------------------------------------------------------------------------------------
--------------%%%%--%%%%-----------------###--###--------%%%%%%%%%%%%%%%%%%%--%%------------------------------%%---%%-----------------------------------------------------------------------------------
--------------||||--||||---------------%%%%%--%%%%%------|||||||||||||||||||--||---------%%%%--%%%%%%%%---%%%%||---||---------%%%%--%%%%%%%%%%%%F%%%%%%%%%%%%%%%%%%%%%%%%%%%%%%%%%%%%%%%%%%%%%%%%%%%%%%%
%%%%%%%%%%%%%%||||--||||%%--%%---------|||||--|||||%%--%%|||||||||||||||||||--||---------||||--||||||||---||||||---||---------||||--||||||||||||%|||||||||||||||||||||||||||||||||||||||||||||||||||||||
||||||||||||||||||--||||||--||XXX---XXX|||||--|||||||--|||||||||||||||||||||--||XXX---XXX||||--||||||||---||||||---||XXX---XXX||||--||||||||||||||||||||||||||||||||||||||||||||||||||||||||||||||||||||
