HEIGHT=16;WIDTH=201;THEME=0;OVERRIDE=false
--------------------------------------------------------------------------------------------------------------------------------------------------------------------------------------------------------
--------------------------------------------------------------------------------------------------------------------------------------------------------------------------------------------------------
--------------------------------------------------------------------------------------------------------------------------------------------------------------------------------------------------------
--------------------------------------------------------------------------------------------------------------------------------------------------------------------------------------------------------
--------------------------------------------------------------------------------------------------------------------------------------------------------------------------------------------------------
--------------------------------------------------------------------------------------------------------------------------------------------------------------------------------------------------------
-------------------------------------------%%%%%%-------------------------------------------------------------------------------------------------------------------------------------------------------
-------------------------------------------||||||-------------------------------------------------------------------------------------------------------------------------------------------------------
-----------------C-S-----------------------||||||------------------------------------------------------------SCSS---------------------------------------------------------------------------------------
-------------------------------------------|||%%%%%%%--------------------------------------r------------------------------------------------------------------------------------------------------------
------------------%--------------g---------||||||||||--------------------------------%%%%%%%------------------------------------------------------------------------------------------------------------
------------------|--------------%%%-------||||||g|||-G---tt---tt--------------------|||||||------------------g-----------------------------------------------------------------------------------------
%%%%%%%%%%%%%%%%%%%%%%-----------|||-----%%%%%%%%%%%%%%%%-tt---tt---------%%%%--%%%%%%%%%%%%%%--------------%%%%%%----------------------Tt--------------------------------------------------------------
||||||||||||||||||||||%%--%%-----|||-----||||||||||||||||%%%%%%%%%%%%%----||||--||||||||||||||------%%%--%%%||||||%%%---%%%%%---%%--tt--tt--------------------------------------------------------------
||||||||||||||||||||||||--||----r|||--g--|||||||||||||||||||||||||||||----||||--||||||||||||||--g-r-|||--||||||||||||---|||||---||--tt--tt--%%%%%%%%F%%%%%%%%%%%%%%%%%%%%%%%%%%%%%%%%%%%%%%%%%%%%%%%%%%%
||||||||||||||||||||||||--||XXXXXXXXXXXXX|||||||||||||||||||||||||||||XXXX||||--||||||||||||||XXXXXX|||--||||||||||||---|||||---||XXXXXXXXXX||||||||X|||||||||||||||||||||||||||||||||||||||||||||||||||
