HEIGHT=16;WIDTH=201;THEME=0;OVERRIDE=false
--------------------------------------------------------------------------------------------------------------------------------------------------------------------------------------------------------
--------------------------------------------------------------------------------------------------------------------------------------------------------------------------------------------------------
--------------------------------------------------------------------------------------------------------------------------------------------------------------------------------------------------------
--------------------------------------------------------------------------------------------------------------------------------------------------------------------------------------------------------
--------------------------------------------------------------------------------------------------------------------------------------------------------------------------------------------------------
--------------------------------------------------------------------------------------------------------------------------------------------------------------------------------------------------------
--------------------------------------------------------------------------------------------------------------------------------------------------------------------------------------------------------
--------------------------------------------------------------------------------------------------------------------------------------------------------------------------------------------------------
-------------------------------------------------------------------------------------------------------------------------------SCSS---------------------------------------------------------------------
--------------------------------------------------------------------------------------------------------------------------------------------------------------------------------------------------------
--------------------------------------------------------------------------------------------------------------------#---#-------------------------------------------------------------------------------
--------------------%%%--------------------------------------------------------------------------------------------##---##----g-------------------------------------------------------------------------
%%%%%%%%%%--------K-|||--%%%%--------------------%%%--%%%%%--%%------------#--#-----------------------------------###---###--%%%%%%%%%%%%%--%%%---------------------------------------------------------
||||||||||-------%%%%||--||||%%%---%%%%%%%---%%%%|||--|||||--||----------%%%--%%%%%%%%%-----------------%%%--%%%%%%%%---%%%%%|||||||||||||--|||%%%%%%%%F%%%%%%%%%%%%%%%%%%%%%%%%%%%%%%%%%%%%%%%%%%%%%%%%
||||||||||-------||||||y-|||||||---|||||||---|||||||--|||||--||----------|||--|||||||||%%%%%--%%%%%-----|||--||||||||---||||||||||||||||||--|||||||||||%||||||||||||||||||||||||||||||||||||||||||||||||
||||||||||XXXXXXXXXXXXXXX|||||||---|||||||---|||||||--|||||--||XXXX--XXXX|||--||||||||||||||--|||||XXXXX|||--||||||||---||||||||||||||||||--||||||||||||||||||||||||||||||||||||||||||||||||||||||||||||
