HEIGHT=16;WIDTH=201;THEME=0;OVERRIDE=false
--------------------------------------------------------------------------------------------------------------------------------------------------------------------------------------------------------
--------------------------------------------------------------------------------------------------------------------------------------------------------------------------------------------------------
--------------------------------------------------------------------------------------------------------------------------------------------------------------------------------------------------------
--------------------------------------------------------------------------------------------------------------------------------------------------------------------------------------------------------
--------------------------------------------------------------------------------------------------------------------------------------------------------------------------------------------------------
--------------------------------------------------------------------------------------------------------------------------------------------------------------------------------------------------------
--------------------------------------------------------------------------------------------------------------------------------------------------------------------------------------------------------
--------------------------------------------------------------------------------------------------------------------------------------------------------------------------------------------------------
--------------------------------------------------------------------------------------------------------------SSSS--------------------------------------------------------------------------------------
--------------------------------------------------------------------------------------------------------------------------------------------------------------------------------------------------------
--------------------------------------------------------------------------------------------------------------------------------------------------------------------------------------------------------
--------------------------------------------------------------------------------------------------------------------------------------------------------------------------------------------------------
%%%%%%%%%%%%%%%%---%%%%%---------tt-Tt----tt------------------------------------------------------#--#------%%%%%%%%%%%----------#---#------------------------------------------------------------------
||||||||||||||||---|||||---------tt-tt----tt--------------------------------%%%%--%%%%%%%--%%%---##--##---%%|||||||||||---------##---##--%%%%%%%%F%%%%%%%%%%%%%%%%%%%%%%%%%%%%%%%%%%%%%%%%%%%%%%%%%%%%%%
||||||||||||||||---|||||%%%--%%%%%%%%%%%%%%%%%--------%%%%%--%%%%%----------||||--|||||||--|||--###--###--|||||||||||||-------%%%%---%%%%||||||||%||||||||||||||||||||||||||||||||||||||||||||||||||||||
||||||||||||||||---||||||||--|||||||||||||||||XXX--XXX|||||--|||||XXXXXXXXXX||||--|||||||--|||XXXXX--XXXXX|||||||||||||XXXXXXX||||---|||||||||||||||||||||||||||||||||||||||||||||||||||||||||||||||||||
