HEIGHT=16;WIDTH=201;THEME=0;OVERRIDE=false
--------------------------------------------------------------------------------------------------------------------------------------------------------------------------------------------------------
--------------------------------------------------------------------------------------------------------------------------------------------------------------------------------------------------------
--------------------------------------------------------------------------------------------------------------------------------------------------------------------------------------------------------
--------------------------------------------------------------------------------------------------------------------------------------------------------------------------------------------------------
--------------------------------------------------------------------------------------------------------------------------------------------------------------------------------------------------------
--------------------------------------------------------------------------------------------------------------------------------------------------------------------------------------------------------
--------------------------------------------------------------------------------------------------------------------------------------------------------------------------------------------------------
--------------------------------------------------------------------------------------------------------------------------------------------------------------------------------------------------------
--------------------------------------------------------------------------------------------------------------------------------------------------------------------------------------------------------
----------------------------------------------------------------------------------------k-r-r-----------------------------------------------------------------------------------------------------------
-----------------------------------------------------#---#------------------------------%%%%%%----------------------------------------------------------------------------------------------------------
----------------------------------------------------##---##-----------------------------||||||--------SSSS-----------------------------K----------------------------------------------------------------
%%%%%%%%%%%%%------------------------------#--#---%%%%---%%%%---------------------------||||||------------------------------------%%%%%%----------------------------------------------------------------
|||||||||||||%%%%--%%%%------Tt----Tt-----##--##--||||---||||-y---r-------------------g-|||||k--gg------------%%%%%%%%%%%%---%%%--||||||--%%%%%%%%F%%%%%%%%%%%%%%%%%%%%%%%%%%%%%%%%%%%%%%%%%%%%%%%%%%%%%
|||||||||||||||||--||||------tt----tt---%%%%--%%%%||||---||||%%%%%%%%%%-------------%%%%%%%%%%%%%%%%--g-------||||||||||||---|||--||||||--||||||||%|||||||||||||||||||||||||||||||||||||||||||||||||||||
|||||||||||||||||--||||XXXXXXXXXXXXXXXXX||||--||||||||---||||||||||||||XXXXX---XXXXX||||||||||||||||XXXXXXXXXX||||||||||||---|||XXXXXXXXXX||||||||||||||||||||||||||||||||||||||||||||||||||||||||||||||
