HEIGHT=16;WIDTH=201;THEME=0;OVERRIDE=false
--------------------------------------------------------------------------------------------------------------------------------------------------------------------------------------------------------
--------------------------------------------------------------------------------------------------------------------------------------------------------------------------------------------------------
--------------------------------------------------------------------------------------------------------------------------------------------------------------------------------------------------------
--------------------------------------------------------------------------------------------------------------------------------------------------------------------------------------------------------
--------------------------------------------------------------------------------------------------------------------------------------------------------------------------------------------------------
--------------------------------------------------------------------------------------------------------------------------------------------------------------------------------------------------------
--------------------------------------------------------------------------------------------------------------------------------------------------------------------------------------------------------
--------------------------------------------------------------------------------------------------------------------------------------------------------------------------------------------------------
--------------------------------------------------------------------------------------------------------------------------------------------------------------------------------------------------------
---------------------------------------------------------------------SSSSUUCS----------------Tt---------------------------------------------------------------------------------------------------------
-----------------------------------------#--#------------------------------------------------tt---------------------------------------------------------------------------------------------------------
-------------Tt--tt---------------------##--##-----------------------------------------------tt---------------------------------------------------------------------------------------------------------
-------------tt--tt-tt-----------------###--###--%%%%%---%%%%%--------g------------------%%%%%%%%%%%----------%%--%%------------------------------------------------------------------------------------
-------------tt--tt-tt---------------%%%%%--%%%%%|||||---|||||------%%%%%%%%%%%%%%%--%%%%|||||||||||----------||--||---------------------%%%%%%%%F%%%%%%%%%%%%%%%%%%%%%%%%%%%%%%%%%%%%%%%%%%%%%%%%%%%%%%
------------%%%%%%%%%%%%%%%%%%--%%%%%|||||--||||||||||---|||||%%--%%|||||||||||||||--|||||||||||||||%%%%%--%%%||--||%%%---%%%%%%%%--%%%%%||||||||%||||||||||||||||||||||||||||||||||||||||||||||||||||||
XXXXXXXXXXXX||||||||||||||||||--||||||||||--||||||||||---|||||||--|||||||||||||||||--||||||||||||||||||||--|||||--|||||---||||||||--||||||||||||||||||||||||||||||||||||||||||||||||||||||||||||||||||||
