HEIGHT=16;WIDTH=201;THEME=0;OVERRIDE=false
--------------------------------------------------------------------------------------------------------------------------------------------------------------------------------------------------------
--------------------------------------------------------------------------------------------------------------------------------------------------------------------------------------------------------
--------------------------------------------------------------------------------------------------------------------------------------------------------------------------------------------------------
--------------------------------------------------------------------------------------------------------------------------------------------------------------------------------------------------------
--------------------------------------------------------------------------------------------------------------------------------------------------------------------------------------------------------
--------------------------------------------------------------------------------------------------------------------------------------------------------------------------------------------------------
--------------------------------------------------------------------------------------------------------------------------------------------------------------------------------------------------------
--------------------------------------------------------------------------------------------------------------------------------------------------------------------------------------------------------
--------------------------------------------------------------------------------------SCCSC-------------------------------------------------------------------------------------------------------------
----------------------------------------------SS-S------------------------------------------------------------------------------------------------------------------------------------------------------
-------------------------------------------------------Tt-----------------------------------------------------------------SSSSS-------------------------------------------------------------------------
------------------------------------#--#--------%------tt-tt-----------%%%%%------------g---------------------------------------------------------------------------------------------------------------
%%%%%%%%%%%%%%%%%%%%%%%%%--%%%%%---##--##-------|------tt-tt-----------|||||--%%--%%%%%%%%%%%%%%%%%%---%%%%%--------------------%%---%%------------%%%%%%%%F%%%%%%%%%%%%%%%%%%%%%%%%%%%%%%%%%%%%%%%%%%%%
|||||||||||||||||||||||||--|||||--###--###----%%%%%%--%%%%%%%---------k|||||--||--||||||||||||||||||---|||||---#--#--------Y----||---||------------||||||||%||||||||||||||||||||||||||||||||||||||||||||
|||||||||||||||||||||||||--|||||%%%%%--%%%%%--||||||--|||||||-------%%%%%%%%%%||--||||||||||||||||||---|||||--##--##--%%%%%%%%%%||---||%%%%%--%%%%%|||||||||||||||||||||||||||||||||||||||||||||||||||||
|||||||||||||||||||||||||--||||||||||--|||||XXXXXXXXXX|||||||XX---XX||||||||||||--||||||||||||||||||---|||||XXXX--XXXX||||||||||||---|||||||--||||||||||||||||||||||||||||||||||||||||||||||||||||||||||
