HEIGHT=16;WIDTH=201;THEME=0;OVERRIDE=false
--------------------------------------------------------------------------------------------------------------------------------------------------------------------------------------------------------
--------------------------------------------------------------------------------------------------------------------------------------------------------------------------------------------------------
--------------------------------------------------------------------------------------------------------------------------------------------------------------------------------------------------------
--------------------------------------------------------------------------------------------------------------------------------------------------------------------------------------------------------
-------------------------------------------------------------------------------------------------------------%%%%%%-------------------------------------------------------------------------------------
-------------------------------------------------------------------------------------------------------------||||||-------------------------------------------------------------------------------------
-------------------------------------------------------------------------------------------------------------||||||-------------------------------------------------------------------------------------
-------------------------------------------------------------------------------------------------------------||||||-------------------------------------------------------------------------------------
-------------------------------------------------------------------------------------------------------------||||%%%%-----------------------------------------------------------------------------------
-------------------------------------------------------------------------------------------------------------||||||||----------SSU----------------------------------------------------------------------
--------------------------------------------------------------Tt---------------------------------------------||||||||------------------SUSSS2-----------------------------------------------------------
--------------------------------------------------------------tt-------------------------------------------y-||||||||--g--------------------------------------------------------------------------------
----------------------------%%%%%---%%%%%%%%%%--%%%%%--------%%%%%%%%%-------------%%%%%%%%%%%---#--#---%%%%%%%%%%%%%%%%%%------------------------------------------------------------------------------
------------%%%%%---%%%%%---|||||---||||||||||--|||||--r--rr-|||||||||%%%%%---%%%%%|||||||||||--##--##--||||||||||||||||||----%%%%%%%%------rk----------------------------------------------------------
------------|||||---|||||%%%|||||---||||||||||--|||||%%%%%%%%||||||||||||||---||||||||||||||||%%%%--%%%%||||||||||||||||||%%%%||||||||%%%%%%%%%%%-------------------------------------------------------
XXXXXXXXXXXX|||||---|||||||||||||---||||||||||--|||||||||||||||||||||||||||---||||||||||||||||||||--|||||||||||||||||||||||||||||||||||||||||||||XXXXXXXXFXXXXXXXXXXXXXXXXXXXXXXXXXXXXXXXXXXXXXXXXXXXXXX
