HEIGHT=16;WIDTH=201;THEME=0;OVERRIDE=false
--------------------------------------------------------------------------------------------------------------------------------------------------------------------------------------------------------
--------------------------------------------------------------------------------------------------------------------------------------------------------------------------------------------------------
--------------------------------------------------------------------------------------------------------------------------------------------------------------------------------------------------------
--------------------------------------------------------------------------------------------------------------------------------------------------------------------------------------------------------
--------------------------------------------------------------------------------------------------------------------------------------------------------------------------------------------------------
--------------------------------------------------------------------------------------------------------------------------------------------------------------------------------------------------------
--------------------------------------------------------------------------------------------------------------------------------------------------------------------------------------------------------
--------------------------------------------------------------------------------------------------------------------------------------------------------------------------------------------------------
--------------------------------------------------------------------------------------------------------------------------------------------------------------------------------------------------------
--------------------------------------------------------------------------------------------------------------------------------------------------------------------------------------------------------
--------------------------------------------------------------------SSSSSU-----------------------------------------------SSSS---------------------------------------------------------------------------
--------------------------------------------------------------------------------------------------#--#--------------------------------------------------------------------------------------------------
------------------------------------------------------------------------------------------------%%%--%%%------------------------------------------------------------------------------------------------
---------------------------------%%%%--%%%%--------------------------------k--------------------|||--|||----------------g------%%--%%-------------------------------------------------------------------
-------------%%%%%---%%%%%-------||||--||||%%%%--%%%%-------------%%%%%%%%%%%%%---%%%%%%%--%%%%%|||--|||%%%%%%%%%%--%%%%%%%%%%%||--||-------------------------------------------------------------------
XXXXXXXXXXXXX|||||---|||||XX---XX||||--||||||||--||||XXXXX---XXXXX|||||||||||||---|||||||--||||||||--|||||||||||||--|||||||||||||--||XXXXXXXXXXXXFXXXXXXXXXXXXXXXXXXXXXXXXXXXXXXXXXXXXXXXXXXXXXXXXXXXXXX
