HEIGHT=16;WIDTH=201;THEME=0;OVERRIDE=false
--------------------------------------------------------------------------------------------------------------------------------------------------------------------------------------------------------
--------------------------------------------------------------------------------------------------------------------------------------------------------------------------------------------------------
--------------------------------------------------------------------------------------------------------------------------------------------------------------------------------------------------------
--------------------------------------------------------------------------------------------------------------------------------------------------------------------------------------------------------
--------------------------------------------------------------------------------------------------------------------------------------------------------------------------------------------------------
--------------------------------------------------------------------------------------------------------------------------------------------------------------------------------------------------------
--------------------------------------------------------------------------------------------------------------------------------------------------------------------------------------------------------
--------------------------------------------------------------------------------------------------------------------------------------------------------------------------------------------------------
-------------------------------CC2S---------------------------------------------------------------------------------------------------------------------------------------------------------------------
--------------------------------------------------------------------------------------------------------------------------------------------------------------------------------------------------------
-------------tt--------------------------------------------------------SUCS------------------------------------------------SS-SSS-----------------------------------------------------------------------
-------------tt-----------------k-----------------SSCS--------------------------------------------------------------------------------------------------------------------------------------------------
-------------tt------#--#---%%%%%%%%%%%--------------------------%%%%%-----------------------------------------%%%%---%%%%---%-----------%%%%%%%%F%%%%%%%%%%%%%%%%%%%%%%%%%%%%%%%%%%%%%%%%%%%%%%%%%%%%%%
%%%%%%%%%%%%%%%%%%--##--##--|||||||||||-------------------#--#---|||||----------------------------%%%%%---%%%%%||||---||||---|-----------||||||||%||||||||||||||||||||||||||||||||||||||||||||||||||||||
||||||||||||||||||%%%%--%%%%|||||||||||-------------r----##--##--|||||%%%%%%%%%%%---%%%-----------|||||---|||||||||---||||%%%%%%%%%%%%%%%|||||||||||||||||||||||||||||||||||||||||||||||||||||||||||||||
||||||||||||||||||||||--|||||||||||||||XXXX--XXXXXXXXXXXXXX--XXXX||||||||||||||||---|||XXXX---XXXX|||||---|||||||||---||||||||||||||||||||||||||||||||||||||||||||||||||||||||||||||||||||||||||||||||||
