HEIGHT=16;WIDTH=201;THEME=0;OVERRIDE=false
--------------------------------------------------------------------------------------------------------------------------------------------------------------------------------------------------------
--------------------------------------------------------------------------------------------------------------------------------------------------------------------------------------------------------
--------------------------------------------------------------------------------------------------------------------------------------------------------------------------------------------------------
--------------------------------------------------------------------------------------------------------------------------------------------------------------------------------------------------------
--------------------------------------------------------------------------------------------------------------------------------------------------------------------------------------------------------
--------------------------------------------------------------------------------------------------------------------------------------------------------------------------------------------------------
--------------------------------------------------------------------------------------------------------------------------------------------------------------------------------------------------------
--------------------------------------------------------------------------------------------------------------------------------------------------------------------------------------------------------
--------------------------------------------------------------------------------------------------------------------------------------------------------------------------------------------------------
--------------------------------------------------------------------------------------------------------------------------------------------------------------------------------------------------------
----------------------------------------------------------------S2SCSS--S2CCSSCS------------------------------------------------------------------------------------------------------------------------
----------------------------------------SSSC--------------------------------------------------------------rr--------------------------------------------------------------------------------------------
--------------------------------------------------------Tt-------------------------------------------%%%%%%%%%%%%--%%%%----------%%%%%--%%%%%%%%%%%%%F%%%%%%%%%%%%%%%%%%%%%%%%%%%%%%%%%%%%%%%%%%%%%%%%%%
%%%%%%%%%%-------------------#---#----------------------tt----------------r------%%%%---%%%%%%%---%%%||||||||||||--||||---#--#---|||||--|||||||||||||%||||||||||||||||||||||||||||||||||||||||||||||||||
||||||||||%%--%%%%%%%%%%%%--##---##--------k----yy--k---tt--%%%%%%%%%%%%%%%%%%%%%||||---|||||||---|||||||||||||||--||||--##--##--|||||--||||||||||||||||||||||||||||||||||||||||||||||||||||||||||||||||
||||||||||||--||||||||||||XXXX---XXXXXXXXXXXXXXXXXXXXXXXXXXX|||||||||||||||||||||||||---|||||||---|||||||||||||||--||||XXXX--XXXX|||||--||||||||||||||||||||||||||||||||||||||||||||||||||||||||||||||||
