HEIGHT=16;WIDTH=201;THEME=0;OVERRIDE=false
--------------------------------------------------------------------------------------------------------------------------------------------------------------------------------------------------------
--------------------------------------------------------------------------------------------------------------------------------------------------------------------------------------------------------
--------------------------------------------------------------------------------------------------------------------------------------------------------------------------------------------------------
--------------------------------------------------------------------------------------------------------------------------------------------------------------------------------------------------------
--------------------------------------------------------------------------------------------------------------------------------------------------------------------------------------------------------
--------------------------------------------------------------------------------------------------------------------------------------------------------------------------------------------------------
--------------------------------------------------------------------------------------------------------------------------------------------------------------------------------------------------------
---------------------------------------g----------------------------------------------------------------------------------------------------------------------------------------------------------------
---------------------------------------%%%--------------------------------------------------------------------------------------------------------------------------------------------------------------
--------------------------------------g|||--------------------------------------------------------------------------------------------------------------------------------------------------------------
-----------------------------------%%%%%%|-------------------------------------#--#---------------------------------------------------------------------------------------------------------------------
------------------g----------------|||||||---------------------------SSS2-----##--##-----#--#------------#--#-------------------------------------------------------------------------------------------
------------------%%%%-------------|||||||---%%--%%%%%--%%%-----------------%%%%--%%%%--##--##----------##--##------------------------------------------------------------------------------------------
%%%%%%%%%%--------||||--%%%%--%%%%-|g|||||---||--|||||--|||-----------------||||--||||%%%%--%%%%%%--%%%%%%--%%%%----------------------------------------------------------------------------------------
||||||||||--------|y||--||||--||||%%%%%%%%%%%||--|||||--|||--#--#-------yy--||||--||||||||--||||||--||||||--||||------%%---%%--------%%%%%--%%%%%-------------------------------------------------------
||||||||||XXXXXXXXXXXXXX||||--|||||||||||||||||--|||||--|||XXX--XXXXXXXXXXXX||||--||||||||--||||||--||||||--||||XXXXXX||---||XXX--XXX|||||--|||||XXXXXXXXFXXXXXXXXXXXXXXXXXXXXXXXXXXXXXXXXXXXXXXXXXXXXXX
