HEIGHT=16;WIDTH=201;THEME=0;OVERRIDE=false
--------------------------------------------------------------------------------------------------------------------------------------------------------------------------------------------------------
--------------------------------------------------------------------------------------------------------------------------------------------------------------------------------------------------------
--------------------------------------------------------------------------------------------2S2---------------------------------------------------------------------------------------------------------
------------------------------------------Kr------------------------------------------------------------------------------------------------------------------------------------------------------------
-----------------------------------------%%%%%----------------------------------------------------------------------------------------------------------------------------------------------------------
-----------------------------------------|||||----------------------------------------------gryg--------------------------------------------------------------------------------------------------------
-----------------------------------------|||||---------------------------------------------%%%%%%-------------------------------------------------------------------------------------------------------
-----------------------------------------|||||---------------------------------------------||||||-------------------------------------------------------------------------------------------------------
--------------------------------------%%%%%%%|---------------------------------------------||||||-------------------------------------------------------------------------------------------------------
--------------------------------------||||||||---------------------------------------------||||||-------------------------------------------------------------------------------------------------------
-----------------#--#-----------------||||||||---------------------------------------------|%%%%%%%----------------------------SSSCS--------------------------------------------------------------------
----------------##--##-----#--#-------||||||k|---------------------------------------------||||||||-----------------------------------------------------------------------------------------------------
--------------%%%%--%%%%--##--##--%%%%%%%%%%%%%%%------------------------------------------||||||||---%%%%%--%%%%%----------------------#---#-----------------------------------------------------------
--------------||||--||||%%%%--%%%%|||||||||||||||-Y----------------------------------------|||||r||---|||||--|||||%%%%---%%%%----------##---##--%%%%%%%%F%%%%%%%%%%%%%%%%%%%%%%%%%%%%%%%%%%%%%%%%%%%%%%%
%%%%%%%%%%%%%%||||--||||||||--|||||||||||||||||||%%%%%%%-----------%%%%%---%%%%%-------%%%%%%%%%%%%%%%|||||--|||||||||---||||%%%%%%%%%%%%---%%%%||||||||%|||||||||||||||||||||||||||||||||||||||||||||||
||||||||||||||||||--||||||||--||||||||||||||||||||||||||XXXX---XXXX|||||---|||||XXXXXXX||||||||||||||||||||--|||||||||---||||||||||||||||---||||||||||||||||||||||||||||||||||||||||||||||||||||||||||||
