HEIGHT=16;WIDTH=201;THEME=0;OVERRIDE=false
--------------------------------------------------------------------------------------------------------------------------------------------------------------------------------------------------------
--------------------------------------------------------------------------------------------------------------------------------------------------------------------------------------------------------
--------------------------------------------------------------------------------------------------------------------------------------------------------------------------------------------------------
--------------------------------------------------------------------------------------------------------------------------------------------------------------------------------------------------------
--------------------------------------------------------------------------------------------------------------------------------------------------------------------------------------------------------
--------------------------------------------------------------------------------------------------------------------------------------------------------------------------------------------------------
--------------------------------------------------------------------------------------------------------------------------------------------------------------------------------------------------------
--------------------------------------------------------------------------------------------------------------------------------------------------------------------------------------------------------
----------------------------------------------------------------------------------------------------k---------------------------------------------------------------------------------------------------
-----------------------------------------------k------------------------------------------------%%%%%---------------------------------------------------------------------------------------------------
-----------------------------------------%%%%%%%-----------------------------#--#---------------|||||----------------------SSS2S------------------------------------------------------------------------
-----------------------------------------|||||||----------------------------##--##--------------|||||y-y------------------------------------------------------------------------------------------------
%%%%%%%%%%%%%%%--%%%%--%%---k------------||r||||--------------------------%%%%--%%%%----------%%%%%%%%%%%%%%%---------------------------g---------------------------------------------------------------
|||||||||||||||--||||--||%%%%%%%%%%%%%%%%%%%%%%%%%-----------------%%---%%||||--||||----------|||||||||||||||--------------------r-%%%%%%%%%%%%%%%F%%%%%%%%%%%%%%%%%%%%%%%%%%%%%%%%%%%%%%%%%%%%%%%%%%%%%
|||||||||||||||--||||--|||||||||||||||||||||||||||-----------------||---||||||--||||----------|||||||||||||||%%%%%---%%%%%%%%%%%%%%|||||||||||||||%|||||||||||||||||||||||||||||||||||||||||||||||||||||
|||||||||||||||--||||--|||||||||||||||||||||||||||XXXX---XXXXXX--XX||---||||||--||||XXXX--XXXX||||||||||||||||||||---|||||||||||||||||||||||||||||||||||||||||||||||||||||||||||||||||||||||||||||||||||
