HEIGHT=16;WIDTH=201;THEME=0;OVERRIDE=false
--------------------------------------------------------------------------------------------------------------------------------------------------------------------------------------------------------
--------------------------------------------------------------------------------------------------------------------------------------------------------------------------------------------------------
--------------------------------------------------------------------------------------------------------------------------------------------------------------------------------------------------------
--------------------------------------------------------------------------------------------------------------------------------------------------------------------------------------------------------
--------------------------------------------------------------------------------------------------------------------------------------------------------------------------------------------------------
--------------------------------------------------------------------------------------------------------------------------------------------------------------------------------------------------------
----------------------------------------------------------------------------------------------------------------------------------------%%%-------------------------------------------------------------
----------------------------------------------------------------------------------------------------------------------------------------|||-------------------------------------------------------------
----------------------------------------------------------------------------------------------------------------------------------------|||-------------------------------------------------------------
--------------------------------------------------------------------------------------------------------------------------------------%%%%|-------------------------------------------------------------
-----------------------SCSS-----------------------------------------------------------------------------------------------------------|||||-------------------------------------------------------------
----------------------------------------------------------------------------------------------------------------Tt--------------------|||||-------------------------------------------------------------
-------------------------------------------------------------%%%%--%%%%%%---%%--------------Tt--tt----%%%--%%%--tt---tt---------------|||||-------------------------------------------------------------
------------------------------%%%---%%%%%--%%%%%%%%%%---%%%%%||||--||||||---||--------------tt--tt----|||--|||--tt---tt--%%%%%-------%%%%%%%%%%%%%%%%%%%%%F%%%%%%%%%%%%%%%%%%%%%%%%%%%%%%%%%%%%%%%%%%%%%
%%%%%%%%%%%%%%--%%%%%%%%%%%%%%|||---|||||--||||||||||---|||||||||--||||||---||%%%%%--%%%%%--tt--tt----|||--|||%%%%%%%%%%%|||||%%---%%|||||||||||||||||||||%|||||||||||||||||||||||||||||||||||||||||||||
||||||||||||||--|||||||||||||||||---|||||--||||||||||---|||||||||--||||||---|||||||--|||||XXXXXXXXXXXX|||--|||||||||||||||||||||---|||||||||||||||||||||||||||||||||||||||||||||||||||||||||||||||||||||
