HEIGHT=16;WIDTH=201;THEME=0;OVERRIDE=false
--------------------------------------------------------------------------------------------------------------------------------------------------------------------------------------------------------
--------------------------------------------------------------------------------------------------------------------------------------------------------------------------------------------------------
--------------------------------------------------------------------------------------------------------------------------------------------------------------------------------------------------------
--------------------------------------------------------------------------------------------------------------------------------------------------------------------------------------------------------
--------------------------------------------------------------------------------------------------------------------------------------------------------------------------------------------------------
--------------------------------------------------------------------------------------------------------------------------------------------------------------------------------------------------------
--------------------------------------------------------------------------------------------------------------------------------------------------------------------------------------------------------
---------------------------------------------------------------------------------------------g----------------------------------------------------------------------------------------------------------
--------------------------------------------------------------------------------------------%%%---------------------2SS2C-------------------------------------------------------------------------------
------------------------------------------------------------------------------------yr-g----|||---------------------------------------------------------------------------------------------------------
-----------------------UCS----------------------------------------------------------%%%%----|||---------------------------------------------------------------------------------------------------------
------------------------------------------------------------------------------------||||----|||--------------------k------------------------------------------------------------------------------------
----------------------%----------r--------------------------------------------------||||----|||---%%--%%-------%%%%%%%%%%%%%%---------------------------------------------------------------------------
%%%%%%%%%%%%%%%%%%----|y--g--%%%%%%-----%%%%%--%%%%%-----------------%%%%---%%%%----k|||----|||---||--||-------||||||||||||||---------------------------------------------------------------------------
||||||||||||||||||%%%%%%%%%%%||||||%%%%%|||||--|||||-----------------||||---||||%%%%%%%%%%%%%%%%%%||--||%%%%%%%||||||||||||||%%%%--%%%%-----------------------------------------------------------------
|||||||||||||||||||||||||||||||||||||||||||||--|||||XXXXXXXXXXXX--XXX||||---||||||||||||||||||||||||--|||||||||||||||||||||||||||--||||XXXXXXXXXXXXFXXXXXXXXXXXXXXXXXXXXXXXXXXXXXXXXXXXXXXXXXXXXXXXXXXXX
