HEIGHT=16;WIDTH=201;THEME=0;OVERRIDE=false
--------------------------------------------------------------------------------------------------------------------------------------------------------------------------------------------------------
--------------------------------------------------------------------------------------------------------------------------------------------------------------------------------------------------------
--------------------------------------------------------------------------------------------------------------------------------------------------------------------------------------------------------
--------------------------------------------------------------------------------------------------------------------------------------------------------------------------------------------------------
--------------------------------------------------------------------------------------------------------------------------------------------------------------------------------------------------------
--------------------------------------------------------------------------------------------------------------------------------------------------------------------------------------------------------
--------------------------------------------------------------------------------------------------------------------------------------------------------------------------------------------------------
--------------------------------------------------------------------------------------------------------------------------------------------------------------------------------------------------------
--------------------------------------------------------------------------------------------------------------------------------------------------------------------------------------------------------
--------------------------------------------------------------------------------------------------------------------------------------------------------------------------------------------------------
--------------------------------------------------------------------------------------------------------------------------------------------------------------------------------------------------------
--------------------------------------------------------------------------------------------------------------------------------------------------------------------------------------------------------
------------------------------rg--y----%%%--%%%---------------------------------%%%%%---%%%%%----------------------------%%%--%%%%%%---%%%%%%%%%%%F%%%%%%%%%%%%%%%%%%%%%%%%%%%%%%%%%%%%%%%%%%%%%%%%%%%%%
-----------------------------%%%%%%----|||--|||----------------------------%%%%%|||||---|||||------------%%---%%----tt---|||--||||||---|||||||||||%|||||||||||||||||||||||||||||||||||||||||||||||||||||
%%%%%%%%%%%%--------%%%%%----y||||y----|||--|||%%%%%--%%%%%-------%%%---%%%||||||||||---|||||------------||---||----tt---|||--||||||---|||||||||||||||||||||||||||||||||||||||||||||||||||||||||||||||||
||||||||||||XXX--XXX|||||XXXXXXXXXXXXXX|||--||||||||--|||||XX---XX|||---|||||||||||||---|||||XXXXX--XXXXX||---||XXXXXXXXX|||--||||||---|||||||||||||||||||||||||||||||||||||||||||||||||||||||||||||||||
