HEIGHT=16;WIDTH=201;THEME=0;OVERRIDE=false
--------------------------------------------------------------------------------------------------------------------------------------------------------------------------------------------------------
--------------------------------------------------------------------------------------------------------------------------------------------------------------------------------------------------------
--------------------------------------------------------------------------------------------------------------------------------------------------------------------------------------------------------
--------------------------------------------------------------------------------------------------------------------------------------------------------------------------------------------------------
--------------------------------------------------------------------------------------------------------------------------------------------------------------------------------------------------------
--------------------------------------------------------------------------------------------------------------------------------SCS---------------------------------------------------------------------
--------------------------------------------------------------------------------------------------------------------------------------------------------------------------------------------------------
--------------------------------------------------------------------------------------------------------------------------------------------------------------------------------------------------------
-----------------------------------------------------------------------------------------------------------------------------y-----r--------------------------------------------------------------------
-----------------------------------------------------------------------------------------------------------------------------%%%%%%%--------------------------------------------------------------------
---------------------------------------------------------------------------------------------SS-UC2C-------------------------|||||||--------------------------------------------------------------------
----------------------------------------------------------%%%%%%-------------------------------------------SS2SS-------------|||||||--------------------------------------------------------------------
--------------%%--%%--------------------------%%%---%%%---||||||-------------------------------|-----------------------------|||||||--------------------------------------------------------------------
%%%%%%%%%%%%%%||--||%%%%%---%%%%%-------------|||---|||---||||||-------------------------------k-----------------%%%--%%%%%%%%%%%%%%%%%%----------------------------------------------------------------
||||||||||||||||--|||||||---|||||-------------|||---|||---||||||--r----g---%%%---%%%----%%%%%%%%%%%%%%%----------|||--||||||||||||||||||%%%%%%%%F%%%%%%%%%%%%%%%%%%%%%%%%%%%%%%%%%%%%%%%%%%%%%%%%%%%%%%%
||||||||||||||||--|||||||---|||||XXX---XXXXXXX|||---|||XXXXXXXXXXXXXXXXXXXX|||---|||XXXX|||||||||||||||XXXXXXXXXX|||--||||||||||||||||||||||||||X|||||||||||||||||||||||||||||||||||||||||||||||||||||||
