HEIGHT=16;WIDTH=201;THEME=0;OVERRIDE=false
--------------------------------------------------------------------------------------------------------------------------------------------------------------------------------------------------------
--------------------------------------------------------------------------------------------------------------------------------------------------------------------------------------------------------
--------------------------------------------------------------------------------------------------------------------------------------------------------------------------------------------------------
--------------------------------------------------------------------------------------------------------------------------------------------------------------------------------------------------------
--------------------------------------------------------------------------------------------------------------------------------------------------------------------------------------------------------
--------------------------------------------------------------------------------------------------------------------------------------------------------------------------------------------------------
--------------------------------------------------------------------------------------------------------------------------------------------------------------------------------------------------------
--------------------------------------------------------------------------------------------------------------------------------------------------------------------------------------------------------
---------------------------------SSCCS------------------------------------------------------------------------------------------------------------------------------------------------------------------
---------------------------------------------------------------------------------------22C2US-----------------------------------------------------------------------------------------------------------
--------------------------------------------------------------------------------------------------------------------------------------------------------------------------------------------------------
----------------------------------y--------#--#-----------------------------------------------------------y-rr-------------#--#---tt---Tt---------------------------------------------------------------
%%%%%%%%%%%%------------------%%%%%%%%%---##--##---%%%%%--%%%%%%%%----------%%%--%%%---------------------%%%%%%--tt-tt---%%%--%%%-tt---tt---------------------------------------------------------------
||||||||||||------------------|||||||||--###--###--|||||--||||||||---tt-tt--|||--|||%%%%%%%%%%%%%%---%%%%||||||--tt-tt---|||--|||%%%%%%%%%%%%%%%%%F%%%%%%%%%%%%%%%%%%%%%%%%%%%%%%%%%%%%%%%%%%%%%%%%%%%%%
||||||||||||------------#--#--|||||||||%%%%%--%%%%%|||||--||||||||---tt-tt--|||--|||||||||||||||||---||||||||||--tt-tt---|||--||||||||||||||||||||%|||||||||||||||||||||||||||||||||||||||||||||||||||||
||||||||||||XXXX--XXXXXXX--XXX||||||||||||||--||||||||||--||||||||XXXXXXXXXX|||--|||||||||||||||||---||||||||||XXXXXXXXXX|||--||||||||||||||||||||||||||||||||||||||||||||||||||||||||||||||||||||||||||
