HEIGHT=16;WIDTH=201;THEME=0;OVERRIDE=false
--------------------------------------------------------------------------------------------------------------------------------------------------------------------------------------------------------
--------------------------------------------------------------------------------------------------------------------------------------------------------------------------------------------------------
--------------------------------------------------------------------------------------------------------------------------------------------------------------------------------------------------------
--------------------------------------------------------------------------------------------------------------------------------------------------------------------------------------------------------
--------------------------------------------------------------------------------------------------------------------------------------------------------------------------------------------------------
--------------------------------------------------------------------------------------------------------------------------------------------------------------------------------------------------------
--------------------------------------------------------------------------------------------------------------------------------------------------------------------------------------------------------
--------------------------------------------------------------------------------------------------------------------------------------------------------------------------------------------------------
--------------------------------------------------------------------------------------------------------------------------------------------------------------------------------------------------------
--------------------------------------------------------------------------------------------------------------------------------------------------------------------------------------------------------
--------------------------------------------------------------------------------------------------------#---#-------------------------------------------------------------------------------------------
------------------------------------------------------------------SSSUSC-----tt------------------------##---##------------------------------------------------------------------------------------------
--------------#--#---------------------------#--#----------------------------tt-----------%%%%--%%%%--###---###--%%%%%--%%%%%---------------------------------------------------------------------------
-------------##--##--%%%%%---%%%%%----------##--##---%%%%---%%%%-------------tt-----------||||--||||%%%%%---%%%%%|||||--|||||%%--%%%%-------------%%%%%%%%F%%%%%%%%%%%%%%%%%%%%%%%%%%%%%%%%%%%%%%%%%%%%%
%%%%%%%%%%%%%%%--%%%%|||||---|||||%%---%%--###--###--||||---||||----Gy----%%%%%%%%%%%---%%||||--|||||||||---||||||||||--|||||||--||||-------------||||||||%|||||||||||||||||||||||||||||||||||||||||||||
|||||||||||||||--|||||||||---|||||||---||XXXXX--XXXXX||||---||||XXXXXXXXXX|||||||||||---||||||--|||||||||---||||||||||--|||||||--||||XXXXX---XXXXX||||||||||||||||||||||||||||||||||||||||||||||||||||||
