HEIGHT=16;WIDTH=201;THEME=0;OVERRIDE=false
--------------------------------------------------------------------------------------------------------------------------------------------------------------------------------------------------------
--------------------------------------------------------------------------------------------------------------------------------------------------------------------------------------------------------
--------------------------------------------------------------------------------------------------------------------------------------------------------------------------------------------------------
--------------------------------------------------------------------------------------------------------------------------------------------------------------------------------------------------------
--------------------------------------------------------------------------------------------------------------------------------------------------------------------------------------------------------
--------------------------------------------------------------------------------------------------------------------------------------------------------------------------------------------------------
--------------------------------------------------------------------------------------------------------------------------------------------------------------------------------------------------------
--------------------------------------------------------------------------------------------------------------------------------------------------------------------------------------------------------
--------------------------------------------------------------------S2CSSSS-----------------------------------------------------------------------------------------------------------------------------
--------------------------------------------------------------------------------------------------------------------------------------------------------------------------------------------------------
-------------------------------------k-----------------------------------------------------------#---#-----------------------------------Tt-------------------------------------------------------------
-------------------------------------%%%%-----------------------------g-k-----------------------##---##----------------------------------tt-------------------------------------------------------------
------------------------------------k||||-y--r------#--#---%%%%%%%%%%%%%%%%%%------------------###---###----------%%%---%%%-----------%%%%%%%-----------------------------------------------------------
---------------------%%%%-------%%%%%%%%%%%%%%%%%--##--##--||||||||||||||||||----------------%%%%%---%%%%%--------|||---|||-----------|||||||-----------------------------------------------------------
--------------%%---%%||||-------|||||||||||||||||%%%%--%%%%||||||||||||||||||----------%%--%%|||||---|||||--------|||---|||%%%%---%%%%|||||||%%%%%%%%F%%%%%%%%%%%%%%%%%%%%%%%%%%%%%%%%%%%%%%%%%%%%%%%%%%
XXXXXXXXXXXXXX||---||||||XX---XX|||||||||||||||||||||--||||||||||||||||||||||XXXX--XXXX||--|||||||---|||||XXX--XXX|||---|||||||---|||||||||||||||||||X||||||||||||||||||||||||||||||||||||||||||||||||||
