HEIGHT=16;WIDTH=201;THEME=0;OVERRIDE=false
--------------------------------------------------------------------------------------------------------------------------------------------------------------------------------------------------------
--------------------------------------------------------------------------------------------------------------------------------------------------------------------------------------------------------
--------------------------------------------------------------------------------------------------------------------------------------------------------------------------------------------------------
--------------------------------------------------------------------------------------------------------------------------------------------------------------------------------------------------------
--------------------------------------------------------------------------------------------------------------------------------------------------------------------------------------------------------
--------------------------------------------------------------------------------------------------------------------------------------------------------------------------------------------------------
--------------------------------------------------------------------------------------------------------------------------------------------------------------------------------------------------------
--------------------------------------------------------------------------------------------------------------------------------------------------------------------------------------------------------
--------------------------------------------------------------------------------------------------------------------------------------------------------------------------------------------------------
----------------------------------------------------------k---------------------------------------------------------------------------------------------------------------------------------------------
-------------------------------------------------------%%%%---------------------------------------------------------------------------------------------------------------------------------------------
-------------------------------------------------------|g||-----Y---------------------------------------------------------------------------------------------------------------------------------------
-------------------------------------------%%---%%%%%%%%%%%%%%%%%%%-----------------------------------------------------------------------%%%%%%%%F%%%%%%%%%%%%%%%%%%%%%%%%%%%%%%%%%%%%%%%%%%%%%%%%%%%%%
------------------------------------#--#---||---|||||||||||||||||||%%%%%--------------------------------------------%%%%%--%%%%%----------||||||||%|||||||||||||||||||||||||||||||||||||||||||||||||||||
%%%%%%%%%%%%--#--#-----------------##--##--||---||||||||||||||||||||||||-------------%%%%--%%%%%%%%---%%%%----%%%%%%|||||--|||||%%%%%%%%%%||||||||||||||||||||||||||||||||||||||||||||||||||||||||||||||
||||||||||||XXX--XXXXXXXX---XXXXXXXXX--XXXX||---||||||||||||||||||||||||XXXXX---XXXXX||||--||||||||---||||XXXX|||||||||||--|||||||||||||||||||||||||||||||||||||||||||||||||||||||||||||||||||||||||||||
