HEIGHT=16;WIDTH=201;THEME=0;OVERRIDE=false
--------------------------------------------------------------------------------------------------------------------------------------------------------------------------------------------------------
--------------------------------------------------------------------------------------------------------------------------------------------------------------------------------------------------------
--------------------------------------------------------------------------------------------------------------------------------------------------------------------------------------------------------
--------------------------------------------------------------------------------------------------------------------------------------------------------------------------------------------------------
--------------------------------------------------------------------------------------------------------------------------------------------------------------------------------------------------------
--------------------------------------------------------------------------------------------------------------------------------------------------------------------------------------------------------
---------------------------------------------------------------------------------------------------------------------SCCCSU-----------------------------------------------------------------------------
--------------------------------------------------------------------------------------------------------------------------------------------------------------------------------------------------------
--------------------------------------------------------------------------------------------------------------------------------------------------------------------------------------------------------
-------------------------------tt-----------------------------------------------------------------------------------------k-----------------------------------------------------------------------------
---------------------------tt--tt--------#---#-----------------------------------------------------------------------%%%%%%%----------------------------------------------------------------------------
---------------------------tt--tt-------##---##------------------------------------k-------------------------SSU-----|||||||----------------------------------------------------------------------------
----------%%---%%--------%%%%%%%%%%%%--###---###---------------------------------%%%%%%%-----------------------------|||Kr||----------------%%%%%%%%F%%%%%%%%%%%%%%%%%%%%%%%%%%%%%%%%%%%%%%%%%%%%%%%%%%%
----------||---||--------||||||||||||%%%%%---%%%%%%%%%--%%%%---------%%--%%------|||||||-----------------%%%--------%%%%%%%%%%%%%%%%%---%%%%||||||||%|||||||||||||||||||||||||||||||||||||||||||||||||||
----------||---||%%%--%%%|||||||||||||||||---|||||||||--||||---------||--||%%--%%|||||||%%---------------|||--------|||||||||||||||||---||||||||||||||||||||||||||||||||||||||||||||||||||||||||||||||||
XXXXXXXXXX||---|||||--||||||||||||||||||||---|||||||||--||||XXX---XXX||--||||--|||||||||||XXXXXXXX---XXXX|||XXXXXXXX|||||||||||||||||---||||||||||||||||||||||||||||||||||||||||||||||||||||||||||||||||
