HEIGHT=16;WIDTH=201;THEME=0;OVERRIDE=false
--------------------------------------------------------------------------------------------------------------------------------------------------------------------------------------------------------
--------------------------------------------------------------------------------------------------------------------------------------------------------------------------------------------------------
--------------------------------------------------------------------------------------------------------------------------------------------------------------------------------------------------------
--------------------------------------------------------------------------------------------------------------------------------------------------------------------------------------------------------
--------------------------------------------------------------------------------------------------------------------------------------------------------------------------------------------------------
--------------------------------------------------------------------------------------------------------------------------------------------------------------------------------------------------------
--------------------------------------------------------------------------------------------------------------------------------------------------------------------------------------------------------
--------------------------------------------------------------------------------------------------------------------------------------------------------------------------------------------------------
--------------------------------------------------------------------------------------------------------------------------------------------------------------------------------------------------------
--------------SCSCS---------------------------------------------------------------r-y-------------------------------------------------------------------------------------------------------------------
-------------------------------------SSSS2----------------------------------------%%%-------------------------------------------------------------------------------------------------------------------
-----------------------------------------------#--#-------------------------------|||------------------Tt-----------------------------------------------------------------------------------------------
------------------------------------%---------##--##------------------------------|||------------------tt---%%%%---%%%%--------------------%%%%%%%%F%%%%%%%%%%%%%%%%%%%%%%%%%%%%%%%%%%%%%%%%%%%%%%%%%%%%
----------%%%%%%%%%%--------------ky|--k-----###--###-----------------------------|||------------------tt---||||---||||-------------#---#--||||||||%||||||||||||||||||||||||||||||||||||||||||||||||||||
----------||||||||||%%--%%%%%%%%%%%%%%%%%%%%%%%%--%%%%%%%%%---%%%%--#---#--%%%%%%%%%%%%%%%%%%%%%---%%%%%%%%%||||---||||-----------%%%---%%%|||||||||||||||||||||||||||||||||||||||||||||||||||||||||||||
XXXXXXXXXX||||||||||||--||||||||||||||||||||||||--|||||||||---||||XXX---XXX|||||||||||||||||||||---|||||||||||||---||||XXXX---XXXX|||---||||||||||||||||||||||||||||||||||||||||||||||||||||||||||||||||
