HEIGHT=16;WIDTH=201;THEME=0;OVERRIDE=false
--------------------------------------------------------------------------------------------------------------------------------------------------------------------------------------------------------
--------------------------------------------------------------------------------------------------------------------------------------------------------------------------------------------------------
----------------SSS-------------------------------------------------------------------------------------------------------------------------------------------------------------------------------------
--------------------------------------------------------------------------------------------------------------------------------------------------------------------------------------------------------
--------------------------------------------------------------------------------------------------------------------------------------------------------------------------------------------------------
--------------------------------------------------------------------------------------------------------------------------------------------------------------------------------------------------------
---------------%%%%%%%----------------------------------------------------------------------------------------------------------------------------------------------------------------------------------
---------------|||||||----------------------------------------------------------------------------------------------------------------------------------------------------------------------------------
---------------|||||||----------------------------------------------------------------------------------------------------------------------------------------------------------------------------------
---------------|%%%|||-------------------------------------------------------------SSCC-----------------------------------------------------------------------------------------------------------------
---------------|||||||----------------------------------------------------------------------------------------------------------------#---#-------------------------------------------------------------
---------------|||||||------------------------------------------------------------------------------------------#--#-----------------##---##------------------------------------------------------------
---------------|r|y|||---------------Tt----tt-%%%%--%%%%------%%--#--#----#---#-------------------------------%%%--%%%%%%%%--%%%%%--###---###--%%%%%%%%F%%%%%%%%%%%%%%%%%%%%%%%%%%%%%%%%%%%%%%%%%%%%%%%%
--------------%%%%%%%%%%%%-----------tt----tt-||||--||||%%--%%||%%%--%%%%%%---%%%%%%%%%%%%%%%---%%%-----------|||--||||||||--|||||%%%%%---%%%%%||||||||%||||||||||||||||||||||||||||||||||||||||||||||||
%%%%%%%%%%%%%%||||||||||||-----------tt----tt-||||--||||||--|||||||--||||||---|||||||||||||||---|||--------%%%|||--||||||||--||||||||||---||||||||||||||||||||||||||||||||||||||||||||||||||||||||||||||
||||||||||||||||||||||||||XXXXXXXXXXXXXXXXXXXX||||--||||||--|||||||--||||||---|||||||||||||||---|||XXX--XXX||||||--||||||||--||||||||||---||||||||||||||||||||||||||||||||||||||||||||||||||||||||||||||
