HEIGHT=16;WIDTH=201;THEME=0;OVERRIDE=false
--------------------------------------------------------------------------------------------------------------------------------------------------------------------------------------------------------
--------------------------------------------------------------------------------------------------------------------------------------------------------------------------------------------------------
--------------------------------------------------------------------------------------------------------------------------------------------------------------------------------------------------------
--------------------------------------------------------------------------------------------------------------------------------------------------------------------------------------------------------
--------------------------------------------------------------------------------------------------------------------------------------------------------------------------------------------------------
-------------------------------------------------------k------------------------------------------------------------------------------------------------------------------------------------------------
----------------------------------------------------%%%%------------------------------------------------------------------------------------------------------------------------------------------------
----------------------------------------------------||||------------------------------------------------------------------------------------------------------------------------------------------------
----------------------------------------------------||||--------------------------22SSCS----------------------------------------------------------------------------------------------------------------
-----------------------------------------------%%%%%%%||------------------------------------------------SCCCU2------------------------------------------------------------------------------------------
-----------------------------------------------|||||||||------------------------------------------------------------------------------------------------------------------------------------------------
-----------------------------------------------|||||||||------------------------------------------------------------------------------------------------------------------------------------------------
----------------------Tt---tt------------------rg|||||||----------------------%%%%%%%%%%%---------------y-g------------------%%%%%%%--------------------------------------------------------------------
----------------------tt---tt------%%%---%%%%%%%%%%%%%%%%%%%%-----------------|||||||||||--------------%%%%%%%%%%------------|||||||%%%%%%%%%%%%%%%%F%%%%%%%%%%%%%%%%%%%%%%%%%%%%%%%%%%%%%%%%%%%%%%%%%%%
--------------%%---%%%%%%%%%%%%%%%%|||---||||||||||||||||||||-------%%%%--%%%%|||||||||||-----------%%%||||||||||------%%--%%|||||||||||||||||||||||%|||||||||||||||||||||||||||||||||||||||||||||||||||
XXXXXXXXXXXXXX||---|||||||||||||||||||---||||||||||||||||||||XXXXXXX||||--|||||||||||||||XXXX---XXXX|||||||||||||XX--XX||--|||||||||||||||||||||||||||||||||||||||||||||||||||||||||||||||||||||||||||||
