HEIGHT=16;WIDTH=201;THEME=0;OVERRIDE=false
--------------------------------------------------------------------------------------------------------------------------------------------------------------------------------------------------------
--------------------------------------------------------------------------------------------------------------------------------------------------------------------------------------------------------
--------------------------------------------------------------------------------------------------------------------------------------------------------------------------------------------------------
--------------------------------------------------------------------------------------------------------------------------------------------------------------------------------------------------------
--------------------------------------------------------------------------------------------------------------------------------------------------------------------------------------------------------
--------------------------------------------------------------------------------------------------------------------------------------------------------------------------------------------------------
--------------------------------------------------------------------------------------------------------------------------------------------------------------------------------------------------------
--------------------------------------------------------------------------------------------------------------------------------------------------------------------------------------------------------
--------------------------------------------------------------------------------------------------------------------------------------------------------------------------------------------------------
--------------------------------------------------------------------------------------------------------------------------------------------------------------------------------------------------------
----------------------------------------#--#-----------------------------------------S-CS2S--------------SSCCCC2S---------------------------------------------------------------------------------------
---------------------------------------##--##-----------------------------------------------------------------------------------------------------------------------------------------------------------
%%%%%%%%%%---------------#---#-------%%%%--%%%%-----------%%%%%--------%%%%%--%%%%%---%---------------------------%%%%%---%%%%%-------------------------------------------------------------------------
||||||||||-------------%%%---%%%%%%%%||||--||||-----------|||||---G-g--|||||--|||||---|---y-y------------------Y--|||||---|||||---#---#---%%%%%%%%F%%%%%%%%%%%%%%%%%%%%%%%%%%%%%%%%%%%%%%%%%%%%%%%%%%%%%
||||||||||%%%%%---%%%%%|||---||||||||||||--||||----------%%%%%%%%%%%%%%|||||--|||||%%%%%%%%%%%%%%%%%%%%%%%%%%%%%%%|||||---|||||--##---##--||||||||%|||||||||||||||||||||||||||||||||||||||||||||||||||||
|||||||||||||||---||||||||---||||||||||||--||||XXXX--XXXX|||||||||||||||||||--|||||||||||||||||||||||||||||||||||||||||---|||||XXXX---XXXX||||||||||||||||||||||||||||||||||||||||||||||||||||||||||||||
