HEIGHT=16;WIDTH=201;THEME=0;OVERRIDE=false
--------------------------------------------------------------------------------------------------------------------------------------------------------------------------------------------------------
--------------------------------------------------------------------------------------------------------------------------------------------------------------------------------------------------------
--------------------------------------------------------------------------------------------------------------------------------------------------------------------------------------------------------
--------------------------------------------------------------------------------------------------------------------------------------------------------------------------------------------------------
--------------------------------------------------------------------------------------------------------------------------------------------------------------------------------------------------------
--------------------------------------------------------------------------------------------------------------------------------------------------------------------------------------------------------
--------------------------------------------------------------------------------------------------------------------------------------------------------------------------------------------------------
-------------------------------------------------------y------------------------------------------------------------------------------------------------------------------------------------------------
-----------------------------------------------------%%%------------------------------------------------------------------------------------------------------------------------------------------------
------------SCS2-------------------------------------||r--y---------------------------------------------------------------------------------------------------------------------------------------------
-----------------------------------------------------||%%%%%-----------#---#----------------------------------------------------------------------------------------------------------------------------
-----------------------------------------------------|||||||----------##---##------#--#-----2CSCCUCS----------------y-----------------------------------------------------------------------------------
%%%%%%%%%%%--r---------------------------------------k||||||-k------%%%%---%%%%---##--##-------------%%%--%%%--%%%%%%-----------------------------------------------------------------------------------
|||||||||||%%%%%%----------%%%%%%%%%---%%%%%--------%%%%%%%%%%%%%---||||---||||--###--###------------|||--|||--||||||---------------%%%%%---%%%%%%%%%%%%%F%%%%%%%%%%%%%%%%%%%%%%%%%%%%%%%%%%%%%%%%%%%%%%
|||||||||||||||||%%%%--%%%%|||||||||---|||||--------|||||||||||||---||||---||||%%%%%--%%%%%----------|||--|||--||||||---------------|||||---|||||||||||||%||||||||||||||||||||||||||||||||||||||||||||||
|||||||||||||||||||||--|||||||||||||---|||||XXX--XXX|||||||||||||XXX||||---|||||||||--|||||XXXXXXXXXX|||--|||XXXXXXXXXXXXXXX---XXXXX|||||---||||||||||||||||||||||||||||||||||||||||||||||||||||||||||||
