HEIGHT=16;WIDTH=201;THEME=0;OVERRIDE=false
--------------------------------------------------------------------------------------------------------------------------------------------------------------------------------------------------------
--------------------------------------------------------------------------------------------------------------------------------------------------------------------------------------------------------
--------------------------------------------------------------------------------------------------------------------------------------------------------------------------------------------------------
--------------------------------------------------------------------------------------------------------------------------------------------------------------------------------------------------------
----------------------------------------------------------------------------g---k-----------------------------------------------------------------------------------------------------------------------
----------------------------------------C2S--------------------------------%%%%%%%----------------------------------------------------------------------------------------------------------------------
---------------------------------------------------------------------------|||||||----------------------------------------------------------------------------------------------------------------------
---------------------------------------------------------------------------|||||||----------------------------------------------------------------------------------------------------------------------
------------------UCS------------------gr---------------------------------g|||||||----------------------------------------------------------------------------------------------------------------------
-------------------------------------%%%%%%------------------------------%%%%%%%||----------------------------------------------------------------------------------------------------------------------
---------------------%---------------||||||------------------------------|||||||||----------------------------------------------------------------------------------------------------------------------
----------------r----|---------------||||||------------------------------|||||||||-------------------------------------------y--------------------------------------------------------------------------
--------------%%%%%%%%%----------%%%%%%%%%%%%--------#---#------#--#-----|||||%%%%%%%---------------------------------------%%%%%%----------------------------------------------------------------------
%%%%%%%%%%%%%%|||||||||----------||||||||||||------%%%---%%%---##--##----||||||||||||------------------%%%---%%%------------||||||----------------------------------------------------------------------
|||||||||||||||||||||||----------||||||||||||%%--%%|||---|||--###--###---|ky||||||r|y-----%%%%%---%%%%%|||---|||------------||||||%%%%--%%%%------------------------------------------------------------
|||||||||||||||||||||||XXXXXXXXXX||||||||||||||--|||||---|||XXXXX--XXXXXXXXXXXXXXXXXXXXXXX|||||---||||||||---|||XXXXX--XXXXX||||||||||--||||XXXXXXXXFXXXXXXXXXXXXXXXXXXXXXXXXXXXXXXXXXXXXXXXXXXXXXXXXXXX
