HEIGHT=16;WIDTH=201;THEME=0;OVERRIDE=false
--------------------------------------------------------------------------------------------------------------------------------------------------------------------------------------------------------
--------------------------------------------------------------------------------------------------------------------------------------------------------------------------------------------------------
--------------------------------------------------------------------------------------------------------------------------------------------------------------------------------------------------------
--------------------------------------------------------------------------------------------------------------------------------------------------------------------------------------------------------
--------------------------------------------------------------------------------------------------------------------------------------------------------------------------------------------------------
--------------------------------------------------------------------------------------------------------------------------------------------------------------------------------------------------------
--------------------------------------------------------------------------------------------------------------------------------------------------------------------------------------------------------
--------------------------------------------------------------------------------------------------------------------------------------------------------------------------------------------------------
------------------SSU--------------------------------------------------------------------------------------------------------SSSU-----------------------------------------------------------------------
--------------------------------------------------------------------------------------------------------------------------------------------------------------------------------------------------------
---------------------------------------------------------------------------------------------------------------------------------%----------------------------------------------------------------------
--------------------------------------#--#---------------------------------------------------------------------------------------|----------------------------------------------------------------------
%%%%%%%%%%%%%%%%%%%%%%%%%%%%--%%%%---##--##----------------------------------%%%---%%%---------------------------#---#---%%%%%%%%%%---------------------------------------------------------------------
||||||||||||||||||||||||||||--||||--###--###---r-----------------------------|||---|||%%%%%--%%%%%--------------##---##--||||||||||---------------------------------------------------------------------
||||||||||||||||||||||||||||--||||%%%%%--%%%%%%%%%%%%%----------%%%%%---%%%%%|||---||||||||--|||||%%%%%--%%%%%%%%%---%%%%||||||||||%%%---%%%%%%%%%%%F%%%%%%%%%%%%%%%%%%%%%%%%%%%%%%%%%%%%%%%%%%%%%%%%%%%
||||||||||||||||||||||||||||--|||||||||--|||||||||||||XXXX--XXXX|||||---||||||||---||||||||--||||||||||--|||||||||---|||||||||||||||||---|||||||||||X|||||||||||||||||||||||||||||||||||||||||||||||||||
