HEIGHT=16;WIDTH=201;THEME=0;OVERRIDE=false
--------------------------------------------------------------------------------------------------------------------------------------------------------------------------------------------------------
--------------------------------------------------------------------------------------------------------------------------------------------------------------------------------------------------------
--------------------------------------------------------------------------------------------------------------------------------------------------------------------------------------------------------
--------------------------------------------------------------------------------------------------------------------------------------------------------------------------------------------------------
--------------------------------------------------------------------------------------------------------------------------------------------------------------------------------------------------------
--------------------------------------------------------------------------------------------------------------------------------------------------------------------------------------------------------
--------------------------------------------------------------------------------------------------------------------------------------------------------------------------------------------------------
--------------------------------------------------------------------------------------------------------------------------------------------------------------------------------------------------------
---------------------------------------------------------------------%%%%%------------------------------------------------------------------------------------------------------------------------------
---------------------------------------------------------------------|||||-----------------------------------------%%%%%--------------------------------------------------------------------------------
---------------------------------------------------------------------|||||-----------------------------------------|||||--------------------------------------------------------------------------------
-----------------------------------------------#---#-----------------|g||g------------------#---#------------------|||||--------------------------------------------------------------------------------
----------------------%%%%--%%%%--------------##---##---%%%%---%%%%%%%%%%%%%%%%----%%--%%--##---##-----------------|||r|----r----#---#------------------------------------------------------------------
%%%%%%%%%%%%%-k-y-----||||--||||-------------###---###--||||---||||||||||||||||%%%%||--||%%%%---%%%%--------%%%%%%%%%%%%%%%%%%--##---##-----------------------------------------------------------------
|||||||||||||%%%%%%%%%||||--||||%%%%---%%%%%%%%%---%%%%%||||---||||||||||||||||||||||--||||||---||||----k---||||||||||||||||||%%%%---%%%%---------------------------------------------------------------
||||||||||||||||||||||||||--||||||||---|||||||||---|||||||||---||||||||||||||||||||||--||||||---||||XXXXXXXX||||||||||||||||||||||---||||XXXXXXXXFXXXXXXXXXXXXXXXXXXXXXXXXXXXXXXXXXXXXXXXXXXXXXXXXXXXXXX
