HEIGHT=16;WIDTH=201;THEME=0;OVERRIDE=false
--------------------------------------------------------------------------------------------------------------------------------------------------------------------------------------------------------
--------------------------------------------------------------------------------------------------------------------------------------------------------------------------------------------------------
--------------------------------------------------------------------------------------------------------------------------------------------------------------------------------------------------------
--------------------------------------------------------------------------------------------------------------------------------------------------------------------------------------------------------
--------------------------------------------------------------------------------------------------------------------------------------------------------------------------------------------------------
--------------------------------------------------------------------------------------------------------------------------------------------------------------------------------------------------------
--------------------------------------------------------------------------------------------------------------------------------------------------------------------------------------------------------
--------------------------------------------------------------------------------------------------------------------------------------------------------------------------------------------------------
----------------------------------------------------------------------------------------2SSS------------------------------------------------------------------------------------------------------------
--------------------------------------------------------------------------------------------------------------------------------------------------------------------------------------------------------
--------------------------------------------------------------------------------------------------------------------------------------------------------------------------------------------------------
--------------------------------------------------------------------------------------------------------------------------------------------------------------------------------------------------------
%%%%%%%%%%%------------%%%%%%-tt-tt----tt----------------------------------------------%%%%%%--g----%%%%%---%%%%%--Tt--tt-------------------------------------------------------------------------------
|||||||||||------------||||||-tt-tt----tt---------%%--%%%%%%%--%%%%%-------------------||||||%%%%%%%|||||---|||||--tt--tt-------------------------------------------------------------------------------
|||||||||||%%%%%--%%%%%||||||-tt-tt----tt----k--r-||--|||||||--|||||%%---%%%%%%%--%%%%%||||||||||||||||||---|||||--tt--tt---%%--%%%%%%--%%%%%%%%%%%%F%%%%%%%%%%%%%%%%%%%%%%%%%%%%%%%%%%%%%%%%%%%%%%%%%%%
||||||||||||||||--|||||||||||XXXXXXXXXXXXXXXXXXXXX||--|||||||--|||||||---|||||||--|||||||||||||||||||||||---|||||XXXXXXXXXXX||--||||||--||||||||||||X|||||||||||||||||||||||||||||||||||||||||||||||||||
