HEIGHT=16;WIDTH=201;THEME=0;OVERRIDE=false
--------------------------------------------------------------------------------------------------------------------------------------------------------------------------------------------------------
--------------------------------------------------------------------------------------------------------------------------------------------------------------------------------------------------------
--------------------------------------------------------------------------------------------------------------------------------------------------------------------------------------------------------
--------------------------------------------------------------------------------------------------------------------------------------------------------------------------------------------------------
--------------------------------------------------------------------------------------------------------------------------------------------------------------------------------------------------------
--------------------------------------------------------------------------------------------------------------------------------------------------------------------------------------------------------
--------------------------------------------------------------------------------------------------------------------------------------------------------------------------------------------------------
--------------------------------------------------------------------------------------------------------------------------------------------------------------------------------------------------------
------------------------------------------------------------------------------------------%%%-----------------------------------------------------------------------------------------------------------
------------------------------------------------------------------------------------------|||-----------------------------------------------------------------------------------------------------------
---------------#--#----------------------------------SSU----------------------------------|||-----------------------------------------------------------------------------------------------------------
--------------##--##--------------------------------------------------------#---#---------|||---------%%%----------tt-----------------------------------------------------------------------------------
%%%%%%%%%%%%%%%%--%%%%---------------------%%%%%%%------------------------%%%---%%%--%%%%%%||---------|||----------tt---------------------------%%%%%%%%F%%%%%%%%%%%%%%%%%%%%%%%%%%%%%%%%%%%%%%%%%%%%%%%
||||||||||||||||--||||---------------#--#--|||||||----g-------------%%--%%|||---|||--||||||||---------|||---------%%%%%%%%----------------------||||||||%|||||||||||||||||||||||||||||||||||||||||||||||
||||||||||||||||--||||-------------%%%--%%%|||||||--%%%%%%%%%%---%%%||--|||||---|||--||||g|||------k--|||-kg--r---||||||||----------------------||||||||||||||||||||||||||||||||||||||||||||||||||||||||
||||||||||||||||--||||XXXXX---XXXXX|||--||||||||||XX||||||||||---|||||--|||||---|||XXXXXXXXXXXXXXXXXXXXXXXXXXXXXXX||||||||XXXXXXXXXXXXXX---XXXXX||||||||||||||||||||||||||||||||||||||||||||||||||||||||
