HEIGHT=16;WIDTH=201;THEME=0;OVERRIDE=false
--------------------------------------------------------------------------------------------------------------------------------------------------------------------------------------------------------
--------------------------------------------------------------------------------------------------------------------------------------------------------------------------------------------------------
--------------------------------------------------------------------------------------------------------------------------------------------------------------------------------------------------------
--------------------------------------------------------------------------------------------------------------------------------------------------------------------------------------------------------
--------------------------------------------------------------------------------------------------------------------------------------------------------------------------------------------------------
--------------------------------------------------------------------------------------------------------------------------------------------------------------------------------------------------------
--------------------------------------------------------------------------------------------------------------------------------------------------------------------------------------------------------
--------------------------------------------------------------------------------------------------------------------------------------------------------------------------------------------------------
--------------------------------------------------------------------------------------------------------------------------------------------------------------------------------------------------------
-----------------------------------------------------------------------------------------------------tt--tt---------------------------------------------------------------------------------------------
------------------------------------------------------------------------------------------------Tt---tt--tt------------------------------#--#-----------------------------------------------------------
---------------------------------------------------------------------------------------#--#-----tt---tt--tt-----------------------------##--##----------------------------------------------------------
----------------------------------------%%%%%-----------------------------------------##--##--%%%%%%%%%%%%%%%%%%%---%%%%%--------------###--###---------------------------------------------------------
----------------------------%%%--%%---%%|||||-----------%%-------%%---%%------------%%%%--%%%%|||||||||||||||||||---|||||------------%%%%%--%%%%%%%%%%%%%F%%%%%%%%%%%%%%%%%%%%%%%%%%%%%%%%%%%%%%%%%%%%%%
%%%%%%%%%%-----------%%%%%%%|||%%||---|||||||%%%%---%%%%||-------||---||%%%%%--%%%%%||||--|||||||||||||||||||||||---|||||------------|||||--|||||||||||||%||||||||||||||||||||||||||||||||||||||||||||||
||||||||||XXXX---XXXX||||||||||||||---|||||||||||---||||||XX---XX||---|||||||--|||||||||--|||||||||||||||||||||||---|||||XXXXX--XXXXX|||||--||||||||||||||||||||||||||||||||||||||||||||||||||||||||||||
