HEIGHT=16;WIDTH=201;THEME=0;OVERRIDE=false
--------------------------------------------------------------------------------------------------------------------------------------------------------------------------------------------------------
--------------------------------------------------------------------------------------------------------------------------------------------------------------------------------------------------------
--------------------------------------------------------------------------------------------------------------------------------------------------------------------------------------------------------
--------------------------------------------------------------------------------------------------------------------------------------------------------------------------------------------------------
--------------------------------------------------------------------------------------------------------------------------------------------------------------------------------------------------------
--------------------------------------------------------------------------------------------------------------------------------------------------------------------------------------------------------
--------------------------------------------------------------------------------------------------------------------------------------------------------------------------------------------------------
--------------------------------------------------------------------------------------------------------------------------------------------------------------------------------------------------------
--------------------------------------------------------------------------------------------------------------------------------------------------------------------------------------------------------
--------------------------------------------------------------------------------------------------------------------------------------------------------------------------------------------------------
------------------------------------------------------------------#---#----------------------------------------------------%%%%%%%----------------------------------------------------------------------
-----------------------------------------------------------------##---##------------------#--#-----------------------------|||||||----------------------------------------------------------------------
-------------------------%%%%%--%%%%%---------------------------###---###---------------%%%--%%%----tt----tt---------------|y|||||----------------------------------------------------------------------
%%%%%%%%%%%%%------------|||||--|||||-------------------------%%%%%---%%%%%-------------|||--|||----tt----tt---------%%%%%%%%%%%%%%%%%%-----------------------------------------------------------------
|||||||||||||------------|||||--|||||%%%%%---%%%%%%%%%%--%%%%%|||||---|||||%%%%%---%%%%%|||--|||%%%%%%%%%%%%%%-------||||||||||||||||||-----------------------------------------------------------------
|||||||||||||XXXXX--XXXXX|||||--||||||||||---||||||||||--||||||||||---||||||||||---||||||||--|||||||||||||||||XXXXXXX||||||||||||||||||XXXX--XXXXXXXXXXXXFXXXXXXXXXXXXXXXXXXXXXXXXXXXXXXXXXXXXXXXXXXXXXX
