HEIGHT=16;WIDTH=201;THEME=0;OVERRIDE=false
--------------------------------------------------------------------------------------------------------------------------------------------------------------------------------------------------------
--------------------------------------------------------------------------------------------------------------------------------------------------------------------------------------------------------
--------------------------------------------------------------------------------------------------------------------------------------------------------------------------------------------------------
--------------------------------------------------------------------------------------------------------------------------------------------------------------------------------------------------------
--------------------------------------------------------------------------------------------------------------------------------------------------------------------------------------------------------
---------------------------------------CCUSS------------------------------------------------------------------------------------------------------------------------------------------------------------
--------------------------------------------------------------------------------------------------------------------------------------------------------------------------------------------------------
--------------------------------------------------------------------------------------------------------------------------------------------------------------------------------------------------------
-------------------------------------r------------------------------------------------------------------------------------------------------------------------------------------------------------------
-------------------------------------%%%%%%%-------------SCCCS--------------------------------------------------%%%%%%-------SCC2CC2S-------------------------------------------------------------------
-----------------------%%%-----------|||||||--------------------------------------------------------------------||||||-gk-------------------------------------------------------------------------------
-----------------------|||-----------|||k|||---y------------------------------------------------------------k---|||%%%%%%-------------------------------------------------------------------------------
%%%%%%%%%%%%%%%---%%%--|%%%%%%%---%%%%%%%%%%%%%%%-----------r-----------------------#--#-----#---#---%%%%%%%%%--|||||||||----k------y-------------------------------------------------------------------
|||||||||||||||---|||--|k|||||y---|||||||||||||||------%%%%%%%%-------------%%%%%%%%%--%%%--##---##--|||||||||--|||||r|||--%%%%%%%%%%%------------------------------------------------------------------
|||||||||||||||---|||%%%%%%%%%%%%%|||||||||||||||------||||||||%%%%%---%%%%%|||||||||--|||%%%%---%%%%|||||||||%%%%%%%%%%%%%|||||||||||%%%%%%%%%%%%F%%%%%%%%%%%%%%%%%%%%%%%%%%%%%%%%%%%%%%%%%%%%%%%%%%%%%
|||||||||||||||---|||||||||||||||||||||||||||||||XX--XX|||||||||||||---||||||||||||||--|||||||---|||||||||||||||||||||||||||||||||||||||||||||||||X|||||||||||||||||||||||||||||||||||||||||||||||||||||
