HEIGHT=16;WIDTH=201;THEME=0;OVERRIDE=false
--------------------------------------------------------------------------------------------------------------------------------------------------------------------------------------------------------
--------------------------------------------------------------------------------------------------------------------------------------------------------------------------------------------------------
--------------------------------------------------------------------------------------------------------------------------------------------------------------------------------------------------------
--------------------------------------------------------------------------------------------------------------------------------------------------------------------------------------------------------
--------------------------------------------------------------------------------------------------------------------------------------------------------------------------------------------------------
--------------------------------------------------------------------------------------------------------------------------------------------------------------------------------------------------------
--------------------------------------------------------------------------------------------------------------------------------------------------------------------------------------------------------
--------------------------------------------------------------------------------------------------------------------------------------------------------------------------------------------------------
---------------------------------------------------------------y---k-----------------------------------------------------------------UCSS---------------------------------------------------------------
---------------------------------------------------------------%%%%%------------------------------------------------------------------------------------------------------------------------------------
------------------------------------------------------#--#-----|||||------------------------------------------------------------------------------------------------------------------------------------
----------------tt-tt--------------------------------##--##----k||||-g------g-------------------2SCSCCS2---UC2C----#---#------------k-------------------------------------------------------------------
----------------tt-tt--%%%%%%---#--#---%%%%%%---%%%%%%%--%%%%%%%%%%%%%%%%%%%%%-----------------------------------%%%---%%%--#--#--%%%%%%%%%-------------------------------------------------------------
----------------tt-tt--||||||--##--##--||||||---|||||||--|||||||||||||||||||||%%---%%----------%-----------------|||---|||%%%--%%%|||||||||-------------------------------------------------------------
--------------%%%%%%%%%||||||%%%%--%%%%||||||---|||||||--|||||||||||||||||||||||---||%%%%%%%%%-|------k-------k--|||---||||||--||||||||||||%%%%%%%%F%%%%%%%%%%%%%%%%%%%%%%%%%%%%%%%%%%%%%%%%%%%%%%%%%%%%
XXXXXXXXXXXXXX|||||||||||||||||||--||||||||||---|||||||--|||||||||||||||||||||||---|||||||||||XXXXXXXXXXXXXXXXXXX|||---||||||--||||||||||||||||||||X||||||||||||||||||||||||||||||||||||||||||||||||||||
