HEIGHT=16;WIDTH=201;THEME=0;OVERRIDE=false
--------------------------------------------------------------------------------------------------------------------------------------------------------------------------------------------------------
--------------------------------------------------------------------------------------------------------------------------------------------------------------------------------------------------------
--------------------------------------------------------------------------------------------------------------------------------------------------------------------------------------------------------
--------------------------------------------------------------------------------------------------------------------------------------------------------------------------------------------------------
--------------------------------------------------------------------------------------------------------------------------------------------------------------------------------------------------------
--------------------------------------------------------------------------------------------------------------------------------------------------------------------------------------------------------
--------------------------------------------------------------------------------------------------------------------------------------------------------------------------------------------------------
--------------------------------------------------------------------------------------------------------------------------------------------------------------------------------------------------------
--------------------------------------------------------------------------------------------------------------------------------------------------------------------------------------------------------
--------------------------------------------------------------------------------------------------------------------------------------------------------------------------------------------------------
--------------------------------------------------------------------------------------------------------------------------------------------------------------------------------------------------------
------------------------------#---#------------#--#-----------------------------------------------------------------------------------------------------------------------------------------------------
%%%%%%%%%%%%%---tt---tt------##---##--%%---%%%%%--%%%------------g---------#---#------------------------------------------------------------------------------------------------------------------------
|||||||||||||---tt---tt----%%%%---%%%%||---|||||--|||------------%%%------##---##-----------------------------------Tt--tt------------------------------------------------------------------------------
|||||||||||||%%%%%%%%%%%%%%||||---||||||---|||||--|||----r-------|||----%%%%---%%%%--------------------%%%---%%%----tt--tt----------%%--%%%%%%%%%%F%%%%%%%%%%%%%%%%%%%%%%%%%%%%%%%%%%%%%%%%%%%%%%%%%%%%%
|||||||||||||||||||||||||||||||---||||||---|||||--|||XXXXXXXXXXXXXXXXXXX||||---||||XXXXXXXX--XXXXX---XX|||---|||XXXXXXXXXXXXXXX---XX||--||||||||||X|||||||||||||||||||||||||||||||||||||||||||||||||||||
