HEIGHT=16;WIDTH=201;THEME=0;OVERRIDE=false
--------------------------------------------------------------------------------------------------------------------------------------------------------------------------------------------------------
--------------------------------------------------------------------------------------------------------------------------------------------------------------------------------------------------------
--------------------------------------------------------------------------------------------------------------------------------------------------------------------------------------------------------
--------------------------------------------------------------------------------------------------------------------------------------------------------------------------------------------------------
--------------------------------------------------------------------------------------------------------------------------------------------------------------------------------------------------------
--------------------------------------------------------------------------------------------------------------------------------------------------------------------------------------------------------
--------------------------------------------------------------------------------------------------------------------------------------------------------------------------------------------------------
--------------------------------------------------------------------------------------------------------------------------------------------------------------------------------------------------------
---------------------------------------------------------------------------------------------------------------SCS--------------------------------------------------------------------------------------
--------------------------------------------------------------------------------------------------------------------------------------------------------------------------------------------------------
--------------------------------------------------------------------------------------------------------------------------------------------------------------------------------------------------------
----------------------#--#------#---#-----------------------------SSSCSU-------------------------------------g------------------------------------------------------------------------------------------
---------------------##--##----##---##--%%%%%--%%%%%-------------------------------------------------------%%%%%%%%%%------%%%%--%%%%-------------------------------------------------------------------
%%%%%%%%%%%%%%%%%%%%%%%--%%%%%%%%---%%%%|||||--|||||----%%%---%%%------------------------%%--%%------------||||||||||------||||--||||-------------------------------------------------------------------
|||||||||||||||||||||||--||||||||---|||||||||--|||||%%--|||---|||-G-g----g--%%%%%---%%%%%||--||------------||||||||||------||||--||||%%%%--%%%%%%%%%%%%F%%%%%%%%%%%%%%%%%%%%%%%%%%%%%%%%%%%%%%%%%%%%%%%%
|||||||||||||||||||||||--||||||||---|||||||||--|||||||XX|||---|||XXXXXXXXXXX|||||---|||||||--||XX--XXXX--XX||||||||||XX--XX||||--||||||||--||||||||||||X||||||||||||||||||||||||||||||||||||||||||||||||
