HEIGHT=16;WIDTH=201;THEME=0;OVERRIDE=false
--------------------------------------------------------------------------------------------------------------------------------------------------------------------------------------------------------
--------------------------------------------------------------------------------------------------------------------------------------------------------------------------------------------------------
--------------------------------------------------------------------------------------------------------------------------------------------------------------------------------------------------------
--------------------------------------------------------------------------------------------------------------------------------------------------------------------------------------------------------
--------------------------------------------------------------------------------------------------------------------------------------------------------------------------------------------------------
--------------------------------------------------------------------------------------------------------------------------------------------------------------------------------------------------------
--------------------------------------------------------------------------------------------------------------------------------------------------------------------------------------------------------
--------------------------------------------------------------------------------------------------------------------------------------------------------------------------------------------------------
--------------------------------------------------------------------------------------------------------------------------------------------------------------------------------------------------------
--------------------------------------------------------------------#--#--------------------------------------------------------------------------------------------------------------------------------
-------------------------------------------------------------------##--##---------#--#------------------------------------------------------------------------------------------------------------------
---------------tt---#---#-----------------------------------------###--###-------##--##-----------------------------------------------2S2---------------------------------------------------------------
---------------tt-%%%---%%%------%%%--%%%----------#--#---------%%%%%--%%%%%%%--###--###------#---#-----------------------------------------------------------------------------------------------------
-----------%%%%%%%|||---|||------|||--|||---------##--##--%%--%%|||||--|||||||%%%%%--%%%%%---##---##---%%%%--%%%%---------------------------%%%%%%%%F%%%%%%%%%%%%%%%%%%%%%%%%%%%%%%%%%%%%%%%%%%%%%%%%%%%
-----------||||||||||---|||%%--%%|||--|||-------%%%%--%%%%||--|||||||--||||||||||||--|||||--###---###--||||--||||--------------------k--y---||||||||%|||||||||||||||||||||||||||||||||||||||||||||||||||
XXXXXXXXXXX||||||||||---|||||--|||||--|||XX---XX||||--||||||--|||||||--||||||||||||--|||||XXXXX---XXXXX||||--||||XXXX--XXXXXXXXXXXXXXXXXXXXX||||||||||||||||||||||||||||||||||||||||||||||||||||||||||||
