HEIGHT=16;WIDTH=201;THEME=0;OVERRIDE=false
--------------------------------------------------------------------------------------------------------------------------------------------------------------------------------------------------------
--------------------------------------------------------------------------------------------------------------------------------------------------------------------------------------------------------
--------------------------------------------------------------------------------------------------------------------------------------------------------------------------------------------------------
--------------------------------------------------------------------------------------------------------------------------------------------------------------------------------------------------------
--------------------------------------------------------------------------------------------------------------------------------------------------------------------------------------------------------
------------------------------------------SUSSC----------------------------------------------------------------------%%%--------------------------------------------------------------------------------
---------------------------------------------------------------------------------------------------------------------|||--------------------------------------------------------------------------------
---------------------------------------------------------------------------------------------------------------------|||--------------------------------------------------------------------------------
------------------------------------------g-g------------------------------------------------------------------------|||-k------------------------------------------------------------------------------
------------------------------------------%%%%%%%---------CSU2-------------------------------------------------------||%%%%-------Tt--------------------------------------------------------------------
------------------------------------------|||||||-----------------------------------------------------------#--#-----||||||-------tt----tt--------------------------------------------------------------
-------------------------------Tt---Tt----|||y|||---------------------%%%%---------------------------------##--##----||||||-------tt----tt--------------------------------------------------------------
-------------------------------tt---tt---%%%%%%%%%%%%%%%--------------||||--------------------------------###--###---||||||------%%%%%%%%%%%%%%---------------------------------------------------------
------------%%%%--%%%%%%%--%%%-tt---tt---|||||||||||||||%%%%%%%%------||||------%%%%%--%%%%%------------%%%%%--%%%%%%%%%%%%%%%%%%||||||||||||||%%%%%%%%F%%%%%%%%%%%%%%%%%%%%%%%%%%%%%%%%%%%%%%%%%%%%%%%%
------------||||--|||||||--|||%%%%%%%%%%%|||||||||||||||||||||||------kk||------|||||--|||||------------|||||--||||||||||||||||||||||||||||||||||||||||%||||||||||||||||||||||||||||||||||||||||||||||||
XXXXXXXXXXXX||||--|||||||--|||||||||||||||||||||||||||||||||||||XXXXXXXXXXXXXXXX|||||--|||||XXXXX--XXXXX|||||--|||||||||||||||||||||||||||||||||||||||||||||||||||||||||||||||||||||||||||||||||||||||||
