HEIGHT=16;WIDTH=201;THEME=0;OVERRIDE=false
--------------------------------------------------------------------------------------------------------------------------------------------------------------------------------------------------------
--------------------------------------------------------------------------------------------------------------------------------------------------------------------------------------------------------
--------------------------------------------------------------------------------------------------------------------------------------------------------------------------------------------------------
--------------------------------------------------------------------------------------------------------------------------------------------------------------------------------------------------------
--------------------------------------------------------------------------------------------------------------------------------------------------------------------------------------------------------
--------------------------------------------------------------------------------------------------------------------------------------------------------------------------------------------------------
--------------------------------------------------------------------------------------------------------------------------------------------------------------------------------------------------------
--------------------------------------------------------------------------------------------------------------------------------------------------------------------------------------------------------
--------------------------------------------------------------------------------------------------------------------------------------------------------------------------------------------------------
--------------------------------------------------------------------------------------------------------------#---#-------------------------------------------------------------------------------------
-------------------------------------------------------------------------------------------------------------##---##------------------------------------------------------------------------------------
----------------------------------SUSC----------------------------------------------------------------------###---###-----------------------------------------------------------------------------------
---------------------%%%%%--%%%%%-------------------%%%%--%%%%--k-----------#---#--------#---#------------%%%%%---%%%%%--------%%%%---%%%%%%%%%%%%F%%%%%%%%%%%%%%%%%%%%%%%%%%%%%%%%%%%%%%%%%%%%%%%%%%%%%
---------------------|||||--|||||---------%%%%--%%%%||||--||||%%%%%%%------##---##-----%%%---%%%----------|||||---|||||%%%--%%%||||---||||||||||||%|||||||||||||||||||||||||||||||||||||||||||||||||||||
%%%%%%%%%%%%%%%%---%%|||||--|||||---yk----||||--||||||||--|||||||||||%%%%%%%%---%%%%---|||---|||----------|||||---||||||||--|||||||---||||||||||||||||||||||||||||||||||||||||||||||||||||||||||||||||||
||||||||||||||||---|||||||--|||||XXXXXXXXX||||--||||||||--|||||||||||||||||||---||||XXX|||---|||XXXX--XXXX|||||---||||||||--|||||||---||||||||||||||||||||||||||||||||||||||||||||||||||||||||||||||||||
