HEIGHT=16;WIDTH=201;THEME=0;OVERRIDE=false
--------------------------------------------------------------------------------------------------------------------------------------------------------------------------------------------------------
--------------------------------------------------------------------------------------------------------------------------------------------------------------------------------------------------------
--------------------------------------------------------------------------------------------------------------------------------------------------------------------------------------------------------
--------------------------------------------------------------------------------------------------------------------------------------------------------------------------------------------------------
--------------------------------------------------------------------------------------------------------------------------------------------------------------------------------------------------------
--------------------------------------------------------------------------------------------------------------------------------------------------------------------------------------------------------
--------------------------------------------------------------------------------------------------------------------------------------------------------------------------------------------------------
----------------------------y---------------------------y-----------------------------------------------------------------------------------------------------------------------------------------------
--------------------------%%%%%%%-----------------------%%%---------------------------------------------------------------------------------------------------------------------------------------------
--------------------------|||||||-----------------------|||---------SCS-2-------------------------------------------------------------------------------------------------------------------------------
--------------------------|||||||-----------------------|||---------------------------------------------------------------------------------------------------------------------------------------------
--------------------------|||||k|k-----------#--#-------|%%%%----------%------------------------------------Tt---tt-------------------------------------------------------------------------------------
-------------------------%%%%%%%%%%%%%-----%%%--%%%%%%--|||||----------|-------#---#------------------------tt---tt--tt----#--#---%%%%------------------------------------------------------------------
%%%%%%%%%%%%%%-----------|||||||||||||-----|||--||||||--|||||----%%%%%%%%%%%--##---##-----------------------tt---tt--tt---##--##--||||------------------------------------------------------------------
||||||||||||||%%%%---%%%%|||||||||||||%%%%%|||--||||||--|||||Y---|||||||||||%%%%---%%%%%%---%%%%%%%--%%%%%%%%%%%%%%%%%%%%%%%--%%%%||||%%%%--%%%%--------------------------------------------------------
||||||||||||||||||---|||||||||||||||||||||||||--||||||XXXXXXXXXXX|||||||||||||||---||||||---|||||||--|||||||||||||||||||||||--||||||||||||--||||XXXXXXXXFXXXXXXXXXXXXXXXXXXXXXXXXXXXXXXXXXXXXXXXXXXXXXXX
