HEIGHT=16;WIDTH=201;THEME=0;OVERRIDE=false
--------------------------------------------------------------------------------------------------------------------------------------------------------------------------------------------------------
--------------------------------------------------------------------------------------------------------------------------------------------------------------------------------------------------------
--------------------------------------------------------------------------------------------------------------------------------------------------------------------------------------------------------
--------------------------------------------------------------------------------------------------------------------------------------------------------------------------------------------------------
--------------------------------------------------------------------------------------------------------------------------------------------------------------------------------------------------------
--------------------------------------------------------------------------------------------------------------------------------------------------------------------------------------------------------
--------------------------------------------------------------------------------------------------------------------------------------------------------------------------------------------------------
--------------------------------------------------------------------------------------------------------------------------------------------------------------------------------------------------------
--------------------------------------------------------------------SCUUS-S-----------------------------------------------------------------------------------------------------------------------------
--------------------------------------------------------------------------------------------------------------------------------------------------------------------------------------------------------
-------------------------------------------------------------------------%-------------U2---------------------------------------------------------------------------------------------------------------
--------------------------------------------------------------------ggg--|------------------------------------------------------------------------------------------------------------------------------
%%%%%%%%%%-------------%%%----------------------%%%---%%%%%%%--%%%%%%%%%%%%%----------%---------#---#---------------------------------------------------------------------------------------------------
||||||||||-------------|||----------------------|||---|||||||--|||||||||||||---------g|---G----##---##----%%%---%%%%%---%%------%%%%---%%%%%%%%%%%%F%%%%%%%%%%%%%%%%%%%%%%%%%%%%%%%%%%%%%%%%%%%%%%%%%%%%
||||||||||%%%%---%%%%--|||-----------r-%%%%---%%|||---|||||||--|||||||||||||------%%%%%%%%%%%%%%%---%%%%%%|||---|||||---||------||||---||||||||||||%||||||||||||||||||||||||||||||||||||||||||||||||||||
||||||||||||||---||||XXXXXXXXXXXXXXXXXX||||---|||||---|||||||--|||||||||||||XX--XX|||||||||||||||---|||||||||---|||||---||XXXXXX||||---|||||||||||||||||||||||||||||||||||||||||||||||||||||||||||||||||
