HEIGHT=16;WIDTH=201;THEME=0;OVERRIDE=false
--------------------------------------------------------------------------------------------------------------------------------------------------------------------------------------------------------
--------------------------------------------------------------------------------------------------------------------------------------------------------------------------------------------------------
--------------------------------------------------------------------------------------------------------------------------------------------------------------------------------------------------------
--------------------------------------------------------------------------------------------------------------------------------------------------------------------------------------------------------
--------------------------------------------------------------------------------------------------------------------------------------------------------------------------------------------------------
--------------------------------------------------------------------------------------------------------------------------------------------------------------------------------------------------------
----------------------------------------------------------------------------------------S2-2------------------------------------------------------------------------------------------------------------
--------------------------------------------------------------------------------------------------------------------------------------------------------------------------------------------------------
------------------------------------------------------------------------------------------%-------------------------------------------------------------------------------------------------------------
--------------------------------------------------------Tt--------------------------------|-y-----------------------------------------------------------------------------------------------------------
----------------------------------S2S---------------Tt--tt-----------------------------%%%%%%%----------------------------------------------------------------------------------------------------------
---------------k--------------------------------Tt--tt--tt-----------------------------|||rg||------------------#---#-----------------------------------------------------------------------------------
%%%%%%%%%%%%%%%%%%%-----------------------------tt-%%%%%%%%%%%%---%%%%-------%%%%%%%%%%%%%%%%%%%%%%%%---%%%%%--##---##----------------------------------------------------------------------------------
|||||||||||||||||||-------------------%%--%%----tt-||||||||||||---||||-------||||||||||||||||||||||||---|||||%%%%---%%%%%%---%%-------------------------------------------------------------------------
|||||||||||||||||||-------------%%%%%%||--||%%%%%%%||||||||||||---||||-------||||||||||||||||||||||||---|||||||||---||||||---||-------------------------------------------------------------------------
|||||||||||||||||||XXXXX---XXXXX||||||||--|||||||||||||||||||||---||||XX---XX||||||||||||||||||||||||---|||||||||---||||||---||XXXX---XXXXXXXXXXXXFXXXXXXXXXXXXXXXXXXXXXXXXXXXXXXXXXXXXXXXXXXXXXXXXXXXXX
