HEIGHT=16;WIDTH=201;THEME=0;OVERRIDE=false
--------------------------------------------------------------------------------------------------------------------------------------------------------------------------------------------------------
--------------------------------------------------------------------------------------------------------------------------------------------------------------------------------------------------------
--------------------------------------------------------------------------------------------------------------------------------------------------------------------------------------------------------
--------------------------------------------------------------------------------------------------------------------------------------------------------------------------------------------------------
--------------------------------------------------------------------------------------------------------------------------------------------------------------------------------------------------------
--------------------------------------------------------------------------------------------------------------------------------------------------------------------------------------------------------
--------------------------------------------------------------------------------------------------------------------------------------------------------------------------------------------------------
-----------------------------------------------------------------------------------------SCSUS----------------------------------------------------------------------------------------------------------
---------------------------------------------------------------------------------------------------------------------------------------CSSS2------------------------------------------------------------
---------------------------------------------------------SS2-----------------S2SS-----------------------------------------------------------------------------------------------------------------------
---------------------------------------------------------------------------------------------r--------------------%%%%----------------------------------------------------------------------------------
-----------------------------------------------------------------------------------------%%%%%--------------------||||----------------------------------------------------------------------------------
----------------------#--#--%%%---%%%---------------------y------------------------------|||||--------------------||||---------------%%%%%%%%%%%%%%%%%%%F%%%%%%%%%%%%%%%%%%%%%%%%%%%%%%%%%%%%%%%%%%%%%%%
%%%%%%%%%%----------%%%--%%%|||---|||%%%%%%-tt---Tt----%%%%%%%%%%%%%--------%%%%%%-------|||||--------------%%%%%%%%%%%%%%%%%%--%%%%%|||||||||||||||||||%|||||||||||||||||||||||||||||||||||||||||||||||
||||||||||----------|||--||||||---|||||||||-tt---tt----|||||||||||||--------||||||-------|||||--%%--%%%%--%%||||||||||||||||||--||||||||||||||||||||||||||||||||||||||||||||||||||||||||||||||||||||||||
||||||||||XXXX--XXXX|||--||||||---|||||||||XXXXXXXXXXXX|||||||||||||XXX--XXX||||||XXXXXXXXXXXXXX||--||||--||||||||||||||||||||--||||||||||||||||||||||||||||||||||||||||||||||||||||||||||||||||||||||||
