HEIGHT=16;WIDTH=201;THEME=0;OVERRIDE=false
--------------------------------------------------------------------------------------------------------------------------------------------------------------------------------------------------------
--------------------------------------------------------------------------------------------------------------------------------------------------------------------------------------------------------
--------------------------------------------------------------------------------------------------------------------------------------------------------------------------------------------------------
--------------------------------------------------------------------------------------------------------------------------------------------------------------------------------------------------------
--------------------------------------------------------------------------------------------------------------------------------------------------------------------------------------------------------
--------------------------------------------------------------------------------------------------------------------------------------------------------------------------------------------------------
----------------------------------------------------------------------------------------------------y---------------------------------------------------------------------------------------------------
------------------------------------------------------------------------------------------------%%%%%---------------------------------------------------------------------------------------------------
---------------------------------------------------%%%%%%%--------------------------------------|||||---------------------------------------------------------------------------------------------------
---------------------------------------------SSCS--|||||||--------------------------------------|||||---------------------------------------------------------------------------------------------------
---------------------------------------------------|||||||--------------------------------------||||k---------------%%%%--------------------------------------------------------------------------------
----------------------tt---------------------------|||||||-------------K------------------------||%%%%%-------------||g|-k------r-----------------------------------------------------------------------
----------------------tt---Tt----------------------|||%%%%%%------%%%%%%%-------%%%%%---%%%%%---|||||||------------%%%%%%%%%%%%%%%----------------------------------------------------------------------
--------------%%%%%%--tt---tt---%%%%---%%%%%%%%%%%-||||||r||------|||||||-------|||||---|||||---|||k|||------------|||||||||||||||-----------%%%%%%%%F%%%%%%%%%%%%%%%%%%%%%%%%%%%%%%%%%%%%%%%%%%%%%%%%%%
%%%%%%%%%%%%%%||||||%%%%%%%%%%%%||||---|||||||||||%%%%%%%%%%%%%%%%|||||||---g-r-|||||---|||||%%%%%%%%%%%%%%%%--%%%%|||||||||||||||%%%%---%%%%||||||||%||||||||||||||||||||||||||||||||||||||||||||||||||
||||||||||||||||||||||||||||||||||||---||||||||||||||||||||||||||||||||||XXXXXXX|||||---|||||||||||||||||||||--|||||||||||||||||||||||---|||||||||||||||||||||||||||||||||||||||||||||||||||||||||||||||
