HEIGHT=16;WIDTH=201;THEME=0;OVERRIDE=false
--------------------------------------------------------------------------------------------------------------------------------------------------------------------------------------------------------
--------------------------------------------------------------------------------------------------------------------------------------------------------------------------------------------------------
--------------------------------------------------------------------------------------------------------------------------------------------------------------------------------------------------------
--------------------------------------------------------------------------------------------------------------------------------------------------------------------------------------------------------
--------------------------------------------------------------------------------------------------------------------------------------------------------------------------------------------------------
--------------------------------------------------------------------------------------------------------------------------------------------------------------------------------------------------------
--------------------------------------------------------------------------------------------------------------------------------------------------------------------------------------------------------
--------------------------------------------------------------------------------------------------------------------------------------------------------------------------------------------------------
---------------------------------------------------UU2SC2-----------------------------------------------------------------------------------------------------------------------------------------------
------------------------------yr-g---------------------------------%%%%%--------------------------------------------------------------------------------------------------------------------------------
-----------------------------%%%%%%--------------------------------|||||----%%%---------#--#-------#--#-------------------------------------------------------------------------------------------------
-----------------------------||||||--------------------------------|||||----|||--------##--##-----##--##------------------------------------------------------------------------------------------------
%%%%%%%%%%%%-----------------||||||--r-%%%---%%%%%%%%%%%%%-----g---|||K|----|||----K-%%%%--%%%%--###--###--%%%%%---%%%%%------%%%%%--%%%%%--------------------------------------------------------------
||||||||||||--------%%%%%%%%%%%%%%%%%%%|||---|||||||||||||%%%%%%%%%%%%%%%%%%%%%%%%%%%||||--||||%%%%%--%%%%%|||||---|||||------|||||--|||||--------------------------------------------------------------
||||||||||||--------||||||||||||||||||||||---||||||||||||||||||||||||||||||||||||||||||||--|||||||||--||||||||||---|||||%%--%%|||||--|||||--------------------------------------------------------------
||||||||||||XXX--XXX||||||||||||||||||||||---||||||||||||||||||||||||||||||||||||||||||||--|||||||||--||||||||||---|||||||--|||||||--|||||XXXXXXXXFXXXXXXXXXXXXXXXXXXXXXXXXXXXXXXXXXXXXXXXXXXXXXXXXXXXXX
