HEIGHT=16;WIDTH=201;THEME=0;OVERRIDE=false
--------------------------------------------------------------------------------------------------------------------------------------------------------------------------------------------------------
--------------------------------------------------------------------------------------------------------------------------------------------------------------------------------------------------------
--------------------------------------------------------------------------------------------------------------------------------------------------------------------------------------------------------
--------------------------------------------------------------------------------------------------------------------------------------------------------------------------------------------------------
-------------------------------------------------------------------------2SCSCS-------------------------------------------------------------------------------------------------------------------------
--------------------------------------------------------------------------------------------------------------------------------------------------------------------------------------------------------
--------------------------------------------------------------------------------------------------------------------------------------------------------------------------------------------------------
--------------------------------------------------------------------------------------------------------------------------------------------------------------------------------------------------------
-------------------------------------------------------------------------%%%%%%-----------------------------------------y-------------------------------------------------------------------------------
--------------------------------#---#------------------------------------||||||----------------------------------------%%%%%%%--------------------------------------------------------------------------
-------------------------------##---##-----------------------------------||||||----------------------------------------|||||||--------------------------------------------------------------------------
------------------------------###---###----------------------------------|%%%%%%%----------------------------------%%%%%%|||||--------------------------------------------------------------------------
----------------------------%%%%%---%%%%%------------------%%%%--%%%%----||||||||------------------------#---#-----|||||||||||--------------------------------------------------------------------------
%%%%%%%%%%%%%%--%%%%--------|||||---|||||--------------y---||||--||||--g-||y|||||-----------------------##---##----g||||r|||||--------------------------------------------------------------------------
||||||||||||||--||||--------|||||---|||||--#--#--%%%%%%%%%%||||--||||%%%%%%%%%%%%%%%%%%%%%%--%%-------%%%%---%%%%%%%%%%%%%%%%%%%%%%%--%%%---------------------------------------------------------------
||||||||||||||--||||XXX--XXX|||||---|||||XXX--XXX||||||||||||||--||||||||||||||||||||||||||--||XX---XX||||---|||||||||||||||||||||||--|||XXXXXXXXFXXXXXXXXXXXXXXXXXXXXXXXXXXXXXXXXXXXXXXXXXXXXXXXXXXXXXX
