HEIGHT=16;WIDTH=201;THEME=0;OVERRIDE=false
--------------------------------------------------------------------------------------------------------------------------------------------------------------------------------------------------------
--------------------------------------------------------------------------------------------------------------------------------------------------------------------------------------------------------
--------------------------------------------------------------------------------------------------------------------------------------------------------------------------------------------------------
--------------------------------------------------------------------------------------------------------------------------------------------------------------------------------------------------------
--------------------------------------------------------------------------------------------------------------------------------------------------------------------------------------------------------
--------------------------------------------------------------------------------------------------------------------------------------------------------------------------------------------------------
--------------------------------------------------------------------------------------------------------------------------------------------------------------------------------------------------------
--------------------------------------------------------------------------------------------------------------------------------------------------------------------------------------------------------
-----------------------------------------------------------------------------------------------------------------------------------------r--------------------------------------------------------------
---------------------------------------------------------------------------------------------------------------------------------------%%%%-------------------------------------------------------------
------------------------------------------------------------------------------------------CSS---Gk-------------------------------------||||-------------------------------------------------------------
-------------#--#------------------------#---#-------------------------------------------------%%%%%%--------------------------g---g-k-||||gr-----------------------------------------------------------
-----------%%%--%%%---%%--%%-----------%%%---%%%------------------%%%--%%%%%%%%---%%%%%--%-----|||||g-------------------%%%%%%%%%%%%%%%%%%%%%%----------------------------------------------------------
-----------|||--|||---||--||%%%%---%%%%|||---|||------------------|||--||||||||---|||||--|----%%%%%%%%%%%---------------||||||||||||||||||||||%%%%%%%%F%%%%%%%%%%%%%%%%%%%%%%%%%%%%%%%%%%%%%%%%%%%%%%%%%
-----------|||--|||%%%||--||||||---|||||||---|||-----%%%%%---%%%%%|||--||||||||---|||||%%%%%%%|||||||||||%%---%%%%%%%%%%||||||||||||||||||||||||||||||%|||||||||||||||||||||||||||||||||||||||||||||||||
XXXXXXXXXXX|||--||||||||--||||||---|||||||---|||XXXXX|||||---||||||||--||||||||---|||||||||||||||||||||||||---||||||||||||||||||||||||||||||||||||||||||||||||||||||||||||||||||||||||||||||||||||||||||
