HEIGHT=16;WIDTH=201;THEME=0;OVERRIDE=false
--------------------------------------------------------------------------------------------------------------------------------------------------------------------------------------------------------
--------------------------------------------------------------------------------------------------------------------------------------------------------------------------------------------------------
--------------------------------------------------------------------------------------------------------------------------------------------------------------------------------------------------------
--------------------------------------------------------------------------------------------------------------------------------------------------------------------------------------------------------
--------------------------------------------------------------------------------------------------------------------------------------------------------------------------------------------------------
--------------------------------------------------------------------------------------------------------------------------------------------------------------------------------------------------------
--------------------------------------------------------------------------------------------------------------------------------------------------------------------------------------------------------
--------------------------------------------------------------------------------------------------------------------------------------------------------------------------------------------------------
--------------------------------------------------------------------------------------------------------------------------------------------------------------------------------------------------------
------------SSSSCSSS------------------------------------------------------------------------------------------------------------------------------------------------------------------------------------
--------------------------------------------------------------------------------#--#------------------#---#---------------------------------------------------------------------------------------------
--------------------%----------------------------------------------------------##--##----------------##---##--------------------------------------------------------------------------------------------
-----------------yy-|----------------#---#---------------%%%%--%%%%----------%%%%--%%%%%%%%%--%%%%%%%%%---%%%%---------------------#---#----------------------------------------------------------------
-----------%%%%%%%%%%%------%%--%%--##---##--%%%%%--%%%%%||||--||||----------||||--|||||||||--|||||||||---||||-------------------%%%---%%%--------------------------------------------------------------
-----------|||||||||||------||--||%%%%---%%%%|||||--|||||||||--||||%%%%--%%%%||||--|||||||||--|||||||||---||||-----------%%%--%%%|||---|||%%%%%%%%F%%%%%%%%%%%%%%%%%%%%%%%%%%%%%%%%%%%%%%%%%%%%%%%%%%%%%
XXXXXXXXXXX|||||||||||XX--XX||--||||||---|||||||||--|||||||||--||||||||--||||||||--|||||||||--|||||||||---||||XXXX---XXXX|||--||||||---|||||||||||X|||||||||||||||||||||||||||||||||||||||||||||||||||||
