HEIGHT=16;WIDTH=201;THEME=0;OVERRIDE=false
--------------------------------------------------------------------------------------------------------------------------------------------------------------------------------------------------------
--------------------------------------------------------------------------------------------------------------------------------------------------------------------------------------------------------
--------------------------------------------------------------------------------------------------------------------------------------------------------------------------------------------------------
--------------------------------------------------------------------------------------------------------------------------------------------------------------------------------------------------------
--------------------------------------------------------------------------------------------------------------------------------------------------------------------------------------------------------
--------------------------------------------------------------------------------------------------------------------------------------------------------------------------------------------------------
--------------------------------------------------------------------------------------------------------------------------------------------------------------------------------------------------------
--------------------------------------------------------------------------------------------------------------------------------------------------------------------------------------------------------
--------------------------------------------------------------------------------------------------------------------------------------------------------------------------------------------------------
-------------------------------------------------------------------------r------------------------------------------------------------------------------------------------------------------------------
------------------------------------------------------------2SUSC-------%%%%%%%------------------r-------------------------#---#------------------------------------------------------------------------
------------------------------------------------------------------------|||||||-----------------%%%-----------------------##---##-----------------------------------------------------------------------
---------------------------------------------%%%%%%%%---%%%-------------|||||||-----------------|||----------------------###---###----#---#--%%%%%%%%F%%%%%%%%%%%%%%%%%%%%%%%%%%%%%%%%%%%%%%%%%%%%%%%%%%
-----------%%%%%---%%%%%---------%%%%%--%%%%%||||||||---|||-r-----------|r||||r-------------r---|||-------%%%%%---%%%%%%%%%%---%%%%%%%%---%%%||||||||%||||||||||||||||||||||||||||||||||||||||||||||||||
%%%%%%%%%%%|||||---|||||---------|||||--|||||||||||||---|||%%%%%%%%%%%%%%%%%%%%%%----------%%%%%%%%%%%%%%%|||||---||||||||||---||||||||---||||||||||||||||||||||||||||||||||||||||||||||||||||||||||||||
||||||||||||||||---|||||XXX---XXX|||||--|||||||||||||---|||||||||||||||||||||||||XXXX--XXXX||||||||||||||||||||---||||||||||---||||||||---||||||||||||||||||||||||||||||||||||||||||||||||||||||||||||||
