HEIGHT=16;WIDTH=201;THEME=0;OVERRIDE=false
--------------------------------------------------------------------------------------------------------------------------------------------------------------------------------------------------------
--------------------------------------------------------------------------------------------------------------------------------------------------------------------------------------------------------
--------------------------------------------------------------------------------------------------------------------------------------------------------------------------------------------------------
--------------------------------------------------------------------------------------------------------------------------------------------------------------------------------------------------------
--------------------------------------------------------------------------------------------------------------------------------------------------------------------------------------------------------
--------------------------------------------------------------------------------------------------------------------------------------------------------------------------------------------------------
--------------------------------------------------------------------------------------------------------------------------------------------------------------------------------------------------------
--------------------------------------------------------------------------------------------------------------------------------------------------------------------------------------------------------
--------------------------------------------------------------------------------------------------------------------------------------------------------------------------------------------------------
-----------------------#--#------------------#---#------------------------------------------------------------------------------------------------------------------------------------------------------
----------------------##--##----------------##---##--------------------------------------222----------------------------------------#--#----------------------------------------------------------------
---------------------###--###--------------###---###-------------------------------------------------------------#--#--------------##--##---------------------------------------------------------------
-------------------%%%%%--%%%%%----------%%%%%---%%%%%------%%%--%%%%%--%%---%%%--%%%---------------------------##--##------------###--###--------------------------------------------------------------
-------------------|||||--|||||----------|||||---|||||%%--%%|||--|||||--||%%%|||--|||-----k----#---#-----------###--###---------%%%%%--%%%%%------------------------------------------------------------
------------%%---%%|||||--|||||--g---g---|||||---|||||||--|||||--|||||--||||||||--|||%%%%%%%%%%%---%%%%%---%%%%%%%--%%%%%%%---%%|||||--|||||------------------------------------------------------------
XXXXXXXXXXXX||---|||||||--|||||XXXXXXXXXX|||||---|||||||--|||||--|||||--||||||||--||||||||||||||---|||||---|||||||--|||||||---|||||||--|||||XXXXXXXXFXXXXXXXXXXXXXXXXXXXXXXXXXXXXXXXXXXXXXXXXXXXXXXXXXXX
