HEIGHT=16;WIDTH=201;THEME=0;OVERRIDE=false
--------------------------------------------------------------------------------------------------------------------------------------------------------------------------------------------------------
--------------------------------------------------------------------------------------------------------------------------------------------------------------------------------------------------------
--------------------------------------------------------------------------------------------------------------------------------------------------------------------------------------------------------
--------------------------------------------------------------------------------------------------------------------------------------------------------------------------------------------------------
--------------------------------------------------------------------------------------------------------------------------------------------------------------------------------------------------------
---------------------------------------------------------------------------------------SCUC-------------------------------------------------------------------------------------------------------------
--------------------------------------------------------------------------------------------------------------------------------------------------------------------------------------------------------
--------------------------------------------------------------------------------------------------------------------------------------------------------------------------------------------------------
------------------------------------------------------------------------SSUSSS------------yk------------------------------------------------------------------------------------------------------------
--------------------------------------------#--#--------------------------------------%%%%%%------------------------------------------------------------------------------------------------------------
--------------SSSC-------------------------##--##----------------Tt-------------------||||||--g---------------------------------------------------------------------------------------------------------
------------------------------------------###--###------y--------tt-------------------|||%%%%%%---------------------------------------------------------------------------------------------------------
-------------------------Tt-------------%%%%%--%%%%%--%%%%%-----%%%%%%%%%%%%%%%%------|||||||||-----------------------------------#--#------------------------------------------------------------------
-------------------------tt----%%%---%%%|||||--|||||--|||||-----||||||||||||||||------|||||||||------------------------%%%---%%%%%%--%%%----------------------------------------------------------------
-------------%%%%%%%%----tt----|||---||||||||--|||||--||||r---y-||||||||||||||||------|k|||||||gg------%%%---%%%%%---%%|||---||||||--|||----------------------------------------------------------------
XXXXXXXXXXXXX||||||||XXXXXXXXXX|||---||||||||--|||||XXXXXXXXXXXX||||||||||||||||XXXXXXXXXXXXXXXXXXXXXXX|||---|||||---|||||---||||||--|||XXXXXXXXFXXXXXXXXXXXXXXXXXXXXXXXXXXXXXXXXXXXXXXXXXXXXXXXXXXXXXXX
