HEIGHT=16;WIDTH=201;THEME=0;OVERRIDE=false
--------------------------------------------------------------------------------------------------------------------------------------------------------------------------------------------------------
--------------------------------------------------------------------------------------------------------------------------------------------------------------------------------------------------------
--------------------------------------------------------------------------------------------------------------------------------------------------------------------------------------------------------
--------------------------------------------------------------------------------------------------------------------------------------------------------------------------------------------------------
--------------------------------------------------------------------------------------------------------------------------------------------------------------------------------------------------------
--------------------------------------------------------------------------------------------------------------------------------------------------------------------------------------------------------
--------------------------------------------------------------------------------------------------------------------------------------------------------------------------------------------------------
--------------------------------------------------------------------------------------------------------------------------------------------------------------------------------------------------------
------------------------------------------------------------------------------------------------------------------------------------SSS2S---------------------------------------------------------------
--------------------------------------------------------------------------------------------------------------------------------------------------------------------------------------------------------
----------------------------------------------------tt--------------------------------------------------------------------------------------------------------------------------------------------------
-------------#---#---------CCSU---------------------tt--------------------------------k-----------------------------------------------k-----------------------------------------------------------------
-----------%%%---%%%------------------g---%%%%%%%%%-tt-------------------%%%%---%%%%%%%%%%%--------------------------------------%%%%%%%%%--------------------------------------------------------------
-----------|||---|||%%%%-----------%%%%%%%|||||||||%%%%%%%%--------------||||---|||||||||||--------%%%%%--%%%%%------%%%%%--%%%%%|||||||||--------------------------------------------------------------
%%%%%%%%%%%|||---|||||||---------y-||||||||||||||||||||||||--------%%--%%||||---|||||||||||%%%--%%%|||||--|||||------|||||--||||||||||||||%%%%%%%%F%%%%%%%%%%%%%%%%%%%%%%%%%%%%%%%%%%%%%%%%%%%%%%%%%%%%%
||||||||||||||---|||||||XXXXXXXXXXX||||||||||||||||||||||||XXX--XXX||--||||||---||||||||||||||--||||||||--|||||XX--XX|||||--||||||||||||||||||||||X|||||||||||||||||||||||||||||||||||||||||||||||||||||
