HEIGHT=16;WIDTH=201;THEME=0;OVERRIDE=false
--------------------------------------------------------------------------------------------------------------------------------------------------------------------------------------------------------
--------------------------------------------------------------------------------------------------------------------------------------------------------------------------------------------------------
--------------------------------------------------------------------------------------------------------------------------------------------------------------------------------------------------------
--------------------------------------------------------------------------------------------------------------------------------------------------------------------------------------------------------
------------------------------------------------------------------CS------------------------------------------------------------------------------------------------------------------------------------
--------------------------------------------------------------------------------------------------------------------------------------------------------------------------------------------------------
--------------------------------------------------------------------%%----------------------------------------------------------------------------------------------------------------------------------
-------------------------------------------------------------------k||----------------------------------------------------------------------------------------------------------------------------------
-----------------------------------------------------------------%%%%%%---------------------------------------------------------------------------------------------------------------------------------
-------------------------#--#------------------------------------||||||---------------------------------------------------------------------------------------------------------------------------------
------------------------##--##-----------------------------------||||||----------------------------------------#---#------------------------------------------------------------------------------------
-----------------------###--###----------------------------------|||r||---y-----------------------------------##---##-----------------------------------------------------------------------------------
--------------%%---%%%%%%%--%%%%%-----#--#--------------------%%%%%%%%%%%%%%%%%%%------------#---#--%%---%%--###---###-----%%%%--%%%%------%%%%%%%%F%%%%%%%%%%%%%%%%%%%%%%%%%%%%%%%%%%%%%%%%%%%%%%%%%%%%
%%%%%%%%%%%%%%||---|||||||--|||||%%--##--##-----%%---%%-------|||||||||||||||||||----------%%%---%%%||---||%%%%%---%%%%%---||||--||||------||||||||%||||||||||||||||||||||||||||||||||||||||||||||||||||
||||||||||||||||---|||||||--|||||||%%%%--%%%%---||---||%%%%%%%|||||||||||||||||||----------|||---|||||---|||||||---|||||%%%||||--||||%%--%%|||||||||||||||||||||||||||||||||||||||||||||||||||||||||||||
||||||||||||||||---|||||||--|||||||||||--||||XXX||---||||||||||||||||||||||||||||XXXX--XXXX|||---|||||---|||||||---||||||||||||--||||||--|||||||||||||||||||||||||||||||||||||||||||||||||||||||||||||||
