HEIGHT=16;WIDTH=201;THEME=0;OVERRIDE=false
--------------------------------------------------------------------------------------------------------------------------------------------------------------------------------------------------------
--------------------------------------------------------------------------------------------------------------------------------------------------------------------------------------------------------
--------------------------------------------------------------------------------------------------------------------------------------------------------------------------------------------------------
--------------------------------------------------------------------------------------------------------------------------------------------------------------------------------------------------------
--------------------------------------------------------------------------------------------------------------------------------------------------------------------------------------------------------
--------------------------------------------------------------------------------------------------------------------------------------------------------------------------------------------------------
--------------------------------------------------------------------------------------------------------------------------------------------------------------------------------------------------------
--------------------------------------------------------------------------------------------------------------------------------------------------------------------------------------------------------
----------------------------------------------------------------------------------------2SS2CSS2--------------------------------------------------------------------------------------------------------
-----------------------------------------------------k-y-----------------------------------------------------------------#---#--------------------------------------------------------------------------
--------------------------------------------------%%%%%%----------------------------------------------------------------##---##-------------------------------------------------------------------------
--------------S22USS--------------------#---#-----||||||-------------------------------------y----tt---tt-tt----y------###---###------------------------------------------------------------------------
--------------------------------------%%%---%%%%%%%%%%%%%%%%---------------------------%%%%%%%%%%-tt---tt-tt---%%%%%%%%%%%---%%%%%----#--#--------------------------------------------------------------
---------------------------%%%%---%%%%|||---||||||||||||||||%%%%%---%%%%%--#--#--------||||||||||%%%%%%%%%%%%%%|||||||||||---|||||---##--##-------------------------------------------------------------
%%%%%%%%%%%-r--------------||||---|||||||---|||||||||||||||||||||---|||||%%%--%%%%%--%%|||||||||||||||||||||||||||||||||||---|||||--###--###--%%%%%%%%F%%%%%%%%%%%%%%%%%%%%%%%%%%%%%%%%%%%%%%%%%%%%%%%%%
|||||||||||XXXXXXXXXXXX--XX||||---|||||||---|||||||||||||||||||||---||||||||--|||||--|||||||||||||||||||||||||||||||||||||---|||||XXXXX--XXXXX||||||||X|||||||||||||||||||||||||||||||||||||||||||||||||
