HEIGHT=16;WIDTH=201;THEME=0;OVERRIDE=false
--------------------------------------------------------------------------------------------------------------------------------------------------------------------------------------------------------
--------------------------------------------------------------------------------------------------------------------------------------------------------------------------------------------------------
--------------------------------------------------------------------------------------------------------------------------------------------------------------------------------------------------------
--------------------------------------------------------------------------------------------------------------------------------------------------------------------------------------------------------
--------------------------------------------------------------------------------------------------------------------------------------------------------------------------------------------------------
--------------------------------------------------------------------------------------------------------------------------------------------------------------------------------------------------------
--------------------------------------------------------------------------------------------------------------------------------------------------------------------------------------------------------
------------------------------------------------------------------------------------------------------------------------%%%-----------------------------------------------------------------------------
------------------------------------------------------------------------------------------------------------------------|||-----------------------------------------------------------------------------
------------------------------------------------------------------------------------------------------------------------|||-----------------------------------------------------------------------------
-------------------------------------------------------------------------------------------------CSSSS------------------|%%%%%--------------------------------------------------------------------------
------------------------------------------------------------------------------------------------------------------------||||||--------------------------------------------------------------------------
%%%%%%%%%%%%---%%----------------------#--#-------------%%%%%%%%%%%%%----------------#---#------------------------------||||||-----------%%%%%%%%F%%%%%%%%%%%%%%%%%%%%%%%%%%%%%%%%%%%%%%%%%%%%%%%%%%%%%%
||||||||||||---||---#--#--------------##--##--------%%%%|||||||||||||---------------##---##---------------------------%%%%%%%%%%%%%%%%---||||||||%||||||||||||||||||||||||||||||||||||||||||||||||||||||
||||||||||||---||--##--##------------###--###-------|||||||||||||||||--------------###---###--%%%%%%%%%%%%%%%%---%%%%%||||||||||||||||---|||||||||||||||||||||||||||||||||||||||||||||||||||||||||||||||
||||||||||||---||XXXX--XXXXXXXXXXXXXXXXX--XXXXXXXXXX|||||||||||||||||XXXXX--XXXXXXXXXX---XXXXX||||||||||||||||---|||||||||||||||||||||XXX|||||||||||||||||||||||||||||||||||||||||||||||||||||||||||||||
