HEIGHT=16;WIDTH=201;THEME=0;OVERRIDE=false
--------------------------------------------------------------------------------------------------------------------------------------------------------------------------------------------------------
--------------------------------------------------------------------------------------------------------------------------------------------------------------------------------------------------------
--------------------------------------------------------------------------------------------------------------------------------------------------------------------------------------------------------
--------------------------------------------------------------------------------------------------------------------------------------------------------------------------------------------------------
--------------------------------------------------------------------------------------------------------------------------------------------------------------------------------------------------------
--------------------------------------------------------------------------------------------------------------------------------------------------------------------------------------------------------
--------------------------------------------------------------------------------------------------------------------------------------------------------------------------------------------------------
--------------------------------------------------------------------------------------------------------------------------------------------------------------------------------------------------------
------------------------------------------------------------------------------------------------------------------------------CCSS----------------------------------------------------------------------
--------------------------------------------------------------------------------------------------------------------------------------------------------------------------------------------------------
-------------------------------------------------SS-----#---#-------------------------------------------------------------------------------------------------------------------------------------------
-------------------------------------------------------##---##---------------S2SC--------------------------------------------y--------------------------------------------------------------------------
%%%%%%%%%%-------------------------------------%%----%%%%---%%%%-------------------------------------#---#-----#---#---%%%%%%%%%%%%%--------------------------------------------------------------------
||||||||||----y-------------------%%%%---%%%%-y||----||||---||||%%-----------------%%%%--%%%%%%--%%%%%---%%%--##---##--|||||||||||||--------%%%%%%%%F%%%%%%%%%%%%%%%%%%%%%%%%%%%%%%%%%%%%%%%%%%%%%%%%%%%
||||||||||%%%%%%%-----------------||||---||||%%%%%%%%||||---||||||%%%%--%%%%-----k-||||--||||||--|||||---|||%%%%---%%%%|||||||||||||--#--#--||||||||%|||||||||||||||||||||||||||||||||||||||||||||||||||
|||||||||||||||||XXXX---XXXXXX--XX||||---||||||||||||||||---||||||||||--||||XXXXXXX||||--||||||--|||||---|||||||---|||||||||||||||||XXX--XXX||||||||||||||||||||||||||||||||||||||||||||||||||||||||||||
