HEIGHT=16;WIDTH=201;THEME=0;OVERRIDE=false
--------------------------------------------------------------------------------------------------------------------------------------------------------------------------------------------------------
--------------------------------------------------------------------------------------------------------------------------------------------------------------------------------------------------------
--------------------------------------------------------------------------------------------------------------------------------------------------------------------------------------------------------
--------------------------------------------------------------------------------------------------------------------------------------------------------------------------------------------------------
--------------------------------------------------------------------------------------------------------------------------------------------------------------------------------------------------------
--------------------------------------------------------------------------------------------------------------------------------------------------------------------------------------------------------
--------------------------------------------------------------------------------------------------------------------------------------------------------------------------------------------------------
--------------------------------------------------------------------------------------------------------------------------------------------------------------------------------------------------------
--------------------------------------------------------------------------------------------------------------------------------------------------------------------------------------------------------
--------------------------------------------------------------------------------------------------------------------------------------------------------------------------------------------------------
--------------------------------------------------------------------------------------------------------------------------------------------------------------------------------------------------------
-----------------------------------------------------------------------------#--#-----------Tt----------------------------------------------------------------------------------------------------------
----------------------------------------%%%---%%%------------%%%---%%%------##--##-------tt-tt-------------------------%%--%%------%%---%%--------------------------------------------------------------
------------------------%%--%%%%%%%%%%--|||---|||------------|||---|||-----###--###------tt-tt----%%%%---%%%%----------||--||------||---||%%%%%%%%F%%%%%%%%%%%%%%%%%%%%%%%%%%%%%%%%%%%%%%%%%%%%%%%%%%%%%
-----------%%%%%---%%%%%||--||||||||||%%|||---|||------------|||---|||---%%%%%--%%%%%%%%%%%%%%%%%%||||---||||----------||--||--k---||---||||||||||%|||||||||||||||||||||||||||||||||||||||||||||||||||||
XXXXXXXXXXX|||||---|||||||--|||||||||||||||---|||XXXXX--XXXXX|||---|||XXX|||||--||||||||||||||||||||||---||||XXXX--XXXX||--||XXXXXX||---||||||||||||||||||||||||||||||||||||||||||||||||||||||||||||||||
