HEIGHT=16;WIDTH=201;THEME=0;OVERRIDE=false
--------------------------------------------------------------------------------------------------------------------------------------------------------------------------------------------------------
--------------------------------------------------------------------------------------------------------------------------------------------------------------------------------------------------------
--------------------------------------------------------------------------------------------------------------------------------------------------------------------------------------------------------
--------------------------------------------------------------------------------------------------------------------------------------------------------------------------------------------------------
--------------------------------------------------------------------------------------------------------------------------------------------------------------------------------------------------------
--------------------------------------------------------------------------------------------------------------------------------------------------------------------------------------------------------
--------------------------------------------------------------------------------------------------------------------------------------------------------------------------------------------------------
--------------------------------------------------------------------------------------------------------------------------------------------------------------------------------------------------------
------------SS2SS----------------------------------------------------------2SUSC------------------------------------------------------------------------------------------------------------------------
-------------------------------------k-----------------------------------------------------------------------------------SCCSS--------------------------------------------------------------------------
-----------------------------------%%%%-----------------------------------------|---------------------------------------------------------#---#---------------------------------------------------------
------------k----------------------||||-----------------------------------------g---------------------------------------%----------------##---##--------------------------------------------------------
-----------%%%%%%%%---------%%%----||||--%%---#--#---%%--%%---------------%%%%%%%%%%%%%%%-------------------------------|------%%---%%--###---###-------------------------------------------------------
-----------||||||||%%---%%--|||-g--|r|y--||--##--##--||--||---------------|||||||||||||||------%%%%%--%%%%%%%----------%%%%%%%%||---||%%%%%---%%%%%-----------------------------------------------------
-----------||||||||||---||%%%%%%%%%%%%%%%||%%%%--%%%%||--||%%%---%%%------|||||||||||||||%%%%%%|||||--|||||||%%%%%--%%%||||||||||---|||||||---|||||%%%%%%%%F%%%%%%%%%%%%%%%%%%%%%%%%%%%%%%%%%%%%%%%%%%%%
XXXXXXXXXXX||||||||||---|||||||||||||||||||||||--||||||--|||||---|||XXXXXX||||||||||||||||||||||||||--||||||||||||--|||||||||||||---|||||||---|||||||||||||X||||||||||||||||||||||||||||||||||||||||||||
