HEIGHT=16;WIDTH=201;THEME=0;OVERRIDE=false
--------------------------------------------------------------------------------------------------------------------------------------------------------------------------------------------------------
--------------------------------------------------------------------------------------------------------------------------------------------------------------------------------------------------------
----------------------------------------SSS-------------------------------------------------------------------------------------------------------------------------------------------------------------
--------------------------------------------------------------------------------------------------------------------------------------------------------------------------------------------------------
--------------------------------------------------------------------------------------------------------------------------------------------------------------------------------------------------------
----------------------------------------g----g----------------------------------------------------------------------------------------------------------------------------------------------------------
----------------------------------------%%%%%%----------------------------------------------------------------------------------------------------------------------------------------------------------
----------------------------------------||||||----------------------------------------------------------------------------------------------------------------------------------------------------------
----------------------------------------||||||-----------------------------------------------------------------------r----------------------------------------------------------------------------------
----------------------------------------||||||---------------------------------------------------------------------%%%%---------------------------------------------------------------------------------
-----------------------------------%%%%%%%||||--------------------y---k--------------SC-SCC----CSCS----------------||||-------k-Y-----------------------------------------------------------------------
--------------------------tt-Tt----|||||||||||------------------%%%%%%%--------------------------------------------||||-------%%%%----------------------------------------------------------------------
--------------------tt----tt-tt-%%%%%%%%%%%%%%%%----------------|||||||----------------%------%---------------%%%%%%%%%%%%----|G||g-------y-------------------------------------------------------------
--------------------tt----tt-tt-||||||||||||||||---------------g|||||||----%%---%%-----|------|y--------------||||||||||||%%%%%%%%%%%%%%%%%%------------------------------------------------------------
%%%%%%%%%%%%%---%%%%%%%%%%%%%%%%||||||||||||||||---------%%%%%%%%%%%%%%%%%%||---||%%%%%%%%%%%%%%%%%%%%--------||||||||||||||||||||||||||||||%%%%%%%%F%%%%%%%%%%%%%%%%%%%%%%%%%%%%%%%%%%%%%%%%%%%%%%%%%%%
|||||||||||||---||||||||||||||||||||||||||||||||XXX---XXX||||||||||||||||||||---||||||||||||||||||||||XXX--XXX||||||||||||||||||||||||||||||||||||||X|||||||||||||||||||||||||||||||||||||||||||||||||||
