HEIGHT=16;WIDTH=201;THEME=0;OVERRIDE=false
--------------------------------------------------------------------------------------------------------------------------------------------------------------------------------------------------------
--------------------------------------------------------------------------------------------------------------------------------------------------------------------------------------------------------
--------------------------------------------------------------------------------------------------------------------------------------------------------------------------------------------------------
--------------------------------------------------------------------------------------------------------------------------------------------------------------------------------------------------------
--------------------------------------------------------------------------------------------------------------------------------------------------------------------------------------------------------
--------------------------------------------------------------------------------------------------------------------------------------------------------------------------------------------------------
--------------------------------------------------------------------------------------------------------------------------------------------------------------------------------------------------------
--------------------------------------------------------------------------------------r-----------------------------------------------------------------------------------------------------------------
----------------------------------------------------------------------------------%%%%%-----------------------------------------------------------------------------------------------------------------
----------------------------------------------------------------------------------|||||-----------------------------------------------------------------------------------------------------------------
------------------------------------------------S2SS------------------------------|||||--------------Tt-------------------------------------------------------------------------------------------------
----------------------------------------------------------------------------------|||%%%%%%----------tt--------------CSSSSC2----------------------------------------------------------------------------
----------------------------tt-----------------------------------%%---%%----------|||||||||----------tt-------------------------------------------------------------------------------------------------
--------------%%%%%%--tt----tt------%%%%%%--%%%------------------||---||%%%--%%%--|||||||||------%%%%%%%%%%%%%%%%%%-----------------------%%%%%%%%F%%%%%%%%%%%%%%%%%%%%%%%%%%%%%%%%%%%%%%%%%%%%%%%%%%%%%
%%%%%%%%%%%%%%||||||--tt----tt--%%%%||||||--|||%%%%%%%%%%%---%%%%||---|||||--|||--|||||y|||--r---||||||||||||||||||-----------------------||||||||%|||||||||||||||||||||||||||||||||||||||||||||||||||||
||||||||||||||||||||XXXXXXXXXXXX||||||||||--||||||||||||||---||||||---|||||--|||XXXXXXXXXXXXXXXXX||||||||||||||||||XXXXXXXXXXXXXXX---XXXXX||||||||||||||||||||||||||||||||||||||||||||||||||||||||||||||
