HEIGHT=16;WIDTH=201;THEME=0;OVERRIDE=false
--------------------------------------------------------------------------------------------------------------------------------------------------------------------------------------------------------
--------------------------------------------------------------------------------------------------------------------------------------------------------------------------------------------------------
--------------------------------------------------------------------------------------------------------------------------------------------------------------------------------------------------------
--------------------------------------------------------------------------------------------------------------------------------------------------------------------------------------------------------
--------------------------------------------------------------------------------------------------------------------------------------------------------------------------------------------------------
--------------------------------------------------------------------------------------------------------------------------------------------------------------------------------------------------------
--------------------------------------------------------------------------------------------------------------------------------------------------------------------------------------------------------
--------------------------------------------------------------------------------------------------------------------------------------------------------------------------------------------------------
--------------------------------2SSCUCS-----------------------------------------------------------------------------------------------------------------------------------------------------------------
---------------------------------------------------------#--#---------%%%%%%%---------------------------------------------------------------------------------------------------------------------------
-------------------------------------------Tt----Tt-----##--##--------|||||||---------------------------------------------------------------------------------------------------------------------------
--------------------------------yg---Gr----tt----tt----###--###-------|||||||---------------------------------------------------------------------------------------------------------------------------
------------------------#---#--%%%%%%%%%%%%%%%%%%%%%%%%%%%--%%%%%-----g||||||----------------------------------------%%%%%-----------%%%%%---%%%%%%%%%%%%%F%%%%%%%%%%%%%%%%%%%%%%%%%%%%%%%%%%%%%%%%%%%%%
-----------%%%%---%%%%%%%---%%%|||||||||||||||||||||||||||--|||||--%%%%%%%|||----------------------------------------|||||---#---#---|||||---|||||||||||||%|||||||||||||||||||||||||||||||||||||||||||||
-----------||||---|||||||---||||||||||||||||||||||||||||||--|||||--||k|||y|||-------------------------------%%%%%%%%%|||||--##---##--|||||---|||||||||||||||||||||||||||||||||||||||||||||||||||||||||||
XXXXXXXXXXX||||---|||||||---||||||||||||||||||||||||||||||--|||||XXXXXXXXXXXXXXXXXXXXXXXX---XXXXXXXXX---XXXX||||||||||||||XXXX---XXXX|||||---|||||||||||||||||||||||||||||||||||||||||||||||||||||||||||
