HEIGHT=16;WIDTH=201;THEME=0;OVERRIDE=false
--------------------------------------------------------------------------------------------------------------------------------------------------------------------------------------------------------
--------------------------------------------------------------------------------------------------------------------------------------------------------------------------------------------------------
--------------------------------------------------------------------------------------------------------------------------------------------------------------------------------------------------------
--------------------------------------------------------------------------------------------------------------------------------------------------------------------------------------------------------
--------------------------------------------------------------------------------------------------------------------------------------------------------------------------------------------------------
--------------------------------------------------------------------------------------------------------------------------------------------------------------------------------------------------------
--------------------------------------------------------------------------------------------------------------------------------------------------------------------------------------------------------
--------------------------------------------------------------------------------------------------------------------------------------------------------------------------------------------------------
-----------------------------SSSSSC2SS------------------------------------------------------------------------------------------------------------------------------------------------------------------
--------------------------------------------------------------------------------------------------------------------------------------------------------------------------------------------------------
--------------------------------------------------------tt----------------------------------------------------------------------SS-SCC------------------------------------------------------------------
-----------------------------g-----------------------Tt-tt----------------------------------------------------------------------------------------------------------------------------------------------
----------------------------%%%%%%%%%%%--------------tt-tt-----%%--%%%%%---%%%---------------------------%%--%%--------%%---------|---------------------------------------------------------------------
-------------%%%%%----------|||||||||||-----------%%%%%%%%%%%%%||--|||||---|||---------%%%%%%%%%%%---%%%%||--||--------||---------g---------------------------------------------------------------------
%%%%%%%%%%%%%|||||----------|||||||||||%%%%---%%%%|||||||||||||||--|||||---|||---------|||||||||||---||||||--||--------||------%%%%%%%%%%%--------------------------------------------------------------
||||||||||||||||||XXXX--XXXX|||||||||||||||---|||||||||||||||||||--|||||---|||XXX---XXX|||||||||||---||||||--||XXX--XXX||XX--XX|||||||||||XXXXXXXXFXXXXXXXXXXXXXXXXXXXXXXXXXXXXXXXXXXXXXXXXXXXXXXXXXXXXX
