HEIGHT=16;WIDTH=201;THEME=0;OVERRIDE=false
--------------------------------------------------------------------------------------------------------------------------------------------------------------------------------------------------------
--------------------------------------------------------------------------------------------------------------------------------------------------------------------------------------------------------
--------------------------------------------------------------------------------------------------------------------------------------------------------------------------------------------------------
--------------------------------------------------------------------------------------------------------------------------------------------------------------------------------------------------------
--------------------------------------------------------------------------------------------------------------------------------------------------------------------------------------------------------
--------------------------------------------------------------------------------------------------------------------------------------------------------------------------------------------------------
------------------------------------USS2----------------------------------------------------------------------------------------------------------------------------------------------------------------
--------------------------------------------------------------------------------------------------------------------------------------------------------------------------------------------------------
-----------------------------------%---------------------------------------------------------------------------------------------SSSSUS-----------------------------------------------------------------
-----------------------------------|-g-----------------------------------SC-----------------------------------------------------------------------------------------------------------------------------
-----------------------------------%%%%%------------------------------------------------------------------------%%%%%-----------------------------------------------------------------------------------
-----------------------------------|||||--------------------------------%--%-----------------------------------g|||||---------------r-------------------------------------------------------------------
-------------tt-------tt-----r-----K||||----%%%%--%%%%------------%%%%%-|--|-------------------%%%%---%%%%---%%%%%%%%%%%%%------%%%%%%%%%%%%%%%%F%%%%%%%%%%%%%%%%%%%%%%%%%%%%%%%%%%%%%%%%%%%%%%%%%%%%%%%
-------------tt--tt---tt-%%%%%%%%%%%%%%%%%%%||||--||||------------|||||%%%%%%%%%%%%%%%%--------||||---||||%%%|||||||||||||------||||||||||||||||%|||||||||||||||||||||||||||||||||||||||||||||||||||||||
%%%%%%%%%%%%-tt--tt---tt-|||||||||||||||||||||||--||||------------|||||||||||||||||||||--#--#--||||---||||||||||||||||||||%%--%%||||||||||||||||||||||||||||||||||||||||||||||||||||||||||||||||||||||||
||||||||||||XXXXXXXXXXXXX|||||||||||||||||||||||--||||XXXXX--XXXXX|||||||||||||||||||||XXX--XXX||||---||||||||||||||||||||||--||||||||||||||||||||||||||||||||||||||||||||||||||||||||||||||||||||||||||
