HEIGHT=16;WIDTH=201;THEME=0;OVERRIDE=false
--------------------------------------------------------------------------------------------------------------------------------------------------------------------------------------------------------
--------------------------------------------------------------------------------------------------------------------------------------------------------------------------------------------------------
--------------------------------------------------------------------------------------------------------------------------------------------------------------------------------------------------------
--------------------------------------------------------------------------------------------------------------------------------------------------------------------------------------------------------
--------------------------------------------------------------------------------------------------------------------------------------------------------------------------------------------------------
--------------------------------------------------------------------------------------------------------------------------------------------------------------------------------------------------------
--------------------------------------------------------------------------------------------------------------------------------------------------------------------------------------------------------
--------------------------------------------------------------------------------------------------------------------------------------------------------------------------------------------------------
--------------------------------------------------------------------------------------------------------------------------------------------------------------------------------------------------------
------------------------------S2SC----------------------------------------------------------------------------------------------------------------------------------------------------------------------
------------------------------------------------rr-Y----------------------------------------------------------------------------------------------------------------------------------------------------
------------------------------------------------%%%%%%--------------------#---#-------------------------------#---#-------------------------------------------------------------------------------------
------------------------------------------------||||||-------------------##---##------------%%%-------------%%%---%%%%%%%%%%%---------------------------------------------------------------------------
----------------------------%%%%%%%%%%----------g|||||---%%---%%--------###---###-----------|||-------------|||---|||||||||||-----%%---%%---------------------------------------------------------------
%%%%%%%%%%%%--------%%%--%%%||||||||||-------%%%%%%%%%%%%||---||------%%%%%---%%%%%-------y-rykr------%%--%%|||---|||||||||||-----||---||---------------------------------------------------------------
||||||||||||XXX--XXX|||--|||||||||||||XX---XX||||||||||||||---||XX--XX|||||---|||||XXXXXXXXXXXXXXXXXXX||--|||||---|||||||||||XXXXX||---||XXXXXXXXFXXXXXXXXXXXXXXXXXXXXXXXXXXXXXXXXXXXXXXXXXXXXXXXXXXXXXX
