HEIGHT=16;WIDTH=201;THEME=0;OVERRIDE=false
--------------------------------------------------------------------------------------------------------------------------------------------------------------------------------------------------------
--------------------------------------------------------------------------------------------------------------------------------------------------------------------------------------------------------
--------------------------------------------------------------------------------------------------------------------------------------------------------------------------------------------------------
--------------------------------------------------------------------------------------------------------------------------------------------------------------------------------------------------------
--------------------------------------------------------------------------------------------------------------------------------------------------------------------------------------------------------
----------------------------------------------------%%%%%%%---------------------------------------------------------------------------------------------------------------------------------------------
----------------------------------------------------|||||||---------------------------------------------------------------------------------------------------------------------------------------------
----------------------------------------------------|||||||---------------------------------------------------------------------------------------------------------------------------------------------
----------------------------------------------------|||||||---------------------------------------------------------------------------------------------------------------------------------------------
---------------S2S----------------------------------|||||%%%%%%%----------------------------------------------------------------------------------------------------------------------------------------
--------------------------------------------------r-||r|||||||||------------------------------SCC2------------------------------------------------------------------------------------------------------
--------------------------------------------------%%%%%|||||||||------------------S-S2------------------------------------------------------------------------------------------------------------------
%%%%%%%%%%%%%----------------------tt---tt--------||||||||||||||---%%--%%---------------------------%%%%%---%%%%%---------------------------------------------------------------------------------------
|||||||||||||%%%%%%%%--------------tt---tt--------|Y||||||||||||---||--||%%%%%-----%---%%%%%----k---|||||---|||||---------------------------------------------------------------------------------------
|||||||||||||||||||||%%%%%--%%%%%%%%%%%%%%%%%----%%%%%%%%%%%%%%%%%%||--|||||||-----|---|||||%%%%%%%%|||||---|||||---------------------------------------------------------------------------------------
||||||||||||||||||||||||||--|||||||||||||||||XXXX||||||||||||||||||||--|||||||XXXXXXXXX||||||||||||||||||---|||||XXXXX--XXXXXXXX--XXXXXXXX--XXXXXXXXXXXXXFXXXXXXXXXXXXXXXXXXXXXXXXXXXXXXXXXXXXXXXXXXXXXX
