HEIGHT=16;WIDTH=201;THEME=0;OVERRIDE=false
--------------------------------------------------------------------------------------------------------------------------------------------------------------------------------------------------------
--------------------------------------------------------------------------------------------------------------------------------------------------------------------------------------------------------
--------------------------------------------------------------------------------------------------------------------------------------------------------------------------------------------------------
--------------------------------------------------------------------------------------------------------------------------------------------------------------------------------------------------------
--------------------------------------------------------------------------------------------------------------------------------------------------------------------------------------------------------
--------------------------------------------------------------------------------------------------------------------------------------------------------------------------------------------------------
--------------------------------------------------------------------------------------------------------------------------------------------------------------------------------------------------------
--------------------------------------------------------------------------------------------------------------------------------------------------------------------------------------------------------
--------------------------------------------------------------------------------------------------------------------------------------------------------------------------------------------------------
------------------------------------------------------------------------------CC-C----------------------------------g-----------------------------------------------------------------------------------
------------------------------------------------------------------------------------------------------------------%%%%%%--------------------------------------------------------------------------------
--------------------------------------------------------------------------------%---------------------------------||||||--------------r-----------------------------------------------------------------
---------------------------------------------%%%%---%%%%%%%---%%%--#---#--------|-y----------------%%%%%%------y-y||||||---g---------%%%%%%%%%%%%%%F%%%%%%%%%%%%%%%%%%%%%%%%%%%%%%%%%%%%%%%%%%%%%%%%%%%%
%%%%%%%%%%%%%%%%---%%%%%--%%%%%%-------------||||---|||||||---|||%%%---%%%%%%%%%%%%%%--------------||||||----%%%%%%%%%%%%%%%%--#--#--||||||||||||||%||||||||||||||||||||||||||||||||||||||||||||||||||||
||||||||||||||||---|||||--||||||%%%%%---%%%%%||||---|||||||---||||||---||||||||||||||%%%%%---%%%%%%%%%%%%%%%%||||||||||||||||%%%--%%%|||||||||||||||||||||||||||||||||||||||||||||||||||||||||||||||||||
||||||||||||||||---|||||--|||||||||||---|||||||||---|||||||---||||||---|||||||||||||||||||---|||||||||||||||||||||||||||||||||||--||||||||||||||||||||||||||||||||||||||||||||||||||||||||||||||||||||||
