HEIGHT=16;WIDTH=201;THEME=0;OVERRIDE=false
--------------------------------------------------------------------------------------------------------------------------------------------------------------------------------------------------------
--------------------------------------------------------------------------------------------------------------------------------------------------------------------------------------------------------
--------------------------------------------------------------------------------------------------------------------------------------------------------------------------------------------------------
--------------------------------------------------------------------------------------------------------------------------------------------------------------------------------------------------------
--------------------------------------------------------------------------------------------------------------------------------------------------------------------------------------------------------
--------------------------------------------------------------------------------------------------------------------------------------------------------------------------------------------------------
--------------------------------------------------------------------------------------------------------------------------------------------------------------------------------------------------------
--------------------------------------------------------------------------------------------------------------------------------------------------------------------------------------------------------
--------------------------------------------------------------------------------------------------------------------------------------------------------------------------------------------------------
--------------------------------------------------------------------------------------------------------------------------------------------------------------------------------------------------------
------------------------------SC2------#--#-------------------------------------------------------------------------------------------------------------------------------------------------------------
--------------------------------------##--##---------------------------------------------------------------------------------SSSCCSU--------------------------------------------------------------------
-------------#--#--------------------###--###--------------#---#----%%---%%--------%%---%%-------------Tt------------k-----------------------------%%%%%%%%F%%%%%%%%%%%%%%%%%%%%%%%%%%%%%%%%%%%%%%%%%%%%
-----------%%%--%%%-----------r----%%%%%--%%%%%--#--#-----##---##---||---||--------||---||--------Tt---tt----------%%%-----------------------------||||||||%||||||||||||||||||||||||||||||||||||||||||||
%%%%%%%%%%%|||--|||%%%--%%%%%%%%%%%|||||--|||||%%%--%%%--###---###--||---||%%%--%%%||---||--------tt---tt----------|||-----------------%%%%%--%%%%%|||||||||||||||||||||||||||||||||||||||||||||||||||||
||||||||||||||--||||||--||||||||||||||||--||||||||--|||XXXXX---XXXXX||---|||||--|||||---||XXXXXXXXXXXXXXXXXXXXXXXXXXXXXXXXXXXXXXXXXXXXX|||||--||||||||||||||||||||||||||||||||||||||||||||||||||||||||||
