HEIGHT=16;WIDTH=201;THEME=0;OVERRIDE=false
--------------------------------------------------------------------------------------------------------------------------------------------------------------------------------------------------------
--------------------------------------------------------------------------------------------------------------------------------------------------------------------------------------------------------
--------------------------------------------------------------------------------------------------------------------------------------------------------------------------------------------------------
--------------------------------------------------------------------------------------------------------------------------------------------------------------------------------------------------------
--------------------------------------------------------------------------------------------------------------------------------------------------------------------------------------------------------
--------------------------------------------------------------------------------------------------------------------------------------------------------------------------------------------------------
--------------------------------------------------------------------------------------------------------------------------------------------------------------------------------------------------------
----------------------------------------------------------------------------------------y--k------------------------------------------------------------------------------------------------------------
--------------------------------------------------------------------------------------%%%%%%------------------------------------------------------------------------------------------------------------
------------------------------------------------------------------------------k-------||||||------------------------------------------------------------------------------------------------------------
-------------------------------------------------------------------------%%%%%%-------||||||------------------------------------------------------------------------------------------------------------
------------------r------------------------------------------------------||||||-------||||||--------------------------------------S-2-------------------------------------------------------------------
%%%%%%%%%%%%%--%%%%%%%%%%--------------------#---#-----------------------|r||||r------||%%%|------------------------------------------------------------------------------------------------------------
|||||||||||||--||||||||||-------------------##---##---------------%%%%%%%%%%%%%%%%%---||||||--------------------------%%%---%%%----%--------------------------------------------------------------------
|||||||||||||--||||||||||%%---%%%%%%--%%%%%%%%---%%%%-------%%--%%|||||||||||||||||%%%%%%%%%%%-------------%%%%---%%%%|||---|||----|--------------------------------------------------------------------
|||||||||||||XX||||||||||||---||||||--||||||||---||||XX---XX||--||||||||||||||||||||||||||||||XXXXX---XXXXX||||---|||||||---|||XXXXXXXXXXXXX---XXXXXXXXXXXXXFXXXXXXXXXXXXXXXXXXXXXXXXXXXXXXXXXXXXXXXXXXX
