HEIGHT=16;WIDTH=201;THEME=0;OVERRIDE=false
--------------------------------------------------------------------------------------------------------------------------------------------------------------------------------------------------------
--------------------------------------------------------------------------------------------------------------------------------------------------------------------------------------------------------
--------------------------------------------------------------------------------------------------------------------------------------------------------------------------------------------------------
--------------------------------------------------------------------------------------------------------------------------------------------------------------------------------------------------------
--------------------------------------------------------------------------------------------------------------------------------------------------------------------------------------------------------
--------------------------------------------------------------------------------------------------------------------------------------------------------------------------------------------------------
--------------------------------------------------------------------------------------------------------------------------------------------------------------------------------------------------------
--------------------------------------------------------------------------------------------------------------------------------------------------------------------------------------------------------
--------------------------------------------------------------------------------------------------------------------------------------------------------------------------------------------------------
-------------------------------------------------------------------------------------tt----------------------------------------------%%%%%%%------------------------------------------------------------
------------------------------------------------------------------#---#--------------tt------2SSS------------------------------------|||||||------------------------------------------------------------
---------------------------------------------%%%%%%--------------##---##-----#--#----tt-----------------y----------CSCS-----------%%%%%|||||------------------------------------------------------------
%%%%%%%%%%%%---------------------------------||||||------------%%%%---%%%%--##--##--%%%%%%%%--------%%%%%%--%%%-------------------||||||||||------------------------------------------------------------
||||||||||||-----------------------%%%---%%%-|||gk|------------||||---||||%%%%--%%%%||||||||--------||||||--|||---------%%%---%%%-|||k||||||-r----------------------------------------------------------
||||||||||||-----------------------|||---|||%%%%%%%%%%%--------||||---||||||||--||||||||||||%%%%%%%%%%%%%%%%|||%%-------|||---|||%%%%%%%%%%%%%%%%%%-----------------------------------------------------
||||||||||||XXXX---XXXXXXXXX--XXXXX|||---||||||||||||||XXX--XXX||||---||||||||--|||||||||||||||||||||||||||||||||XXXXXXX|||---|||||||||||||||||||||XXXXXXXXFXXXXXXXXXXXXXXXXXXXXXXXXXXXXXXXXXXXXXXXXXXXX
