HEIGHT=16;WIDTH=201;THEME=0;OVERRIDE=false
--------------------------------------------------------------------------------------------------------------------------------------------------------------------------------------------------------
--------------------------------------------------------------------------------------------------------------------------------------------------------------------------------------------------------
--------------------------------------------------------------------------------------------------------------------------------------------------------------------------------------------------------
--------------------------------------------------------------------------------------------------------------------------------------------------------------------------------------------------------
--------------------------------------------------------------------------------------------------------------------------------------------------------------------------------------------------------
--------------------------------------------------------------------------------------------------------------------------------------------------------------------------------------------------------
--------------------------------------------------------------------------------------------------------------------------------------------------------------------------------------------------------
--------------------------------------------------------------------------------------------------------------------------------------------------------------------------------------------------------
--------------------------------------------------------------------------------------------------------------------------------------------------------------------------------------------------------
--------------------------------------------------------------------------------------------------------------------------------------------------------------------------------------------------------
------------------------------------------------------------SSU2S---------------------------------------------------------------------------------------------------------------------------------------
-------------------------------------------------------------------------------------------------------------------------------------------g------------------------------------------------------------
----------------------------------------------------#---#-----------%%%%%---%%%%%-------------%%---%%%%--%%----------r----%%%%%--%%%%%--%%%%%-----------------------------------------------------------
%%%%%%%%%%--------------%%---%%-------------------%%%---%%%-r-------|||||---|||||-------------||---||||--||------%%%%%%%--|||||--|||||--||||k-----------------------------------------------------------
||||||||||%%%%%%%%--%%%%||---||%%%---%%%%%%%--%%%%|||---|||%%%%%%%%%|||||---|||||%%%%%---%%%%%||---||||--||--y-k-|||||||--|||||--|||||%%%%%%%%%%%%------------------------------------------------------
||||||||||||||||||--||||||---|||||---|||||||--|||||||---|||||||||||||||||---||||||||||---|||||||---||||--||XXXXXXXXXXXXXXX|||||--|||||||||||||||||XXXXXXXXFXXXXXXXXXXXXXXXXXXXXXXXXXXXXXXXXXXXXXXXXXXXXX
