HEIGHT=16;WIDTH=201;THEME=0;OVERRIDE=false
--------------------------------------------------------------------------------------------------------------------------------------------------------------------------------------------------------
--------------------------------------------------------------------------------------------------------------------------------------------------------------------------------------------------------
--------------------------------------------------------------------------------------------------------------------------------------------------------------------------------------------------------
--------------------------------------------------------------------------------------------------------------------------------------------------------------------------------------------------------
--------------------------------------------------------------------------------------------------------------------------------------------------------------------------------------------------------
--------------------------------------------------------------------------------------------------------------------------------------------------------------------------------------------------------
--------------------------------------------------------------------------------------------------------------------------------------------------------------------------------------------------------
--------------------------------------------------------------------------------------------------------------------------------------------------------------------------------------------------------
--------------------------------------------------------------------------------------------------------------------------------------------------------------------------------------------------------
-------------SS-C-------#---#--------------------------------------------------------------------------------------%%%----------------------------------------------------------------------------------
-----------------------##---##-------------------------------------------------------------------------------------|||----------------------------------------------------------------------------------
---------------%------###---###-----------------------------------------------------------------------------------y|||----------------------------------------------------------------------------------
---------------|g-k-%%%%%---%%%%%%%%%%%%-----------#--#---------------%%%%--%%%%------------------------%%%--%%%%%%%%%%%%%%%%%%%%%%%%%------------------------------------------------------------------
%%%%%%%%%%%%%%%%%%%%|||||---||||||||||||----------##--##--------------||||--||||------------------------|||--|||||||||||||||||||||||||%%%---%%%%%%%%%%%F%%%%%%%%%%%%%%%%%%%%%%%%%%%%%%%%%%%%%%%%%%%%%%%%
|||||||||||||||||||||||||---||||||||||||--------%%%%--%%%%%%%%%--%%%%%||||--||||%%%%%---%%%%%%%%%%------|||--||||||||||||||||||||||||||||---|||||||||||%||||||||||||||||||||||||||||||||||||||||||||||||
|||||||||||||||||||||||||---||||||||||||XXX--XXX||||--|||||||||--|||||||||--|||||||||---||||||||||XX--XX|||--||||||||||||||||||||||||||||---||||||||||||||||||||||||||||||||||||||||||||||||||||||||||||
