HEIGHT=16;WIDTH=201;THEME=0;OVERRIDE=false
--------------------------------------------------------------------------------------------------------------------------------------------------------------------------------------------------------
--------------------------------------------------------------------------------------------------------------------------------------------------------------------------------------------------------
--------------------------------------------------------------------------------------------------------------------------------------------------------------------------------------------------------
--------------------------------------------------------------------------------------------------------------------------------------------------------------------------------------------------------
--------------------------------------------------------------------------------------------------------------------------------------------------------------------------------------------------------
--------------------------------------------------------------------------------------------------------------------------------------------------------------------------------------------------------
--------------------------------------------------------------------------------------------------------------------------------------------------------------------------------------------------------
--------------------------------------------------------------------------------------------------------------------------------------------------------------------------------------------------------
--------------------------------------------------------------------------------------------------------------------------------------------------------------------------------------------------------
----------------%%%-------------------------------------------------------------------------------------------------------------------------------------------------------------------------------------
----------------|||---------------------------------------------CSCSS-----------------------------------------------------------------------------------------------------------------------------------
----------------|%%%%--------------------------------------------------------------------------------------------------#---#----------------------------------------------------------------------------
----------------|||||-----------------------------------%%%%-----------------------------------------%%%--------------##---##--%%%%%--%%%%%%%%%%%%%F%%%%%%%%%%%%%%%%%%%%%%%%%%%%%%%%%%%%%%%%%%%%%%%%%%%%
----------------|||||-------%%%%%---%%%%%---------------||||---------k----------------------g-k------|||------------%%%%---%%%%|||||--|||||||||||||%||||||||||||||||||||||||||||||||||||||||||||||||||||
%%%%%%%%%%%%--gk|||y|-------|||||---|||||------------y--||y|--%%%%%%%%%--------------------%%%%%%%%%%%%%%%%--#---#--||||---|||||||||--||||||||||||||||||||||||||||||||||||||||||||||||||||||||||||||||||
||||||||||||XXXXXXXXXXXXXXXX|||||---|||||XX--XXXXXXXXXXXXXXXXX|||||||||XXXX--XXXXXXXX--XXXX||||||||||||||||XXX---XXX||||---|||||||||--||||||||||||||||||||||||||||||||||||||||||||||||||||||||||||||||||
