HEIGHT=16;WIDTH=201;THEME=0;OVERRIDE=false
--------------------------------------------------------------------------------------------------------------------------------------------------------------------------------------------------------
--------------------------------------------------------------------------------------------------------------------------------------------------------------------------------------------------------
--------------------------------------------------------------------------------------------------------------------------------------------------------------------------------------------------------
--------------------------------------------------------------------------------------------------------------------------------------------------------------------------------------------------------
--------------------------------------------------------------------------------------------------------------------------------------------------------------------------------------------------------
--------------------------------------------------------------------------------------------------------------------------------------------------------------------------------------------------------
--------------------------------------------------------------------------------------------------------------------------------------------------------------------------------------------------------
--------------------------------------------------------------------------------------------------------------------------------------------------------------------------------------------------------
-------------g---------------------------------------------y--------------------------------------------------------------------------------------------------------------------------------------------
------------%%%%%%%--------#---#--------------------------%%%-------------------------------------------------------------------------------------------------------------------------------------------
------------|||||||-------##---##-------------------------|||------------------------#--#---------------------------------------------------------------------------------------------------------------
------------||k||||------###---###------------------------|||-----------#---#-------##--##----------------------------------Tt--------------------------------------------------------------------------
------------|%%%|||----%%%%%---%%%%%----------------------|||----------##---##-----###--###-----------------------k-k-------tt--------------------------------------------------------------------------
%%%%%%%%%%%-|||||||----|||||---|||||-----------------%%%%%%%%%%%%%%%--###---###--%%%%%--%%%%%---------------r-----%%%%%%--%%%%%%%%%%%%%%%%--------------------------------------------------------------
|||||||||||-|||||||r-r-|||||---|||||----------%%%%%%%|||||||||||||||%%%%%---%%%%%|||||--|||||------------%%%%%%---|||||r--||||||||||||||||%%%%%%%%F%%%%%%%%%%%%%%%%%%%%%%%%%%%%%%%%%%%%%%%%%%%%%%%%%%%%%
|||||||||||XXXXXXXXXXXX|||||---|||||XXXXX---XX|||||||||||||||||||||||||||---||||||||||--|||||XXXXX--XXXXX||||||XXXXXXXXXXX||||||||||||||||||||||||X|||||||||||||||||||||||||||||||||||||||||||||||||||||
