HEIGHT=16;WIDTH=201;THEME=0;OVERRIDE=false
--------------------------------------------------------------------------------------------------------------------------------------------------------------------------------------------------------
--------------------------------------------------------------------------------------------------------------------------------------------------------------------------------------------------------
--------------------------------------------------------------------------------------------------------------------------------------------------------------------------------------------------------
--------------------------------------------------------------------------------------------------------------------------------------------------------------------------------------------------------
--------------------------------------------------------------------------------------------------------------------------------------------------------------------------------------------------------
--------------------------------------------------------------------------------------------------------------------------------------------------------------------------------------------------------
--------------------------------------------------------------------------------------------------------------------------------------------------------------------------------------------------------
--------------------------------------------------------------------------------------------------------------------------------------------------------------------------------------------------------
--------------------------------------------------------------------------------------------------------------------------------------------------------------------------------------------------------
--------------------------------------------------------------------------------------------------------------------------------------------------------------------------------------------------------
--------------------------------------------------------------------------------------------------------------------------------------------------------------------------------------------------------
------------------------------------------------------------------tt------------------------------------------------------------------------------------------------------------------------------------
--------------#--#------------------%%%%%%------------------------tt---Tt-----------------------tt-tt--%%--%%-----------------------%%%%%%%%------------------------------------------------------------
-------------##--##-----------------||||g|-----#--#------#--#-----tt---tt----%%--%%---#--#------tt-tt--||--||-----------------------||||||||%%%%%%%%F%%%%%%%%%%%%%%%%%%%%%%%%%%%%%%%%%%%%%%%%%%%%%%%%%%%
-----------%%%%--%%%%%%%%--%%%%%%%%%%%%%%%%%--##--##----##--##--%%%%%%%%%%%%%||--||--##--##--%%%%%%%%%%||--||-------%%%%--%%%%%%--%%||||||||||||||||%|||||||||||||||||||||||||||||||||||||||||||||||||||
XXXXXXXXXXX||||--||||||||--|||||||||||||||||XXXX--XXXXXXXX--XXXX|||||||||||||||--||XXXX--XXXX||||||||||||--||XX---XX||||--||||||--||||||||||||||||||||||||||||||||||||||||||||||||||||||||||||||||||||||
