HEIGHT=16;WIDTH=201;THEME=0;OVERRIDE=false
--------------------------------------------------------------------------------------------------------------------------------------------------------------------------------------------------------
--------------------------------------------------------------------------------------------------------------------------------------------------------------------------------------------------------
--------------------------------------------------------------------------------------------------------------------------------------------------------------------------------------------------------
--------------------------------------------------------------------------------------------------------------------------------------------------------------------------------------------------------
--------------------------------------------------------------------------------------------------------------------------------------------------------------------------------------------------------
--------------------------------------------------------------------------------------------------------------------------------------------------------------------------------------------------------
--------------------------------------------------------------------------------------------------------------------------------------------------------------------------------------------------------
------------------------------------------------------------------------------------------2SSSSS--------------------------------------------------------------------------------------------------------
--------------------------------------------------------------------------------------------------------------------------------------------------------------------------------------------------------
--------------------------------------------------------------------------------------------------------------------------------------------------------------------------------------------------------
------------------------------------------------------------------------------------------g-g-k---------------------------------------------------------------------------------------------------------
------------------------------tt----------------------------------------------------------%%%%%%---------------------------S222-------------------------------------------------------------------------
--------------------------tt--tt-----%%%%---%%%%----------------------------------%%---%%-||||||-----------#--#---%%--%%--------------------------------------------------------------------------------
%%%%%%%%%%----------------tt--tt-----||||---||||%%%%---%%%%------%%%%-------------||---||-||||||----------##--##--||--||-----------------%%%%%%%%F%%%%%%%%%%%%%%%%%%%%%%%%%%%%%%%%%%%%%%%%%%%%%%%%%%%%%%
||||||||||%%%%%---%%%%%%%%%%%%%%%%%%%||||---||||||||---||||%%--%%||||%%%%%---%%%%%||---||%%%%%%%%%%%%%%%%%%%--%%%%||--||-r---------------||||||||%||||||||||||||||||||||||||||||||||||||||||||||||||||||
|||||||||||||||---|||||||||||||||||||||||---||||||||---||||||--|||||||||||---|||||||---|||||||||||||||||||||--||||||--||XXXXXXXXXXXXX--XX|||||||||||||||||||||||||||||||||||||||||||||||||||||||||||||||
