HEIGHT=16;WIDTH=201;THEME=0;OVERRIDE=false
--------------------------------------------------------------------------------------------------------------------------------------------------------------------------------------------------------
--------------------------------------------------------------------------------------------------------------------------------------------------------------------------------------------------------
--------------------------------------------------------------------------------------------------------------------------------------------------------------------------------------------------------
--------------------------------------------------------------------------------------------------------------------------------------------------------------------------------------------------------
----------------------------------------------------------------------------------------------k---------------------------------------------------------------------------------------------------------
--------------------------------------------------------------------------------------------%%%%--------------------------------------------------------------------------------------------------------
--------------------------------------------------------------------------------------------||||--------------------------------------------------------------------------------------------------------
-----------------------------------------------------------------------------------------%%%%%%|--------------------------------------------------------------------------------------------------------
-----------------------------------------------------------------------------------------|||||||--------------------------------------------------------------------------------------------------------
-----------------------------------------------------------------------------------------|||||||--------------------------------------------------------------------------------------------------------
-----------------------------------------------------------------------------------------|||||||--------------------------tt-tt------------#---#--------------------------------------------------------
--------------------------------S2CSS--------------------------------------------------%%%||||||--------------------------tt-tt-----------##---##-------------------------------------------------------
--------------------------------------------------%%%--%%%--#---#----------%%--%%------|r|||||||------------------------%%%%%%%%%--------###---###------------------------------------------------------
--------------------%%%--%%%----------------------|||--|||%%%---%%%%%%--%%%||--||%%%%%%%%%%%%%%%%%%%%%%%---%%%%---------|||||||||%%--%%%%%%%---%%%%%----------------------------------------------------
--------------%%--%%|||--|||----r-----%%%%%--%%%%%|||--||||||---||||||--|||||--|||||||||||||||||||||||||---||||---------|||||||||||--|||||||---|||||----------------------------------------------------
XXXXXXXXXXXXXX||--|||||--|||XXXXXXXXXX|||||--||||||||--||||||---||||||--|||||--|||||||||||||||||||||||||---||||XXX---XXX|||||||||||--|||||||---|||||XXXXXXXXFXXXXXXXXXXXXXXXXXXXXXXXXXXXXXXXXXXXXXXXXXXX
