HEIGHT=16;WIDTH=201;THEME=0;OVERRIDE=false
--------------------------------------------------------------------------------------------------------------------------------------------------------------------------------------------------------
--------------------------------------------------------------------------------------------------------------------------------------------------------------------------------------------------------
--------------------------------------------------------------------------------------------------------------------------------------------------------------------------------------------------------
--------------------------------------------------------------------------------------------------------------------------------------------------------------------------------------------------------
--------------------------------------------------------------------------------------------------------------------------------------------------------------------------------------------------------
--------------------------------------------------------------------------------------------------------------------------------------------------------------------------------------------------------
--------------------------------------------------------------------------------------------------------------------------------------------------------------------------------------------------------
--------------------------------------------------------------------------------------------------------------------------------------------------------------------------------------------------------
-------------------------------------------------------------------------------------------------------------SCSSU--------------------------------------------------------------------------------------
----------------------%%%-------------------------------------------------------------------------------------------------------------------------------------------------------------------------------
----------------SSS---|||-------------------------------------------------------------------------------------------------------------------------------------------------------------------------------
----------------------|||-g------------------------------------------------------------------------------------kr---------------------------------------------------------------------------------------
%%%%%%%%%%%%%---------|%%%%%--------------------------------------------#---#-----------------------------%%%%%%%%%%%-----------------------------------------------------------------------------------
|||||||||||||--r--y---||||||-------------------------------------------##---##--%%%--%%%------------------|||||||||||%%%%---#--#---%%%---%%%------------------------------------------------------------
|||||||||||||%%%%%%%%%%%%%%%%%%--------------------------------------%%%%---%%%%|||--|||------------------|||||||||||||||--##--##--|||---|||%%%%%%%%F%%%%%%%%%%%%%%%%%%%%%%%%%%%%%%%%%%%%%%%%%%%%%%%%%%%
|||||||||||||||||||||||||||||||XXXX--XXXXXXX--XXXXXXXX---XXXXXXX---XX||||---|||||||--|||XXXXX---XXXXXXXXXX|||||||||||||||XXXX--XXXX|||---|||||||||||X|||||||||||||||||||||||||||||||||||||||||||||||||||
