HEIGHT=16;WIDTH=201;THEME=0;OVERRIDE=false
--------------------------------------------------------------------------------------------------------------------------------------------------------------------------------------------------------
--------------------------------------------------------------------------------------------------------------------------------------------------------------------------------------------------------
--------------------------------------------------------------------------------------------------------------------------------------------------------------------------------------------------------
--------------------------------------------------------------------------------------------------------------------------------------------------------------------------------------------------------
--------------------------------------------------------------------------------------------------------------------------------------------------------------------------------------------------------
--------------------------------------------------------------------------------------------------------------------------------------------------------------------------------------------------------
--------------------------------------------------------------------------------------------------------------------------------------------------------------------------------------------------------
--------------------------------------------------------------------------------------------------------------------------------------------------------------------------------------------------------
--------------------------------------------------------------------------------------------------------------------------------------------------------------------------------------------------------
----------------------------------------------------------S2SSSS----------------------------------------------------------------------------------------------------------------------------------------
----------------------------------SCSS------------------------------------------------------------------------------------------------------------------------------------------------------------------
-----------------------------------------#---#---------------------------------#--#---------------------------------------------------------------------------------------------------------------------
%%%%%%%%%%%%---------------------------%%%---%%%---------------k--%%%%---%%%%%%%--%%%-------------------%%%%%---%%%%%-----------------------------------------------------------------------------------
||||||||||||-------%%---%%-------------|||---|||---------%%%%%%%%%||||---|||||||--|||-------------------|||||---|||||-----------%%%%%---%%%%%%%%%%%%%F%%%%%%%%%%%%%%%%%%%%%%%%%%%%%%%%%%%%%%%%%%%%%%%%%%
||||||||||||-------||---||-------%%%%%%|||---|||---------|||||||||||||---|||||||--|||%%%%%%%%%----------|||||---|||||-------%%%%|||||---|||||||||||||%||||||||||||||||||||||||||||||||||||||||||||||||||
||||||||||||XX---XX||---||XX---XX|||||||||---|||XXX---XXX|||||||||||||---|||||||--||||||||||||XXXX--XXXX|||||---|||||XXXXXXX|||||||||---||||||||||||||||||||||||||||||||||||||||||||||||||||||||||||||||
