HEIGHT=16;WIDTH=201;THEME=0;OVERRIDE=false
--------------------------------------------------------------------------------------------------------------------------------------------------------------------------------------------------------
--------------------------------------------------------------------------------------------------------------------------------------------------------------------------------------------------------
--------------------------------------------------------------------------------------------------------------------------------------------------------------------------------------------------------
--------------------------------------------------------------------------------------------------------------------------------------------------------------------------------------------------------
--------------------------------------------------------------------------------------------------------------------------------------------------------------------------------------------------------
--------------------------------------------------------------------------------------------------------------------------------------------------------------------------------------------------------
--------------------------------------------------------------------------------------------------------------------------------------------------------------------------------------------------------
--------------------------------------------------------------------------------------------------------------------------------------------------------------------------------------------------------
---------------------------------------------------------------------------------------------------------------------2SCS-------------------------------------------------------------------------------
-----------------------------------------------------SU2------------------------------------------------------------------------------------------------------------------------------------------------
-------------------------------------------------------------------%%%---------------kr-----------------------------------------------------------------------------------------------------------------
-------------------------------------------------------------------|||-------------%%%%-------------------------------------SSSUSS----------------------------------------------------------------------
------------------------%%%%%---%%%%%---------------r--------------|||-------------||||----y-k----------------------%%%%%%%-----------------------------------------------------------------------------
------------------------|||||---|||||%%%%%--%%%%%%%%%%%%%-r--------|||----%%---%%%%%%%%%%%%%%%%%%%%%----------------|||||||----------%%%%%--%%%%%-------------------------------------------------------
%%%%%%%%%%%-------------|||||---||||||||||--|||||||||||||%%%%%%%%%%%%%%%%%||---|||||||||||||||||||||--#---#--%%---%%|||||||----------|||||--|||||-------------------------------------------------------
|||||||||||XXXXX---XXXXX|||||---||||||||||--||||||||||||||||||||||||||||||||---|||||||||||||||||||||XXX---XXX||---|||||||||XXXXXXXXXX|||||--|||||XXXXXXXXFXXXXXXXXXXXXXXXXXXXXXXXXXXXXXXXXXXXXXXXXXXXXXX
