HEIGHT=16;WIDTH=201;THEME=0;OVERRIDE=false
--------------------------------------------------------------------------------------------------------------------------------------------------------------------------------------------------------
--------------------------------------------------------------------------------------------------------------------------------------------------------------------------------------------------------
--------------------------------------------------------------------------------------------------------------------------------------------------------------------------------------------------------
--------------------------------------------------------------------------------------------------------------------------------------------------------------------------------------------------------
--------------------------------------------------------------------------------------------------------------------------------------------------------------------------------------------------------
--------------------------------------------------------------------------------------------------------------------------------------------------------------------------------------------------------
--------------------------------------------------------------------------------------------------------------------------------------------------------------------------------------------------------
--------------------------------------------------------------------------------------------------------------------------------------------------------------------------------------------------------
--------------------------------------------------------------------------------------------------------------------------------------------------------------------------------------------------------
--------------------------------------------------------------------------------------------------------------------------------------------------------------------------------------------------------
---------------------------------------------------------------------------------------------tt--tt---------tt------------------------------------------------------------------------------------------
-----------------------#---#-----------------------------------------------------------------tt--tt--tt-----tt------------------------------------------------------------------------------------------
----------------------##---##----------------------%%%%%-------------------------------------tt--tt--tt-%%%%%%%--------------------------%%%%%%%%F%%%%%%%%%%%%%%%%%%%%%%%%%%%%%%%%%%%%%%%%%%%%%%%%%%%%%%
--------------r-y----###---###--%%--%%%%%%%---%%%%%|||||-----------%%%%%--%%%%%-----------%%%%%%%%%%%%%%|||||||--------------------%%--%%||||||||%||||||||||||||||||||||||||||||||||||||||||||||||||||||
%%%%%%%%%%%%%%%%%%%%%%%%---%%%%%||--|||||||---||||||||||-----------|||||--|||||--#---#--%%|||||||||||||||||||||%%%%--%%%%----------||--|||||||||||||||||||||||||||||||||||||||||||||||||||||||||||||||||
||||||||||||||||||||||||---|||||||--|||||||---||||||||||XXXX---XXXX|||||--|||||XXX---XXX|||||||||||||||||||||||||||--||||XXXX--XXXX||--|||||||||||||||||||||||||||||||||||||||||||||||||||||||||||||||||
