HEIGHT=16;WIDTH=201;THEME=0;OVERRIDE=false
--------------------------------------------------------------------------------------------------------------------------------------------------------------------------------------------------------
--------------------------------------------------------------------------------------------------------------------------------------------------------------------------------------------------------
--------------------------------------------------------------------------------------------------------------------------------------------------------------------------------------------------------
--------------------------------------------------------------------------------------------------------------------------------------------------------------------------------------------------------
--------------------------------------------------------------------------------------------------------------------------------------------------------------------------------------------------------
--------------------------------------------------------------------------------------------------------------------------------------------------------------------------------------------------------
--------------------------------------------------------------------------------------------------------------------------------------------------------------------------------------------------------
--------------------------------------------------------------------------------------------------------------------------------------------------------------------------------------------------------
-------------------------------------------------------------------------------------------------------------CSUSSS-------------------------------------------------------------------------------------
------------------------------------------------------------------------------------------------2USSSUS2S-----------------------------------------------------------------------------------------------
-----------------------------------------------------------------------------%%%%%%------------------------------------------Tt-------------------------------------------------------------------------
----------------------------------#--#---------------------------------------||||||------------------------------------------tt-------------------------------------------------------------------------
%%%%%%%%%%%%%-------------------%%%--%%%----------%%---%%--------tt-----%%%%%%|||||-----------------k---k-%%%%%%%%%%---------tt---------%%%%%%%%F%%%%%%%%%%%%%%%%%%%%%%%%%%%%%%%%%%%%%%%%%%%%%%%%%%%%%%%
|||||||||||||%%%%%--%%%%%%%---%%|||--|||----------||---||----tt--tt-----|||||||||||------------%%%%%%%%%%%||||||||||--------%%%%%%%%%%%%||||||||%|||||||||||||||||||||||||||||||||||||||||||||||||||||||
||||||||||||||||||--|||||||---|||||--|||%%%%%%%%%%||---||----tt--tt-----||||||||||r--%%%%--%%%%|||||||||||||||||||||--#--#--||||||||||||||||||||||||||||||||||||||||||||||||||||||||||||||||||||||||||||
||||||||||||||||||--|||||||---|||||--|||||||||||||||---||XXXXXXXXXXXXXXXXXXXXXXXXXXXX||||--|||||||||||||||||||||||||XXX--XXX||||||||||||||||||||||||||||||||||||||||||||||||||||||||||||||||||||||||||||
