HEIGHT=16;WIDTH=201;THEME=0;OVERRIDE=false
--------------------------------------------------------------------------------------------------------------------------------------------------------------------------------------------------------
--------------------------------------------------------------------------------------------------------------------------------------------------------------------------------------------------------
--------------------------------------------------------------------------------------------------------------------------------------------------------------------------------------------------------
--------------------------------------------------------------------------------------------------------------------------------------------------------------------------------------------------------
--------------------------------------------------------------------------------------------------------------------------------------------------------------------------------------------------------
--------------------------------------------------------------------------------------------------------------------------------------------------------------------------------------------------------
--------------------------------------------------------------------------------------------------------------------------------------------------------------------------------------------------------
--------------------------------------------------------------------------------------------------------------------------------------------------------------------------------------------------------
--------------------------------------------------------------------------------------------------------------------------------------------------------------------------------------------------------
--------------------------------------------------------------------------------------------------------------------------------------------------------------------------------------------------------
------------------------------------------------------------------ky-------#---#----------------------------SSSC-SCCS-----------------------------------------------------------------------------------
------------------------------------------------------------------%%%-----##---##-----------------------------------------------------------------------------------------------------------------------
-----------------%%%%--%%%%---------------------------------------|||----###---###------tt-------%%%%-----------%---------------------------------------------------------------------------------------
-----------------||||--||||-------%%%%%---%%%%%-------------yy----r||--%%%%%---%%%%%----tt-------||||%%--%%----k|---------------------------------------------------------------------------------------
%%%%%%%%%%%%%%%%%||||--||||-------|||||---|||||---------%%%%%%%%%%%%%%%|||||---|||||----tt-------||||||--||%%%%%%%%%%%-------------%%%%%--%%%%%---------------------------------------------------------
|||||||||||||||||||||--||||XXXXXXX|||||---|||||XXXXXXXXX||||||||||||||||||||---|||||XXXXXXXXX--XX||||||--|||||||||||||XXXXX---XXXXX|||||--|||||XXXXXXXXFXXXXXXXXXXXXXXXXXXXXXXXXXXXXXXXXXXXXXXXXXXXXXXXX
