HEIGHT=16;WIDTH=201;THEME=0;OVERRIDE=false
--------------------------------------------------------------------------------------------------------------------------------------------------------------------------------------------------------
--------------------------------------------------------------------------------------------------------------------------------------------------------------------------------------------------------
--------------------------------------------------------------------------------------------------------------------------------------------------------------------------------------------------------
--------------------------------------------------------------------------------------------------------------------------------------------------------------------------------------------------------
--------------------------------------------------------------------------------------------------------------------------------------------------------------------------------------------------------
--------------------------------------------------------------------------------------------------------------------------------------------------------------------------------------------------------
--------------------------------------------------------------------------------------------------------------------------------------------------------------------------------------------------------
--------------------------------------------------------------------------------------------------------------------------------------------------------------------------------------------------------
-------------------------------SCCCSSS------------------------------------------------------------------------------------------------------------------------------------------------------------------
--------------------------------------------------------------------------------------------------------------------------------------------------------------------------------------------------------
---------------------------------------------------------------------------------------------------y----------------------------------------------------------------------------------------------------
------------------------------rr---------------------------------------------2S2CSC---------------%%%---------------------------------------------------------------------------------------------------
--------------%%---%%%%---%%%%%%%%%%%%%-----------#--#--------------------------------------------r||---------------------------------------------------------------------------------------------------
--------------||---||||---|||||||||||||%%---%%---##--##------------------------------%%%%%--%%%%%%%%%%%%%%%%%-----------#---#---------%%----------------------------------------------------------------
%%%%%%%%%%%%%%||---||||---|||||||||||||||---||--###--###--%%%%%--%%%%%---------------|||||--|||||||||||||||||%%%--%%%--##---##--------||%%%%%%%%F%%%%%%%%%%%%%%%%%%%%%%%%%%%%%%%%%%%%%%%%%%%%%%%%%%%%%%%
||||||||||||||||---||||---|||||||||||||||---||XXXXX--XXXXX|||||--|||||XX--XXXXXXXXXXX|||||--||||||||||||||||||||--|||XXXX---XXXXXXXXXX||||||||||X|||||||||||||||||||||||||||||||||||||||||||||||||||||||
