HEIGHT=16;WIDTH=201;THEME=0;OVERRIDE=false
--------------------------------------------------------------------------------------------------------------------------------------------------------------------------------------------------------
--------------------------------------------------------------------------------------------------------------------------------------------------------------------------------------------------------
--------------------------------------------------------------------------------------------------------------------------------------------------------------------------------------------------------
--------------------------------------------------------------------------------------------------------------------------------------------------------------------------------------------------------
--------------------------------------------------------------------------------------------------------------------------------------------------------------------------------------------------------
--------------------------------------------------------------------------------------------------------------------------------------------------------------------------------------------------------
--------------------------------------------------------------------------------------------------------------------------------------------------------------------------------------------------------
--------------------------------------------------------------------------------------------------------------------------------------------------------------------------------------------------------
----------------------------------------------------------------------------------------------------------------------------k---------------------------------------------------------------------------
---------------------------------------------------------------------------SSCS-----------------------------------------%%%%%%--------------------------------------------------------------------------
------------------------------USSS--------------------------------------------------------------------------------------||||||--------------------------------------------------------------------------
-------------------------------------#---#------------------------------------------------%%%%--------------------------||||||--------------------------------------------------------------------------
-----------------------------------%%%---%%%-------------%%%---%%%-----------k------------||||-------------%%%----------|%%%%|--%%--%%------------------------------------------------------------------
%%%%%%%%%%%---------------------r--|||---|||-----------%%|||---|||--------%%%%%%%%%-------||||--%%%%---%%%%|||%%%--%%%-r||||||--||--||------------------------------------------------------------------
|||||||||||%%%---%%%--#--#--%%%%%%%|||---|||%%%%---%%%%|||||---|||--------|||||||||-------||||--||||---||||||||||--|||%%%%%%%%%%||--||%%---%%-----------------------------------------------------------
||||||||||||||---|||XXX--XXX||||||||||---|||||||---|||||||||---|||XXX--XXX|||||||||XXXXXXXXXXXXX||||---||||||||||--|||||||||||||||--||||---||XXXXXXXXFXXXXXXXXXXXXXXXXXXXXXXXXXXXXXXXXXXXXXXXXXXXXXXXXXX
