HEIGHT=16;WIDTH=201;THEME=0;OVERRIDE=false
--------------------------------------------------------------------------------------------------------------------------------------------------------------------------------------------------------
--------------------------------------------------------------------------------------------------------------------------------------------------------------------------------------------------------
--------------------------------------------------------------------------------------------------------------------------------------------------------------------------------------------------------
--------------------------------------------------------------------------------------------------------------------------------------------------------------------------------------------------------
--------------------------------------------------------------------------------------------------------------------------------------------------------------------------------------------------------
--------------------------------------------------------------------------------------------------------------------------------------------------------------------------------------------------------
--------------------------------------------------------------------------------------------------------------------------------------------------------------------------------------------------------
----------------------------------------------------------------------------------------%%%%%-----------------------------------------------------------------------------------------------------------
----------------------------------------------------------------------------------------||k||-----------------------------------------------------------------------------------------------------------
----------------------------------------------------------------------------------------||%%%%%---------------------------------------------------------------------------------------------------------
----------------------------------------------------------------------------------------|||||||---------------------------------------------------------------------------------------------------------
-------------------------------tt---tt--------------------------------------------------|||||||-------------------#---#------#---#----------------------------------------------------------------------
-------------%%---%%-----------tt---tt-%%%%%%%---%%%%%----------------------%%%--%%%%%%%%%%%%%%%%%--------------%%%---%%%---##---##---------------------------------------------------------------------
%%%%%%%%%%%%%||---||%%%%%---%%%%%%%%%%%|||||||---|||||%%%%--%%%%------------|||--|||||||||||||||||--------------|||---|||--###---###--%%%%%%%%%%%%F%%%%%%%%%%%%%%%%%%%%%%%%%%%%%%%%%%%%%%%%%%%%%%%%%%%%%
|||||||||||||||---|||||||---||||||||||||||||||---|||||||||--||||------------|||--|||||||||||||||||--------------|||---|||%%%%%---%%%%%||||||||||||%|||||||||||||||||||||||||||||||||||||||||||||||||||||
|||||||||||||||---|||||||---||||||||||||||||||---|||||||||--||||XXXXX--XXXXX|||--|||||||||||||||||XX---XXXX---XX|||---||||||||---|||||||||||||||||||||||||||||||||||||||||||||||||||||||||||||||||||||||
