HEIGHT=16;WIDTH=201;THEME=0;OVERRIDE=false
--------------------------------------------------------------------------------------------------------------------------------------------------------------------------------------------------------
--------------------------------------------------------------------------------------------------------------------------------------------------------------------------------------------------------
--------------------------------------------------------------------------------------------------------------------------------------------------------------------------------------------------------
--------------------------------------------------------------------------------------------------------------------------------------------------------------------------------------------------------
--------------------------------------------------------------------------------------------------------------------------------------------------------------------------------------------------------
--------------------------------------------------------------------------------------------------------------------------------------------------------------------------------------------------------
--------------------------------------------------------------------------------------------------------------------------------------------------------------------------------------------------------
--------------------------------------------------------------------------------------------------------------------------------------------------------------------------------------------------------
-------------------------------------------%%%%--------U2S----------------------------------------------------------------------------------------------------------------------------------------------
------------------------------#--#---------||||---------------------------------------------------------------------------------------------------------------------------------------------------------
-----------------------------##--##--------||||----------------------------------------------------------------------#---#------------------------------------------------------------------------------
----------------------------###--###------y||||-gk----------g------------------------------Tt-----------------------##---##----#---#--------------------------------------------------------------------
%%%%%%%%%%%%%-------------%%%%%--%%%%%%%%%%%%%%%%%%%%%%%%%%%%%-------------#---#--------Tt-tt-Tt------------------%%%%---%%%%%%%---%%%------%%%%%%%%F%%%%%%%%%%%%%%%%%%%%%%%%%%%%%%%%%%%%%%%%%%%%%%%%%%%
|||||||||||||-------------|||||--|||||||||||||||||||||||||||||------------##---##-------tt-tt-tt------------------||||---|||||||---|||------||||||||%|||||||||||||||||||||||||||||||||||||||||||||||||||
|||||||||||||-------%%--%%|||||--|||||||||||||||||||||||||||||-----------###---###--%%%%%%%%%%%%%%%%%%%--%%%%%--%%||||---|||||||---|||------||||||||||||||||||||||||||||||||||||||||||||||||||||||||||||
|||||||||||||XXXXXXX||--|||||||--|||||||||||||||||||||||||||||XXX---XXXXXXXX---XXXXX|||||||||||||||||||--|||||--||||||---|||||||---|||XX--XX||||||||||||||||||||||||||||||||||||||||||||||||||||||||||||
