HEIGHT=16;WIDTH=201;THEME=0;OVERRIDE=false
--------------------------------------------------------------------------------------------------------------------------------------------------------------------------------------------------------
--------------------------------------------------------------------------------------------------------------------------------------------------------------------------------------------------------
--------------------------------------------------------------------------------------------------------------------------------------------------------------------------------------------------------
--------------------------------------------------------------------------------------------------------------------------------------------------------------------------------------------------------
--------------------------------------------------------------------------------------------------------------------------------------------------------------------------------------------------------
--------------------------------------------------------------------------------------------------------------------------------------------------------------------------------------------------------
-------------------------------------------------------------------------------------------------------------------------US2C---------------------------------------------------------------------------
--------------------------------------------------------------------------------------------------------------------------------------------------------------------------------------------------------
-----------------------------------------------------------------------------------------------------------%%%%%%---------------------------------------------------------------------------------------
---------------------------------#---#---------------------------------------------------------------------||||||--------G------------------------------------------------------------------------------
--------------------------------##---##--------------------------------------------------------------------||||||-------%%%%%%--------------------------------------------------------------------------
-------------------------------###---###--------------------------------------------------------------g----||g|||-------||||||-------#---#--------------------------------------------------------------
-----------------------%%--%%%%%%%---%%%%%---------------------%%%---%%%--------%%%%---%%%%%%%%%%%%%%%%%%%%%%%%%%%%%%---||||||------##---##-------------------------------------------------------------
------------%%%%---%%%%||--|||||||---|||||--------%%%%%---%%%%%|||---|||--------||||---||||||||||||||||||||||||||||||---|||||r-Gr-%%%%---%%%%-----------------------------------------------------------
%%%%%%%%%%%%||||---||||||--|||||||---|||||--------|||||---||||||||---|||--------||||---||||||||||||||||||||||||||||||%%%%%%%%%%%%%||||---||||-----------------------------------------------------------
||||||||||||||||---||||||--|||||||---|||||XXX--XXX|||||---||||||||---|||XXX--XXX||||---|||||||||||||||||||||||||||||||||||||||||||||||---||||XXXXXXXXFXXXXXXXXXXXXXXXXXXXXXXXXXXXXXXXXXXXXXXXXXXXXXXXXXX
