HEIGHT=16;WIDTH=201;THEME=0;OVERRIDE=false
--------------------------------------------------------------------------------------------------------------------------------------------------------------------------------------------------------
--------------------------------------------------------------------------------------------------------------------------------------------------------------------------------------------------------
--------------------------------------------------------------------------------------------------------------------------------------------------------------------------------------------------------
--------------------------------------------------------------------------------------------------------------------------------------------------------------------------------------------------------
--------------------------------------------------------------------------------------------------------------------------------------------------------------------------------------------------------
--------------------------------------------------------------------------------------------------------------------------------------------------------------------------------------------------------
--------------------------------------------------------------------------------------------------------------------------------------------------------------------------------------------------------
--------------------------------------------------------------------------------------------------------------------------------------------------------------------------------------------------------
--------------------------------------------------------------------------------------------------------------------------------------------------------------------------------------------------------
--------------------------------------------------------------------------------------------------------------------------------------------------------------------------------------------------------
--------------------tt----------------------------------------------------------------------------------------------------------------------------------------------------------------------------------
--------------------tt----------#--#------------------------------------------------------SSC-----------------------------------------------------------------------------------------------------------
--------------------tt---------##--##----------------%%%--------------------------Tt-----------------------tt-%%%%%---%%%%%-----------------------------------------------------------------------------
-----------%%%%%%%%%%%%%%%%%--###--###---------------|||------------%%%%%--%%%%%--tt-----------------------tt-|||||---|||||%%%%%--%%%%%--%%%%%%%%F%%%%%%%%%%%%%%%%%%%%%%%%%%%%%%%%%%%%%%%%%%%%%%%%%%%%%%
-----------|||||||||||||||||%%%%%--%%%%%-------------|||------------|||||--|||||--tt-----------%%%%%--%%%%%%%%|||||---||||||||||--|||||--||||||||%||||||||||||||||||||||||||||||||||||||||||||||||||||||
XXXXXXXXXXX||||||||||||||||||||||--|||||XXX---XXXXXXX|||XXXXX--XXXXX|||||--|||||XXXXXXXXXXXXXXX|||||--|||||||||||||---||||||||||--|||||XX|||||||||||||||||||||||||||||||||||||||||||||||||||||||||||||||
