HEIGHT=16;WIDTH=201;THEME=0;OVERRIDE=false
--------------------------------------------------------------------------------------------------------------------------------------------------------------------------------------------------------
--------------------------------------------------------------------------------------------------------------------------------------------------------------------------------------------------------
---------------------------------------------------gg---------------------------------------------------------------------------------------------------------------------------------------------------
-------------------------------------------------%%%%%%-------------------------------------------------------------------------------------------------------------------------------------------------
-------------------------------------------------||||||-r-----------------------------------------------------------------------------------------------------------------------------------------------
-------------------------------------------------|%%%%%%%-----------------------------------------------------------------------------------------------------------------------------------------------
-------------------------------------------------||||||||-----------------------------------------------------------------------------------------------------------------------------------------------
-------------------------------------------------||||||||-----------------------------------------------------------------------------------------------------------------------------------------------
-------------------------------------------------||%%%|||-----------------------------------------------------------------------------------------------------------------------------------------------
-------------------------------------------------||||||||-----------------------------------------------------------------------------------------------------------------------------------------------
-------------------------------------------------||||||||-----------------------------------------------------------------------------------------------------------------------------------------------
---------------------------y---------------------||||rg||------#---#------------------------------------------------------------------------------------------------------------------------------------
--------------------------%%%%%%%-------------%%%%%%%%%%%%%%%%%%---%%%----------------------------#--#-----------%%%%--%%%%-----------------%%%%%%%%F%%%%%%%%%%%%%%%%%%%%%%%%%%%%%%%%%%%%%%%%%%%%%%%%%%%
--------------------------|||||||-------------||||||||||||||||||---|||-------------%%------------##--##--%%%--%%%||||--||||%%%%--%%%%-------||||||||%|||||||||||||||||||||||||||||||||||||||||||||||||||
------------#---#--------%%%%%%%%%%%%%%%---%%%||||||||||||||||||---|||-------------||----------%%%%--%%%%|||--|||||||--||||||||--||||%%---%%||||||||||||||||||||||||||||||||||||||||||||||||||||||||||||
XXXXXXXXXXXXX---XXXXX--XX|||||||||||||||---|||||||||||||||||||||---|||XXXXX---XXXXX||XXXX--XXXX||||--|||||||--|||||||--||||||||--||||||---||||||||||||||||||||||||||||||||||||||||||||||||||||||||||||||
