HEIGHT=16;WIDTH=201;THEME=0;OVERRIDE=false
--------------------------------------------------------------------------------------------------------------------------------------------------------------------------------------------------------
--------------------------------------------------------------------------------------------------------------------------------------------------------------------------------------------------------
--------------------------------------------------------------------------------------------------------------------------------------------------------------------------------------------------------
--------------------------------------------------------------------------------------------------------------------------------------------------------------------------------------------------------
--------------------------------------------------------------------------------------------------------------------------------------------------------------------------------------------------------
--------------------------------------------------------------------------------------------------------------------------------------------------------------------------------------------------------
------------------------------------------------------------------------------------------------------------SSCS----------------------------------------------------------------------------------------
--------------------------------------------------------------------------------------------------------------------------------------------------------------------------------------------------------
---------------------------------------------------------------------------------%%%----------------------------------------r---------------------------------------------------------------------------
---------------------------------------------------------------------------------|||-----------------------------y----------%%%%----------#---#---------------------------------------------------------
---------------------------------------------------------------------------------|||------------------------%%%%%%----------||||---------##---##--------------------------------------------------------
------------------#--#--------------------------------------------------%%%%%%---|||------------------------||||||--------k-||||--------###---###-------------------------------------------------------
%%%%%%%%%%%%%%---##--##---------------------Tt-------%%%%%--------------||||||---|||---%%--%%----------%%%%-||g|||---y-%%%%%%%%%%%%%--%%%%%---%%%%%-----------------------------------------------------
||||||||||||||--###--###--------------------tt--tt---|||||%%%%--%%%%--r-||||||--y|||---||--||---#--#---||||%%%%%%%%%%%%|||||||||||||--|||||---|||||%%%%%%%%F%%%%%%%%%%%%%%%%%%%%%%%%%%%%%%%%%%%%%%%%%%%%
||||||||||||||%%%%%--%%%%%%%--%%------------tt--tt---|||||||||--||||%%%%%%%%%%%%%%%%%%%||--||--##--##--|||||||||||||||||||||||||||||--|||||---|||||||||||||%||||||||||||||||||||||||||||||||||||||||||||
|||||||||||||||||||--|||||||--||XXX--XXXXXXXXXXXXXXXX|||||||||--|||||||||||||||||||||||||--||XXXX--XXXX|||||||||||||||||||||||||||||XX|||||---||||||||||||||||||||||||||||||||||||||||||||||||||||||||||
