HEIGHT=16;WIDTH=201;THEME=0;OVERRIDE=false
--------------------------------------------------------------------------------------------------------------------------------------------------------------------------------------------------------
--------------------------------------------------------------------------------------------------------------------------------------------------------------------------------------------------------
--------------------------------------------------------------------------------------------------------------------------------------------------------------------------------------------------------
--------------------------------------------------------------------------------------------------------------------------------------------------------------------------------------------------------
--------------------------------------------------------------------------------------------------------------------------------------------------------------------------------------------------------
--------------------------------------------------------------------------------------------------------------------------------------------------------------------------------------------------------
--------------------------------------------------------------------------------------------------------------------------------------------------------------------------------------------------------
--------------------------------------------------------------------------------------------------------------------------------------------------------------------------------------------------------
--------------------------------------------------------------------------------------------------------------------------------------------------------------------------------------------------------
--------------------------------------------------------------------------------------------------------------------------------------------------------------------------------------------------------
----------------------------------------------------------------#--#------------------------------------------------------#---#-------------------------------------------------------------------------
---------------------------------------------------------------##--##-------#--#-----------------------------------------##---##------------------------------------------------------------------------
%%%%%%%%%%----------------------------------------------------###--###-----##--##---%%%--%%%-------%%--%%%%%%----------%%%%---%%%%-----#--#-------------------------------------------------------------
||||||||||----------------------------#--#---%%--%%---------%%%%%--%%%%%--###--###--|||--|||-------||--||||||----------||||---||||----##--##------------------------------------------------------------
||||||||||--------%%%%%---%%%%%------##--##--||--||%%%---%%%|||||--|||||%%%%%--%%%%%|||--|||-------||--||||||%%%%--%%%%||||---||||%%%%%%--%%%%%%%%%%%%F%%%%%%%%%%%%%%%%%%%%%%%%%%%%%%%%%%%%%%%%%%%%%%%%%
||||||||||XXX--XXX|||||---|||||XXXXXXXX--XXXX||--|||||---||||||||--||||||||||--||||||||--|||XX---XX||--||||||||||--||||||||---||||||||||--||||||||||||X|||||||||||||||||||||||||||||||||||||||||||||||||
