HEIGHT=16;WIDTH=201;THEME=0;OVERRIDE=false
--------------------------------------------------------------------------------------------------------------------------------------------------------------------------------------------------------
--------------------------------------------------------------------------------------------------------------------------------------------------------------------------------------------------------
--------------------------------------------------------------------------------------------------------------------------------------------------------------------------------------------------------
--------------------------------------------------------------------------------------------------------------------------------------------------------------------------------------------------------
--------------------------------------------------------------------------------------------------------------------------------------------------------------------------------------------------------
--------------------------------------------------------------------------------------------------------------------------------------------------------------------------------------------------------
--------------------------------------------------------------------------------------------------------------------------------------------------------------------------------------------------------
--------------------------------------------------------------------------------------------------------------------------------------------------------------------------------------------------------
--------------------------------------------------------------------------------------------------------------------------------------------------------------------------------------------------------
-------------------------------------------------------------------------------------------------tt-----------------------------------------------------------------------------------------------------
-------------------------------------------------------------------------------------------------tt-----------------------------------------------------------------------------------------------------
----------------------------------S2S2SS----------------------------------#---#------------------tt---k-------------------------------------------------------------------------------------------------
---------------tt------------------------%%%---%%%----------%%%%---%%%%--##---##--------------%%%%%%%%%%%%%%--------------------------------------------------------------------------------------------
%%%%%%%%%%%%---tt--%%---%%---------------|||---|||%%%%--%%%%||||---||||%%%%---%%%%---------%%%||||||||||||||%%--%%------------------------%%%%%%%%F%%%%%%%%%%%%%%%%%%%%%%%%%%%%%%%%%%%%%%%%%%%%%%%%%%%%%
||||||||||||%%%%%%%||---||%%--%%---------|||---|||||||--||||||||---||||||||---||||---------|||||||||||||||||||--||-----------%%--%%-------||||||||%|||||||||||||||||||||||||||||||||||||||||||||||||||||
|||||||||||||||||||||---||||--||XXXXXXXXX|||---|||||||--||||||||---||||||||---||||XXX---XXX|||||||||||||||||||--||XXXX---XXXX||--||XX---XX||||||||||||||||||||||||||||||||||||||||||||||||||||||||||||||
