HEIGHT=16;WIDTH=201;THEME=0;OVERRIDE=false
--------------------------------------------------------------------------------------------------------------------------------------------------------------------------------------------------------
--------------------------------------------------------------------------------------------------------------------------------------------------------------------------------------------------------
--------------------------------------------------------------------------------------------------------------------------------------------------------------------------------------------------------
--------------------------------------------------------------------------------------------------------------------------------------------------------------------------------------------------------
--------------------------------------------------------------------------------------------------------------------------------------------------------------------------------------------------------
--------------------------------------------------------------------------------------------------------------------------------------------------------------------------------------------------------
--------------------------------------------------------------------------------------------------------------------------------------------------------------------------------------------------------
--------------------------------------------------------------------------------------------------------------------------------------------------------------------------------------------------------
--------------------------------------------------------------------------------------k-----------------------------------------------------------------------------------------------------------------
------------------------------------------------------------2SS------------------%%%%%%---------------------------------------------------%%%%%%--------------------------------------------------------
---------------------------------------------------------------------------------||||||---------------------------------------------------||||||--------------------------------------------------------
---------------------------------------------------------------------------------||%%%%%%-------------------------------------------------||||||--------------------------------------------------------
---------------------------------------------%%%--%%%%%%%-r---g------------------||||||||--------------%%%%%---%%%%%-tt--Tt------------%%%%%%%%%%%%%%%%-------------------------------------------------
---------------------------------------------|||--|||||||%%%%%%%%%%-------------%%%%%%%%%%%%-----------|||||---|||||-tt--tt------------||||||||||||||||-------------------------------------------------
%%%%%%%%%%%%%%%%%---%%%%%%%%%--%%%%%%%%%%%%%%|||--|||||||||||||||||-------------||||||||||||%%%%---%%%%|||||---|||||%%%%%%%%%----------||||||||||||||||-------------------------------------------------
|||||||||||||||||---|||||||||--|||||||||||||||||--|||||||||||||||||XXXXX---XXXXX||||||||||||||||---|||||||||---||||||||||||||XXXX--XXXX||||||||||||||||XXXXXXXXFXXXXXXXXXXXXXXXXXXXXXXXXXXXXXXXXXXXXXXXX
