HEIGHT=16;WIDTH=201;THEME=0;OVERRIDE=false
--------------------------------------------------------------------------------------------------------------------------------------------------------------------------------------------------------
--------------------------------------------------------------------------------------------------------------------------------------------------------------------------------------------------------
--------------------------------------------------------------------------------------------------------------------------------------------------------------------------------------------------------
--------------------------------------------------------------------------------------------------------------------------------------------------------------------------------------------------------
--------------------------------------------------------------------------------------------------------------------------------------------------------------------------------------------------------
--------------------------------------------------------------------------------------------------------------------------------------------------------------------------------------------------------
--------------------------------------------------------------------------------------------------------------------------------------------------------------------------------------------------------
--------------------------------------------------------------------------------------------------------------------------------------------------------------------------------------------------------
---------------------------------------------------------S-SS-------------------------------------------------------------------------------------------------------------------------------------------
-----------------------------------#---#----------------------------------------------------------------------------------------------------------------------------------------------------------------
----------------------------------##---##-----------------%---------------------------------------------------------------------------------------------------------------------------------------------
---------------------------------###---###----------------|-----------------------------------------------------------------------#---#-----------------------------------------------------------------
-------------------------------%%%%%---%%%%%-----------%%%%%%%%%%----#---#-------------------------------------------------------##---##---%%%%%%%%F%%%%%%%%%%%%%%%%%%%%%%%%%%%%%%%%%%%%%%%%%%%%%%%%%%%%
-------------------------------|||||---|||||-----------||||||||||---##---##----------------%%%%%--%%%%%-------------------------###---###--||||||||%||||||||||||||||||||||||||||||||||||||||||||||||||||
------------------------#---#--|||||---|||||-----------||||||||||--###---###---------------|||||--|||||-----------------------%%%%%---%%%%%|||||||||||||||||||||||||||||||||||||||||||||||||||||||||||||
XXXXXXXXXXXXXXX---XXXXXXX---XXX|||||---|||||XXXX---XXXX||||||||||XXXXX---XXXXXXXXXX---XXXXX|||||--|||||XXXXX--XXXXXXXXX---XXXX|||||---||||||||||||||||||||||||||||||||||||||||||||||||||||||||||||||||||
