HEIGHT=16;WIDTH=201;THEME=0;OVERRIDE=false
--------------------------------------------------------------------------------------------------------------------------------------------------------------------------------------------------------
--------------------------------------------------------------------------------------------------------------------------------------------------------------------------------------------------------
--------------------------------------------------------------------------------------------------------------------------------------------------------------------------------------------------------
--------------------------------------------------------------------------------------------------------------------------------------------------------------------------------------------------------
--------------------------------------------------------------------------------------------------------------------------------------------------------------------------------------------------------
--------------------------------------------------------------------------------------------------------------------------------------------------------------------------------------------------------
--------------------------------------------------------------------------------------------------------------------------------------------------------------------------------------------------------
--------------------------------------------------------------------------------------------------------------------------------------------------------------------------------------------------------
--------------------------------------------------------------------------------------------------------------------------------------------------------------------------------------------------------
--------------------------------------------------------------------------------------------------------------------------------------------------------------------------------------------------------
----------------------------------------------------------22S222S---------------------------------------------------------------------------------------------------------------------------------------
--------------------------------------------------------------------------------------------------------------------------------------------------------------------------------------------------------
%%%%%%%%%%%%----------------------------------------------------------------------------%%%%--%%%%------------------------------------------------------------------------------------------------------
||||||||||||--------%%%%%---%%%%%%%%%%--%%%%%%%%%--%%%%-gk----r---%%%%%--%%%%%----------||||--||||------------------------------------------------------------------------------------------------------
||||||||||||%%%--%%%|||||---||||||||||--|||||||||--||||%%%%%%%%%%%|||||--|||||%%%%------||||--||||%%--%%%%--%%-----%%%---%%%---------#--#---------------------------------------------------------------
|||||||||||||||--||||||||---||||||||||--|||||||||--||||||||||||||||||||--|||||||||XXXXXX||||--||||||--||||--||XXXXX|||---|||XX---XXXXX--XXXXXXXXXXXFXXXXXXXXXXXXXXXXXXXXXXXXXXXXXXXXXXXXXXXXXXXXXXXXXXXX
