HEIGHT=16;WIDTH=201;THEME=0;OVERRIDE=false
--------------------------------------------------------------------------------------------------------------------------------------------------------------------------------------------------------
--------------------------------------------------------------------------------------------------------------------------------------------------------------------------------------------------------
--------------------------------------------------------------------------------------------------------------------------------------------------------------------------------------------------------
--------------------------------------------------------------------------------------------------------------------------------------------------------------------------------------------------------
--------------------------------------------------------------------------------------------------------------------------------------------------------------------------------------------------------
---------------------------------------------------------------------------gygk-------------------------------------------------------------------------------------------------------------------------
--------------------------------------------------------------------------%%%%%%------------------------------------------------------------------------------------------------------------------------
-------------------------------------------------------%%%%%%-------------||||||------------------------------------------------------------------------------------------------------------------------
-------------------------------------------------------||||||-------------||||||-------------CUSU-------------------------------------------------------------------------------------------------------
-------------------------------------------------------||||||-------------||||||K-----------------------------------------------------------------------------------------------------------------------
-----------------------------------------------------k-g|||||-------------||%%%%%%%---------------------------------------------------------------------------------------------------------------------
-----------------------------------------------------%%%|||||-------------|||||||||-----------------------------------tt--------------------------------------------------------------------------------
----------------------%%%%%%---------%%%%%---%%%%%---||||||||-------------|||||||||-------%%%%%%%%%%--------%%--%%-tt-tt--------------------------------------------------------------------------------
%%%%%%%%%%%%%---------||||||--#---#--|||||---|||||---|k||||k|--%%%%--%%%%-|||||y|||--r----||||||||||--------||--||-tt-tt------------------#--#---%%%%%%%%F%%%%%%%%%%%%%%%%%%%%%%%%%%%%%%%%%%%%%%%%%%%%%%
|||||||||||||%%%---%%%||||||%%%---%%%|||||---|||||%%%%%%%%%%%%%||||--||||%%%%%%%%%%%%%%%%%||||||||||--------||--||%%%%%%%%---------------##--##--||||||||%||||||||||||||||||||||||||||||||||||||||||||||
||||||||||||||||---||||||||||||---||||||||---||||||||||||||||||||||--|||||||||||||||||||||||||||||||XXXXXXXX||--||||||||||XXXXX---XXXXXXXXX--XXXX|||||||||||||||||||||||||||||||||||||||||||||||||||||||
