HEIGHT=16;WIDTH=201;THEME=0;OVERRIDE=false
--------------------------------------------------------------------------------------------------------------------------------------------------------------------------------------------------------
--------------------------------------------------------------------------------------------------------------------------------------------------------------------------------------------------------
--------------------------------------------------------------------------------------------------------------------------------------------------------------------------------------------------------
--------------------------------------------------------------------------------------------------------------------------------------------------------------------------------------------------------
--------------------------------------------------------------------------------------------------------------------------------------------------------------------------------------------------------
--------------------------------------------------------------------------------------------------------------------------------------------------------------------------------------------------------
--------------------------------------------------------------------------------------------------------------------------------------------------------------------------------------------------------
--------------------------------------------------------------------------------------------------------------------------------------------------------------------------------------------------------
--------------------------------------------------------------------------------------------------------------------------------------------------------------------------------------------------------
--------------------------------------------------------------------#--#--------------------------------------------------------------------------------------------------------------------------------
-------------------------------------------------------------------##--##-------------------------------------------2CC------------------%%%%%----------------------------------------------------------
------------------------------------------------------------------###--###-----#--#------------------------------------------------------|||||---Y------------------------------------------------------
---------------------------------%%%%%%%%%%%%---%%%%%-----%%--%%%%%%%--%%%%%--##--##---------------------------------------%%%%---%%%%%%%%%%%%%%%%%-----------------------------------------------------
%%%%%%%%%%%%%%%%---%%%%%---------||||||||||||---|||||-----||--|||||||--|||||%%%%--%%%%-----------------------------------%%||||---|||||||||||||||||-----------------------------------------------------
||||||||||||||||---|||||---------||||||||||||---|||||-----||--|||||||--|||||||||--||||%%%%%%%%%%---------%%---%%%%%%%%%%%||||||---|||||||||||||||||%%%%%%%%F%%%%%%%%%%%%%%%%%%%%%%%%%%%%%%%%%%%%%%%%%%%%
||||||||||||||||---|||||XXX---XXX||||||||||||---|||||XXXXX||--|||||||--|||||||||--||||||||||||||XXX---XXX||---|||||||||||||||||---|||||||||||||||||||||||||X||||||||||||||||||||||||||||||||||||||||||||
