HEIGHT=16;WIDTH=201;THEME=0;OVERRIDE=false
--------------------------------------------------------------------------------------------------------------------------------------------------------------------------------------------------------
--------------------------------------------------------------------------------------------------------------------------------------------------------------------------------------------------------
--------------------------------------------------------------------------------------------------------------------------------------------------------------------------------------------------------
--------------------------------------------------------------------------------------------------------------------------------------------------------------------------------------------------------
--------------------------------------------------------------------------------------------------------------------------------------------------------------------------------------------------------
--------------------------------------------------------------------------------------------------------------------------------------------------------------------------------------------------------
--------------------------------------------------------------------------------------------------------------------------------------------------------------------------------------------------------
--------------------------------------------------------------------------------------------------------------------------------------------------------------------------------------------------------
--------------------------------------------------------------------------------------------------------------------------------------------------------------------------------------------------------
----------------------------------------------g--------------------------------------------------------SUUS---------------------------------------------------------------------------------------------
-----------------tt---------------------%%%%%%%---------------------------SS-SSSC-----------------------------------------------------------------------------------------------------------------------
-----------------tt---------------------|||||||-----%%%%%%----------------------------------#--#--------------------------------------------------------------------------------------------------------
--------------%%%%%%%%%%%%--%%%%%%%%%%%%%%%%%%%%%%%-||||||--------#--#------%--------------##--##-----g-----y--%%%--------------------------------------------------------------------------------------
%%%%%%%%%%%%%%||||||||||||--|||||||||||||||||||||||-||||||-------##--##---kY|--y---%%%%%--###--###--%%%%%%%%%%-|||--------------------------------------------------------------------------------------
||||||||||||||||||||||||||--|||||||||||||||||||||||%%%%%%%%%%%%%%%%--%%%%%%%%%%%%%%|||||%%%%%--%%%%%||||||||||%%%%%%%%%%%%%%%%%%%%%--%%%%%%%%%%%%%F%%%%%%%%%%%%%%%%%%%%%%%%%%%%%%%%%%%%%%%%%%%%%%%%%%%%%
||||||||||||||||||||||||||--|||||||||||||||||||||||||||||||||||||||--||||||||||||||||||||||||--||||||||||||||||||||||||||||||||||||--|||||||||||||X|||||||||||||||||||||||||||||||||||||||||||||||||||||
