HEIGHT=16;WIDTH=201;THEME=0;OVERRIDE=false
--------------------------------------------------------------------------------------------------------------------------------------------------------------------------------------------------------
--------------------------------------------------------------------------------------------------------------------------------------------------------------------------------------------------------
--------------------------------------------------------------------------------------------------------------------------------------------------------------------------------------------------------
--------------------------------------------------------------------------------------------------------------------------------------------------------------------------------------------------------
--------------------------------------------------------------------------------------------------------------------------------------------------------------------------------------------------------
--------------------------------------------------------------------------------------------------------------------------------------------------------------------------------------------------------
--------------------------------------------------------------------------------------------------------------------------------------------------------------------------------------------------------
-------------K--------------------------------------------------------------------------------------------------------------SCCS------------------------------------------------------------------------
------------%%%%------------------------------------------------------------------------------------------------------------------------y---------------------------------------------------------------
------------||||-----------------------------------------------------------------------------------------------------------------------%%%%%------------------------------------------------------------
------------||||----------------------------------------------------------------------------------------------------------k-y----------|||||------------------------------------------------------------
------------||||-----------SSCSSSSS-----------------------------------------------------------------------CSCSSCSS--------%%%%%%%------|||||------------------------------------------------------------
----------%%%%%%%%%%%%----------------------------------------------------------------------------------------------------|||||||------|||||----G-------------------------------------------------------
%%%%%%%%%%||||||||||||--------------------%%%%---%%%%-------------------%%%%%-------%%%%%--%%%%%--------------------------|||||||---%%%%%%%%%%%%%%%-----------------------------------------------------
||||||||||||||||||||||%%%---r----y--%%--%%||||---||||-------%%%%%--%%%%%|||||%%---%%|||||--|||||--#--#---k---k------------|||||||---|||||||||||||||-----------------------------------------------------
|||||||||||||||||||||||||XXXXXXXXXXX||--||||||---||||XX---XX|||||--||||||||||||---|||||||--|||||XXX--XXXXXXXXXXXXXXXXXXXXXXXXXXXXXXX|||||||||||||||XXXXXXXXFXXXXXXXXXXXXXXXXXXXXXXXXXXXXXXXXXXXXXXXXXXXX
