HEIGHT=16;WIDTH=201;THEME=0;OVERRIDE=false
--------------------------------------------------------------------------------------------------------------------------------------------------------------------------------------------------------
--------------------------------------------------------------------------------------------------------------------------------------------------------------------------------------------------------
--------------------------------------------------------------------------------------------------------------------------------------------------------------------------------------------------------
---------------------------------------------------------------------------------------------------%%%%%%-----------------------------------------------------------------------------------------------
---------------------------------------------------------------------------------------------------||||||-----------------------------------------------------------------------------------------------
---------------------------------------------------------------------------------------------------||||||-----------------------------------------------------------------------------------------------
------------------%%%%%%---------------------------------------------------------------------------||||||-----------------------------------------------------------------------------------------------
------------------||||||-----------------------------------------------------------------------%%%%%%%|||-----------------------------------------------------------------------------------------------
------------------||||||-----------------------------------------------------------------------||||||||||-----------------------------------------------------------------------------------------------
------------------||||||------------------------------#--#-------------------------------------||||||||||----y--g---------------------------------------------------------------------------------------
-------------%%%%%%%||||-----------------------------##--##------------tt----------------------||||||y|||---%%%%%%%------%%%%%--------------------------------------------------------------------------
-------------||||||r||Gyk---------------------------###--###-----------tt----------------------||%%%%%%%|---|||||||------|||||y-y-----------------------------------------------------------------------
------------%%%%%%%%%%%%%%------%%---#--#---------%%%%%--%%%%%%%---%%--tt-------------%%%--%%%-||||||||||---r|Y||||--%%%%%%%%%%%%%%%%%%----------%%%%%%%%F%%%%%%%%%%%%%%%%%%%%%%%%%%%%%%%%%%%%%%%%%%%%%%
------------||||||||||||||------||--##--##--------|||||--|||||||---||%%%%%%%%---------|||--|||-||||||||||--%%%%%%%%%%||||||||||||||||||%%%%--%%%%||||||||%||||||||||||||||||||||||||||||||||||||||||||||
%%%%%%%%%%%%||||||||||||||%%--%%||%%%%--%%%%------|||||--|||||||---||||||||||%%%---%%%|||--|||-||||||||||--||||||||||||||||||||||||||||||||--|||||||||||||||||||||||||||||||||||||||||||||||||||||||||||
||||||||||||||||||||||||||||--||||||||--||||XX--XX|||||--|||||||---|||||||||||||---||||||--|||XXXXXXXXXXXXX||||||||||||||||||||||||||||||||--|||||||||||||||||||||||||||||||||||||||||||||||||||||||||||
