HEIGHT=16;WIDTH=201;THEME=0;OVERRIDE=false
--------------------------------------------------------------------------------------------------------------------------------------------------------------------------------------------------------
--------------------------------------------------------------------------------------------------------------------------------------------------------------------------------------------------------
--------------------------------------------------------------------------------------------------------------------------------------------------------------------------------------------------------
--------------------------------------------------------------------------------------------------------------------------------------------------------------------------------------------------------
--------------------------------------------------------------------------------------------------------------------------------------------------------------------------------------------------------
--------------------------------------------------------------------------------------------------------------------------------------------------------------------------------------------------------
--------------------------------------------------------------------------------------------------------------------------------------------------------------------------------------------------------
--------------------------------------------------------------------------------------------------------------------------------------------------------------------------------------------------------
--------------------------------------------------------------------------------------------------------------------------------------------------------------------------------------------------------
--------------------------------------------------------------------------------------------------------------------------------------------------------------------------------------------------------
----------------#--#------------------------------------------------------------------#---#-------------------------------------------------------------------------------------------------------------
---------------##--##-----------------#--#------#--#----------------------#---#------##---##--------------------------------------tt--------------------------------------------------------------------
-------------%%%%--%%%%-------------%%%--%%%---##--##---------%%%---%%%--##---##----###---###---------%%--%%----------------------tt--------------------------------------------------------------------
-------------||||--||||%%%%%---%%%%%|||--|||--###--###---Tt---|||---|||%%%%---%%%%%%%%%---%%%%%%%%%%%%||--||--------%%%%---%%%%%%%%%%%%%%---------------------------------------------------------------
-------------||||--|||||||||---||||||||--|||%%%%%--%%%%%-tt---|||---|||||||---|||||||||---||||||||||||||--||--#--#--||||---||||||||||||||---------------------------------------------------------------
XXXXXXXXXXXXX||||--|||||||||---||||||||--||||||||--|||||XXXXXX|||---|||||||---|||||||||---||||||||||||||--||XXX--XXX||||---||||||||||||||XXXXXXXXFXXXXXXXXXXXXXXXXXXXXXXXXXXXXXXXXXXXXXXXXXXXXXXXXXXXXXX
