HEIGHT=16;WIDTH=201;THEME=0;OVERRIDE=false
--------------------------------------------------------------------------------------------------------------------------------------------------------------------------------------------------------
--------------------------------------------------------------------------------------------------------------------------------------------------------------------------------------------------------
--------------------------------------------------------------------------------------------------------------------------------------------------------------------------------------------------------
--------------------------------------------------------------------------------------------------------------------------------------------------------------------------------------------------------
--------------------------------------------------------------------------------------------------------------------------------------------------------------------------------------------------------
--------------------------------------------------------------------------------------------------------------------------------------------------------------------------------------------------------
-------------------------S2S----------------------------------------------------------------------------------------------------------------------------------------------------------------------------
--------------------------------------------------------------------------------------------------------------------------------------------------------------------------------------------------------
----------------------------|---------------------------------------------------------------------------------------------------------------------------------------------------------------------------
-------------------------y--k---------------------------------------------------------------------------------------------------------------------------------------------------------------------------
-------------------------%%%%-------------%%%------------------------------------------------------------------------------rgg--------------------------------------------------------------------------
-------------------------||||-------------|||---------------------------------------------------------------y--------------%%%%%------------------------------------------------------------------------
-------------------------||||---%%%%%%%%%%%%%%%%%%%%%---#--#-----------------------------------------------%%%-------------|||||------------------------------------------------------------------------
-------------------g-r---||||---|||||||||||||||||||||--##--##----------------------------------%%%%%-------|||----------%%%%%%%%%%%%%%--%%%-------------------------------------------------------------
--------------%%%%%%%%%%%%%%%%%%|||||||||||||||||||||%%%%--%%%%%%%%%--%%%%%-----------%%%---%%%|||||----g--|k|----------||||||||||||||--|||%%%%%%%%F%%%%%%%%%%%%%%%%%%%%%%%%%%%%%%%%%%%%%%%%%%%%%%%%%%%%
XXXXXXXXXXXXXX|||||||||||||||||||||||||||||||||||||||||||--|||||||||--|||||XXXX---XXXX|||---||||||||XXXXXXXXXXXXXXX---XX||||||||||||||--|||||||||||X||||||||||||||||||||||||||||||||||||||||||||||||||||
