HEIGHT=16;WIDTH=201;THEME=0;OVERRIDE=false
--------------------------------------------------------------------------------------------------------------------------------------------------------------------------------------------------------
--------------------------------------------------------------------------------------------------------------------------------------------------------------------------------------------------------
--------------------------------------------------------------------------------------------------------------------------------------------------------------------------------------------------------
--------------------------------------------------------------------------------------------------------------------------------------------------------------------------------------------------------
--------------------------------------------------------------------------------------------------------------------------------------------------------------------------------------------------------
--------------------------------------------------------------------------------------------------------------------------------------------------------------------------------------------------------
----------------------------------------y---------------------------------------------------------------------------------------------------------------------------------------------------------------
---------------------------------------%%%--------------------------------------------------------------------------------------------------------------------------------------------------------------
----------------------------SSSCS------|||--------------------------------------------------------------------------------------------------------------------------------------------------------------
---------------------------------------|||--------------------------------------------------------------------------------------------------------------------------------------------------------------
---------------------------------------|||--------------------------------------------------------------------------------------------------------------------------------------------------------------
-----------------------------k---------|||----%%%-------#---#-----Tt------------------------------------------------------------------------------------------------------------------------------------
-------------------%%%%----%%%%%%%%%---|||----|||------##---##----tt--Tt------%%---%%-------------------------------------------------------------------------------------------------------------------
%%%%%%%%%%%%%------|||k----|||||||||--g|y|---g|k|-----###---###---tt--tt------||---||%%%%%---%%%%%%%%%--%%%%--------------------------------------------------------------------------------------------
|||||||||||||%%%%%%%%%%%%%%|||||||||%%%%%%%%%%%%%%%%%%%%%---%%%%%%%%%%%%%%%%%%||---|||||||---|||||||||--||||------------%%%%---%%%%%%%%%---%%%%%%%%%%%%%F%%%%%%%%%%%%%%%%%%%%%%%%%%%%%%%%%%%%%%%%%%%%%%%
|||||||||||||||||||||||||||||||||||||||||||||||||||||||||---||||||||||||||||||||---|||||||---|||||||||--||||XXXXX--XXXXX||||---|||||||||---|||||||||||||X|||||||||||||||||||||||||||||||||||||||||||||||
