HEIGHT=16;WIDTH=201;THEME=0;OVERRIDE=false
--------------------------------------------------------------------------------------------------------------------------------------------------------------------------------------------------------
--------------------------------------------------------------------------------------------------------------------------------------------------------------------------------------------------------
--------------------------------------------------------------------------------------------------------------------------------------------------------------------------------------------------------
--------------------------------------------------------------------------------------------------------------------------------------------------------------------------------------------------------
--------------------------------------------------------------------------------------------------------------------------------------------------------------------------------------------------------
--------------------------------------------------------------------------------------------------------------------------------------------------------------------------------------------------------
--------------------------------------------------------------------------------------------------------------------------------------------------------------------------------------------------------
--------------------------------------------------------------------------------------------------------------------------------------------------------------------------------------------------------
--------------------------------------------------------------------------------------------------------------------------SS2SS2------------------------------------------------------------------------
-------------------------------------------------S-S----------------------------------------------------------------------------------------------------------------------------------------------------
-----------------------------------------------------------------------%%%%%------------------------SSCC------------------------------------------------------------------------------------------------
--------------------------------------------------%--------------------|||||---------------------------------------------y-----------#---#--------------------------------------------------------------
%%%%%%%%%%%%%-----------%%%%--%%%%---#---#----y---|-rG-----------------|||||------------------------------%%%%%---%%%%%%%%%%%%%%%%--##---##--%%%%%%%%F%%%%%%%%%%%%%%%%%%%%%%%%%%%%%%%%%%%%%%%%%%%%%%%%%%
|||||||||||||-----------||||--||||--##---##--%%%%%%%%%%%%%---%%%--y----|||||------------------------------|||||---||||||||||||||||%%%%---%%%%||||||||%||||||||||||||||||||||||||||||||||||||||||||||||||
|||||||||||||-----------||||--||||%%%%---%%%%|||||||||||||---|||%%%%%%%%%%%%%%%%%%%---%%-----------%%%%%%%|||||---||||||||||||||||||||---|||||||||||||||||||||||||||||||||||||||||||||||||||||||||||||||
|||||||||||||XXXXXXXXXXX||||--||||||||---|||||||||||||||||---||||||||||||||||||||||---||XXXX---XXXX||||||||||||---||||||||||||||||||||---|||||||||||||||||||||||||||||||||||||||||||||||||||||||||||||||
