HEIGHT=16;WIDTH=201;THEME=0;OVERRIDE=false
--------------------------------------------------------------------------------------------------------------------------------------------------------------------------------------------------------
--------------------------------------------------------------------------------------------------------------------------------------------------------------------------------------------------------
--------------------------------------------------------------------------------------------------------------------------------------------------------------------------------------------------------
--------------------------------------------------------------------------------------------------------------------------------------------------------------------------------------------------------
--------------------------------------------------------------------------------------------------------------------------------------------------------------------------------------------------------
--------------------------------------------------------------------------------------------------------------------------------------------------------------------------------------------------------
--------------------------------------------------------------------------------------------------------------------------------------------------------------------------------------------------------
--------------------------------------------------------------------------------------------------------------------------------------------------------------------------------------------------------
------------------------------------------------------%%%%%%---------------SCCUSSS----------------------------------------------------------------------------------------------------------------------
------------------------------------------------------||||||--------------------------------------------------------------------------------------------------------------------------------------------
------------------------------------------------------||||||-----SSCS2S---------------------------------------------------------------------------------------------------------------------------------
------------------------------------------------------||||||--------------------------------------------------------------------------------------------------------------------------------------------
------------%%%---%%%-------------%%--%%------------%%%%%%%%%%----------%%%%%%%%%%%---------------------tt---tt-----------------------------------------------------------------------------------------
------------|||---|||%%%%%---%%%%%||--||------------||||||||||----------|||||||||||%%%%--%%%%---#--#----tt---tt---%%%%--%%%%%%--%%------------%%%%%%%%F%%%%%%%%%%%%%%%%%%%%%%%%%%%%%%%%%%%%%%%%%%%%%%%%%
------------|||---||||||||---|||||||--||------------||||||||||%%%%%%%%%%|||||||||||||||--||||--##--##--%%%%%%%%%%%||||--||||||--||------------||||||||%|||||||||||||||||||||||||||||||||||||||||||||||||
XXXXXXXXXXXX|||---||||||||---|||||||--||XXXXX--XXXXX|||||||||||||||||||||||||||||||||||--||||XXXX--XXXX|||||||||||||||--||||||--||XXXXX--XXXXX||||||||||||||||||||||||||||||||||||||||||||||||||||||||||
