HEIGHT=16;WIDTH=201;THEME=0;OVERRIDE=false
--------------------------------------------------------------------------------------------------------------------------------------------------------------------------------------------------------
--------------------------------------------------------------------------------------------------------------------------------------------------------------------------------------------------------
--------------------------------------------------------------------------------------------------------------------------------------------------------------------------------------------------------
--------------------------------------------------------------------------------------------------------------------------------------------------------------------------------------------------------
--------------------------------------------------------------------------------------------------------------------------------------------------------------------------------------------------------
--------------------------------------------------------------------------------------------------------------------------------------------------------------------------------------------------------
--------------------------------------------------------------------------------------------------------------------------------------------------------------------------------------------------------
-----------------------------------------------------------------------------------------------------------CS2S-----------------------------------------------------------------------------------------
------------------------------------SUCC----------------------------------------------------------------------------------------------------------------------------------------------------------------
-------------------------------------------------------------------------SUS----------------------------------------------------------------------------------------------------------------------------
--------------------------------------------------------------------------------------y-----------------------------------------------------------------------------------------------------------------
-------------------------------------------------------------------------------------%%%%%%%--------------%%%%%------------y------#--#------------------------------------------------------------------
%%%%%%%%%%%--------------%%%%--%%%%%%%%%%%%%%%%------------%%%%---%%%%-----g---------|||||||--------------|||||-----------%%%%%%%%%--%%%----------------------------------------------------------------
|||||||||||-----------%%%||||--||||||||||||||||%%--%%%%--%%||||---||||%%%%%%%--------|||||||--------------|||||-----------|||||||||--|||----------------------------------------------------------------
|||||||||||%%%%---%%%%|||||||--||||||||||||||||||--||||--||||||---|||||||||||%%--%%%%%%%%%%%%%%%%%---%%-g-||||y-----------|||||||||--|||----------------------------------------------------------------
|||||||||||||||---|||||||||||--||||||||||||||||||--||||--||||||---|||||||||||||--|||||||||||||||||---||XXXXXXXXXXXXXXXXXXX|||||||||--|||XXXXXXXXFXXXXXXXXXXXXXXXXXXXXXXXXXXXXXXXXXXXXXXXXXXXXXXXXXXXXXXX
