HEIGHT=16;WIDTH=201;THEME=0;OVERRIDE=false
--------------------------------------------------------------------------------------------------------------------------------------------------------------------------------------------------------
--------------------------------------------------------------------------------------------------------------------------------------------------------------------------------------------------------
--------------------------------------------------------------------------------------------------------------------------------------------------------------------------------------------------------
--------------------------------------------------------------------------------------------------------------------------------------------------------------------------------------------------------
--------------------------------------------------------------------------------------------------------------------------------------------------------------------------------------------------------
--------------------------------------------------------------------------------------------------------------------------------------------------------------------------------------------------------
--------------------------------------------------------------------------------------------------------------------------------------------------------------------------------------------------------
--------------------------------------------------------------------------------------------------------------------------------------------------------------------------------------------------------
-------------------------------------------------------------------k------------------------------------------------------------------------------------------------------------------------------------
--------------------------------------------------------------%%%%%%%-----------------------------------------------------------------------------------------------------------------------------------
--------------------------------------------------------------|||||||-----------------------------------------------------------------------------------------------------------------------------------
-----------------------------------------%%%---------------%%%%||||||-----------------------------------------------------------------------------------------------------------------------------------
%%%%%%%%%%%%%%---------------------------|||---------------r|||||||||----------------------%%%%---%%%%------------------------y------%%%%--%%%%%%%%%%%%F%%%%%%%%%%%%%%%%%%%%%%%%%%%%%%%%%%%%%%%%%%%%%%%%
||||||||||||||------------------------r--|||------------%%%%|||||||||--------%%---%%-------||||---||||%%%---%%%-------------%%%%-----||||--||||||||||||%||||||||||||||||||||||||||||||||||||||||||||||||
||||||||||||||-------------------%%%%%%%%%%%%%%%%%%%----|||||||r|||||--------||---||%%%%%%%||||---|||||||---|||-------------|g||-----||||--|||||||||||||||||||||||||||||||||||||||||||||||||||||||||||||
||||||||||||||XXXXX---XXXXXXXXXXX|||||||||||||||||||XXXXXXXXXXXXXXXXXXXXX--XX||---|||||||||||||---|||||||---|||XXXX--XXXXXXXXXXXXXXXX||||--|||||||||||||||||||||||||||||||||||||||||||||||||||||||||||||
