HEIGHT=16;WIDTH=201;THEME=0;OVERRIDE=false
--------------------------------------------------------------------------------------------------------------------------------------------------------------------------------------------------------
--------------------------------------------------------------------------------------------------------------------------------------------------------------------------------------------------------
--------------------------------------------------------------------------------------------------------------------------------------------------------------------------------------------------------
--------------------------------------------------------------------------------------------------------------------------------------------------------------------------------------------------------
--------------------------------------------------------------------------------------------------------------------------------------------------------------------------------------------------------
-----------------------------------------------------------------------------------------------------------------------------2SSSU----------------------------------------------------------------------
--------------------------------------------------------------------------------------------------------------------------------------------------------------------------------------------------------
--------------------------------------------------------------------------------------------------------------------------------------------------------------------------------------------------------
--------------------------------------------------------------------------------------------------------------------------------------------------------------------------------------------------------
-----------------------------------------------------------------------------------------C2US--------------------------------%%%%%%---------------------------------------------------------------------
----------------------------------SSCSU-----------------------------------------------------------tt-------------------------||||||---------------------------------------------------------------------
------------#--#---------------------------------------#--#----------------------------------%----tt-------------------------|||||%%%%%%----------------------------------------------------------------
%%%%%%%%%%%%%--%%%--------------------------#---#-----##--##---------------------------------|----tt--------#--#--%%%--%%%---|||||||||||----------------------------------------------------------------
|||||||||||||--|||---------%%--%%----------##---##--%%%%--%%%%%%%%%%%%%%%%%%%%---%%%%%%%%%%%%%%%%%%%%%%%%%%%%--%%%|||--|||---|||||||||||----------------------------------------------------------------
|||||||||||||--|||%%%---%%%||--||%%%%%%%%%%%%---%%%%||||--||||||||||||||||||||---||||||||||||||||||||||||||||--||||||--|||---|||||||||||--y--%%%%%%%%F%%%%%%%%%%%%%%%%%%%%%%%%%%%%%%%%%%%%%%%%%%%%%%%%%%
|||||||||||||--||||||---|||||--||||||||||||||---||||||||--||||||||||||||||||||---||||||||||||||||||||||||||||--||||||--|||XXXXXXXXXXXXXXXXXXX||||||||X||||||||||||||||||||||||||||||||||||||||||||||||||
