HEIGHT=16;WIDTH=201;THEME=0;OVERRIDE=false
--------------------------------------------------------------------------------------------------------------------------------------------------------------------------------------------------------
--------------------------------------------------------------------------------------------------------------------------------------------------------------------------------------------------------
--------------------------------------------------------------------------------------------------------------------------------------------------------------------------------------------------------
--------------------------------------------------------------------------------------------------------------------------------------------------------------------------------------------------------
--------------------------------------------------------------------------------------------------------------------------------------------------------------------------------------------------------
--------------------------------------------------------------------------------------------------------------------------------------------------------------------------------------------------------
--------------------------------------------------------------------------------------------------------------------------------------------------------------------------------------------------------
--------------------------------------------------------------------------------------------------------------------------------------------------------------------------------------------------------
--------------------------------------------------------------------------------------------------------------------------------------------------------------------------------------------------------
--------------------------------------------------------------------------------------------------------------------------------------------------------------------------------------------------------
----------------------------------------------SS-U--------------------------------------------------------------2-S2------------------------------------------------------------------------------------
---------------222S--------------k-----------------------------------------#--#------------------------SCSCSCS------------------------------------------------------------------------------------------
---------------------------%%%%%%%%%------------|-------#--#--------------##--##---------------------------------%---------%%--%%%%---%%----------------------------------------------------------------
---------------------------|||||||||%%%---%%%---rg----%%%--%%%%%%%--%%%%%%%%--%%%%-----------%%---%%-------------|---r-%%%%||--||||---||----------------------------------------------------------------
--------------------%%---%%||||||||||||---|||%%%%%%%%%|||--|||||||--||||||||--||||%%%%---%%%%||---||----y--r---%%%%%%%%||||||--||||---||----------------------------------------------------------------
XXXXXXXXXXXXXXXXXXXX||---||||||||||||||---|||||||||||||||--|||||||--||||||||--||||||||---||||||---||XXXXXXXXXXX||||||||||||||--||||---||XXXXXXXXFXXXXXXXXXXXXXXXXXXXXXXXXXXXXXXXXXXXXXXXXXXXXXXXXXXXXXXX
