HEIGHT=16;WIDTH=201;THEME=0;OVERRIDE=false
--------------------------------------------------------------------------------------------------------------------------------------------------------------------------------------------------------
--------------------------------------------------------------------------------------------------------------------------------------------------------------------------------------------------------
--------------------------------------------------------------------------------------------------------------------------------------------------------------------------------------------------------
--------------------------------------------------------------------------------------------------------------------------------------------------------------------------------------------------------
--------------------------------------------------------------------------------------------------------------------------------------------------------------------------------------------------------
--------------------------------------------------------------------------------------------------------------------------------------------------------------------------------------------------------
--------------------------------------------------------------------------------------------------------------------------------------------------------------------------------------------------------
--------------------------------------------------------------------------------------------------------------------------------------------------------------------------------------------------------
--------------------------------------------------------------------------------------------------------------------------------------------------------------------------------------------------------
-------------SSSS2SS--------------------------------------------------------------------------------------------------------------------SCU-CS----------------------------------------------------------
----------------------------------------------------------#---#-------------#---#-----------------------------------------------------------------------------------------------------------------------
-------------------------------------%%%%%%--------------##---##-----------##---##---------------------------------------------------------%------------------------------------------------------------
-------------------------------------||||||-------------###---###--%%--%%%%%%---%%%%----------------------------%%%%%%%%%%%----------------|------------------------------------------------------------
------------%%%%%%%%%%%--------------||||||----%%---%%%%%%%---%%%%%||--||||||---||||---------------------%%%%%%%|||||||||||---#--#---%%%%%%%%%%---------------------------------------------------------
%%%%%%%%%%%%|||||||||||%%%--%%%---g--||||||-y--||---|||||||---|||||||--||||||---||||---------------------||||||||||||||||||--##--##--||||||||||---------------------------------------------------------
||||||||||||||||||||||||||--|||XXXXXXXXXXXXXXXX||---|||||||---|||||||--||||||---||||XXXXX--XXXXXXXX---XXX||||||||||||||||||XXXX--XXXX||||||||||XXXXXXXXFXXXXXXXXXXXXXXXXXXXXXXXXXXXXXXXXXXXXXXXXXXXXXXXX
