HEIGHT=16;WIDTH=201;THEME=0;OVERRIDE=false
--------------------------------------------------------------------------------------------------------------------------------------------------------------------------------------------------------
--------------------------------------------------------------------------------------------------------------------------------------------------------------------------------------------------------
--------------------------------------------------------------------------------------------------------------------------------------------------------------------------------------------------------
--------------------------------------------------------------------------------------------------------------------------------------------------------------------------------------------------------
--------------------------------------------------------------------------------------------------------------------------------------------------------------------------------------------------------
--------------------------------------------------------------------------------------------------------------------------------------------------------------------------------------------------------
--------------------------------------------------------------------------------------------------------------------------------------------------------------------------------------------------------
--------------------------------------------------------------------------------------------------------------------------------------------------------------------------------------------------------
--------------------------------------------------------------------------------------------------------------------------------------------------------------------------------------------------------
------------------------g-k-----------------------------------------------------SS2----UUU22------------------------------------------------------------------------------------------------------------
------------------------%%%%----------------------------------------------------------------------------------------------------------------------------------------------------------------------------
------------------------||||----------------------------------------------------------------------------------------------------------------------------------------------------------------------------
%%%%%%%%%%--------------||||---y--------------%%%%---%%%%%%%%----------------------Y--------------------------%%%---%%%---%%%%--%%%%--------------------------------------------------------------------
||||||||||%%%%%--%%%%%%%%%%%%%%%%%%%%%%---%%%%||||---||||||||%%%--%%%---------%%%%%%%%%%%%%%%%----------------|||---|||---||||--||||------%%%%%%%%F%%%%%%%%%%%%%%%%%%%%%%%%%%%%%%%%%%%%%%%%%%%%%%%%%%%%%
|||||||||||||||--||||||||||||||||||||||---||||||||---|||||||||||--|||%%%---%%%||||||||||||||||--#---#--%%---%%|||---|||---||||--||||%%--%%||||||||%|||||||||||||||||||||||||||||||||||||||||||||||||||||
|||||||||||||||--||||||||||||||||||||||---||||||||---|||||||||||--||||||---|||||||||||||||||||XXX---XXX||---|||||---|||XXX||||--||||||--||||||||||||||||||||||||||||||||||||||||||||||||||||||||||||||||
