HEIGHT=16;WIDTH=201;THEME=0;OVERRIDE=false
--------------------------------------------------------------------------------------------------------------------------------------------------------------------------------------------------------
--------------------------------------------------------------------------------------------------------------------------------------------------------------------------------------------------------
--------------------------------------------------------------------------------------------------------------------------------------------------------------------------------------------------------
--------------------------------------------------------------------------------------------------------------------------------------------------------------------------------------------------------
--------------------------------------------------------------------------------------------------------------------------------------------------------------------------------------------------------
--------------------------------------------------------------------------------------------------------------------------------------------------------------------------------------------------------
--------------------------------------------------------------------------------------------------------------------------------------------------------------------------------------------------------
-----------------------------2CCS-----------------------------------------------------------------------------------------------------------------------------------------------------------------------
---------------------------------------------%%%%%------------------------------------------------------------------------------------------------------------------------------------------------------
---------------------------------------------|||||------------------------------------------------------------------------------------------------------------------------------------------------------
---------------------------------------------|||||------------------------------------------------#--#--------------------------------------------------------------------------------------------------
-----------------------------%%%%%%----------|||||----%%%%---------------------------------------##--##---------------------------------#--#------------------------------------------------------------
%%%%%%%%%%---%%%%%---%%%%%---||||||----------|||||----||||--------------------------------------###--###-------------------------------##--##---%%%%%%%%F%%%%%%%%%%%%%%%%%%%%%%%%%%%%%%%%%%%%%%%%%%%%%%%
||||||||||---|||||---|||||%%%%%%%%%%%%%%%%%%-g||||----||||-y--%%---%%--%%%%%---%%%%%----------%%%%%--%%%%%---------%%%%%--%%%%%-------###--###--||||||||%|||||||||||||||||||||||||||||||||||||||||||||||
||||||||||---|||||---|||||||||||||||||||||||%%%%%%%%%%%%%%%%%%||---||%%|||||---|||||----------|||||--|||||---------|||||--|||||-----%%%%%--%%%%%||||||||||||||||||||||||||||||||||||||||||||||||||||||||
||||||||||XXX|||||---|||||||||||||||||||||||||||||||||||||||||||---|||||||||---|||||XXXX--XXXX|||||--|||||XXX---XXX|||||--|||||XXXXX|||||--|||||||||||||||||||||||||||||||||||||||||||||||||||||||||||||
