HEIGHT=16;WIDTH=201;THEME=0;OVERRIDE=false
--------------------------------------------------------------------------------------------------------------------------------------------------------------------------------------------------------
--------------------------------------------------------------------------------------------------------------------------------------------------------------------------------------------------------
--------------------------------------------------------------------------------------------------------------------------------------------------------------------------------------------------------
--------------------------------------------------------------------------------------------------------------------------------------------------------------------------------------------------------
--------------------------------------------------------------------------------------------------------------------------------------------------------------------------------------------------------
--------------------------------------------------------------------------------------------------------------------------------------------------------------------------------------------------------
--------------------------------------------------------------------------------------------------------------------------------------------------------------------------------------------------------
--------------------------------------------------------------------------------------------------------------------------------------------------------------------------------------------------------
--------------------------------------------------------------------------------------------------------------------------------------------------------------------------------------------------------
-----------------------------------------------------------------------------------------------------------#--#-----------------------------------------------------------------------------------------
----------------------------------------------------------------------------------------------------------##--##----------------------------------------------------------------------------------------
-----------------------Y-------------------------------------------------------------------------CSSC----###--###---------------------------------------------------------------------------------------
-----------------------%%%%-----------%%%%%--%%%%%-------%%%%---%%%%-----------------------------------%%%%%--%%%%%-------------------------%%%%%%%%F%%%%%%%%%%%%%%%%%%%%%%%%%%%%%%%%%%%%%%%%%%%%%%%%%%%
%%%%%%%%%%%------------g|||-----------|||||--|||||-------||||---||||%%%--------------------------------|||||--|||||-------------------------||||||||%|||||||||||||||||||||||||||||||||||||||||||||||||||
|||||||||||-----------%%%%%%%%%%%%%%%%|||||--|||||%%%%%%%||||---|||||||%%---%%---------%%%%%%-y--------|||||--|||||-----------------------r-||||||||||||||||||||||||||||||||||||||||||||||||||||||||||||
|||||||||||XXXX---XXXX|||||||||||||||||||||--||||||||||||||||---|||||||||---||XXX---XXX||||||XXXXXXXXXX|||||--|||||XX--XXXXXXX---XXXXXXXXXXX||||||||||||||||||||||||||||||||||||||||||||||||||||||||||||
