HEIGHT=16;WIDTH=201;THEME=0;OVERRIDE=false
--------------------------------------------------------------------------------------------------------------------------------------------------------------------------------------------------------
--------------------------------------------------------------------------------------------------------------------------------------------------------------------------------------------------------
--------------------------------------------------------------------------------------------------------------------------------------------------------------------------------------------------------
--------------------------------------------------------------------------------------------------------------------------------------------------------------------------------------------------------
--------------------------------------------------------------------------------------------------------------------------------------------------------------------------------------------------------
--------------------------------------------------------------------------------------------------------------------------------------------------------------------------------------------------------
--------------------------------------------------------------------------------------------------------------------------------------------------------------------------------------------------------
---------------------------------------r----------------------------------------------------------------------------------------------------------------------------------------------------------------
-------------------------------------%%%%%------------------------2SSCSU--------------------------------------------------------------------------------------------------------------------------------
-------------------------------------|||||--------------------------------------------------------------------------------------------------------------------------------------------------------------
-------------------------------------|||||--------------------------------------------------------------SU2SSS-S2-----------USCSS-----------------------------------------------------------------------
-------------------------------------|||||--------------------------------------------------------------------------------------------------------------------------------------------------------------
----------------------------------%%%%%%%%%%%%%%%%%%%%%%---%%%%%%%%%%%%%%%%%%%%%%%%%--%%----------------------%-------------------%%%---#--#---%%%%%%%%F%%%%%%%%%%%%%%%%%%%%%%%%%%%%%%%%%%%%%%%%%%%%%%%%
-------------%%%%%--%%%%%---------||||||||||||||||||||||---|||||||||||||||||||||||||--||--------%%---%%-------|-------------------|||--##--##--||||||||%||||||||||||||||||||||||||||||||||||||||||||||||
%%%%%%%%%%%%%|||||--|||||%%%---%%%||||||||||||||||||||||---|||||||||||||||||||||||||--||%%%--%%%||---||%%%%%%%%%%%%%%%%%%%%%%%%%%%|||%%%%--%%%%|||||||||||||||||||||||||||||||||||||||||||||||||||||||||
||||||||||||||||||--||||||||---|||||||||||||||||||||||||---|||||||||||||||||||||||||--|||||--|||||---||||||||||||||||||||||||||||||||||||--|||||||||||||||||||||||||||||||||||||||||||||||||||||||||||||
