HEIGHT=16;WIDTH=201;THEME=0;OVERRIDE=false
--------------------------------------------------------------------------------------------------------------------------------------------------------------------------------------------------------
--------------------------------------------------------------------------------------------------------------------------------------------------------------------------------------------------------
--------------------------------------------------------------------------------------------------------------------------------------------------------------------------------------------------------
--------------------------------------------------------------------------------------------------------------------------------------------------------------------------------------------------------
--------------------------------------------------------------------------------------------------------------------------------------------------------------------------------------------------------
--------------------------------------------------------------------------------------------------------------------------------------------------------------------------------------------------------
--------------------------------------------------------------------------------------------------------------------------------------------------------------------------------------------------------
--------------------------------------------------------------------------------------------------------------------------------------------------------------------------------------------------------
----------------U2S--------------------------------------------------------------------------------------------------------SC2CSCS----------------------------------------------------------------------
--------------------------------------------------------------------------------------------------------------------------------------------------------------------------------------------------------
--------------------------------------------------------------------------------------------------------------------------------------------------------------------------------------------------------
------------------------------------------------------------------------------------------------------------------#--#--------y-------------------------------------------------------------------------
------------%%%%%%%%%---------------------------------------------------------------%%%%%--%%%%%--------%%%%%%%--##--##--%%%%%%%%%%%--------------------------------------------------------------------
------------|||||||||%%%%%---%%%%%--------------------%%--%%---------%%--%%---------|||||--|||||--------|||||||%%%%--%%%%|||||||||||--------------------------------------------------------------------
------------||||||||||||||---|||||%%---%%-------------||--||%%%---%%%||--||--#---#--|||||--|||||%%%-----|||||||||||--|||||||||||||||--#--#--------------------------------------------------------------
XXXXXXXXXXXX||||||||||||||---|||||||---||XXXXXXXX--XXX||--|||||---|||||--||XXX---XXX|||||--||||||||XXXXX|||||||||||--|||||||||||||||XXX--XXXXXXXXXXXFXXXXXXXXXXXXXXXXXXXXXXXXXXXXXXXXXXXXXXXXXXXXXXXXXXX
