HEIGHT=16;WIDTH=201;THEME=0;OVERRIDE=false
--------------------------------------------------------------------------------------------------------------------------------------------------------------------------------------------------------
--------------------------------------------------------------------------------------------------------------------------------------------------------------------------------------------------------
--------------------------------------------------------------------------------------------------------------------------------------------------------------------------------------------------------
--------------------------------------------------------------------------------------------------------------------------------------------------------------------------------------------------------
------------------------------------------Gk------------------------------------------------------------------------------------------------------------------------------------------------------------
----------------------------------------%%%%------------------------------------------------------------------------------------------------------------------------------------------------------------
----------------------------------------||||------------------------------------------------------------------------------------------------------------------------------------------------------------
----------------------------------------||||------------------------------------------------------------------------------------------------------------------------------------------------------------
----------------------------------------||||-----k------------------------------------------------------------------------------------------------------------------------------------------------------
----------------tt----------------------||||----%%%%----------------------------------------------------------------------------------------------------------------------------------------------------
----------------tt----------------------||||----||||----------------------------rg-------SC2S2------CU2S------------------------------------------------------------------------------------------------
----------------tt---------------yy-----||||----||||----------------------------%%%%--------------------------------------------------------------------------------------------------------------------
------------%%%%%%%%%---#---#---%%%%%%--|k||----||||----------------------------||||--------------------------------------------------------------------------------------------------------------------
------------|||||||||--##---##--||||||%%%%%%%%%%%%%%%%%%--%%%%%%%---%%%%%-------||||---------------------r------------------%%--%%----------------------------------------------------------------------
%%%%%%%%%%%%|||||||||%%%%---%%%%||||||||||||||||||||||||--|||||||---|||||---%%%%%%%%%%%%%%%%%%%%%%%%%%%%%%%%%%%--%%%%%%---%%||--||-------%%%%%%%%F%%%%%%%%%%%%%%%%%%%%%%%%%%%%%%%%%%%%%%%%%%%%%%%%%%%%%%
|||||||||||||||||||||||||---||||||||||||||||||||||||||||--|||||||---|||||XXX|||||||||||||||||||||||||||||||||||--||||||---||||--||XX---XX||||||||X||||||||||||||||||||||||||||||||||||||||||||||||||||||
