HEIGHT=16;WIDTH=201;THEME=0;OVERRIDE=false
--------------------------------------------------------------------------------------------------------------------------------------------------------------------------------------------------------
--------------------------------------------------------------------------------------------------------------------------------------------------------------------------------------------------------
--------------------------------------------------------------------------------------------------------------------------------------------------------------------------------------------------------
--------------------------------------------------------------------------------------------------------------------------------------------------------------------------------------------------------
--------------------------------------------------------------------------------------------------------------------------------------------------------------------------------------------------------
--------------------------------------------------------------------------------------------------------------------------------------------------------------------------------------------------------
--------------------------------------------------------------------------------------------------------------------------------------------------------------------------------------------------------
--------------------------------------------------------------------------------------------------------------------------------------------------------------------------------------------------------
--------------------------------------------------------------------------------------------------------------------------------------------------------------------------------------------------------
--------------------------------------------------------------------------------------------------------------------------------------------------------------------------------------------------------
--------------------------------------------------------------------------------------------------------------------------------------------------------------------------------------------------------
----------------------------------U22CSCS---------------------------------------------------------------------------------#--#--------------------------------------------------------------------------
----------%%%%--%%%%%%%%---%%%%-----------%%%--%%%-------%%%%---%%%%%%%%%%---%%------------------------tt----------------##--##--%%%--%%%---------------------------------------------------------------
%%%%%%%%%%||||--||||||||---||||-----------|||--|||-------||||---||||||||||---||--------------%%%--Tt---tt----%%--------%%%%--%%%%|||--|||%%%%%%%%F%%%%%%%%%%%%%%%%%%%%%%%%%%%%%%%%%%%%%%%%%%%%%%%%%%%%%%
||||||||||||||--||||||||---||||---y-------|||--|||%%---%%||||---||||||||||---||%%%--%%%%%%%%%|||--tt---tt----||%%%%%%%%||||--|||||||--|||||||||||%||||||||||||||||||||||||||||||||||||||||||||||||||||||
||||||||||||||--||||||||---||||XXXXXXXXXXX|||--|||||---||||||---||||||||||---|||||--||||||||||||XXXXXXXXXXXXX||||||||||||||--|||||||--||||||||||||||||||||||||||||||||||||||||||||||||||||||||||||||||||
