HEIGHT=16;WIDTH=201;THEME=0;OVERRIDE=false
--------------------------------------------------------------------------------------------------------------------------------------------------------------------------------------------------------
--------------------------------------------------------------------------------------------------------------------------------------------------------------------------------------------------------
--------------------------------------------------------------------------------------------------------------------------------------------------------------------------------------------------------
--------------------------------------------------------------------------------------------------------------------------------------------------------------------------------------------------------
--------------------------------------------------------------------------------------------------------------------------------------------------------------------------------------------------------
----------------------------------------------------%%%-------------------------------------------------------------------------------------------------------------------------------------------------
----------------------------------------------------|||-------------------------------------------------------------------------------------------------------------------------------------------------
----------------------------------------------------|||-------------------------------------------------------------------------------------------------------------------------------------------------
---------------%%%%---------------------------------|||------------------------------------------------------------------------------k------------------------------------------------------------------
---------------||||----------------------------%%%%%%||-------------------------SCSU------------------------------------------------%%%-----------------------------------------------------------------
---------------||||----------------------------|||k||g|g--------------------------------------------------------SS------------------|||-----------------------------------------------------------------
-------------ry||||-------SSU--S------r--------|||%%%%%%%---------------------------------------------------------------------------|||-----------------------------------------------------------------
-----------%%%%%|||-------------------%%%%-----||||||||||-------%%---%%--#--#-----------------------#---#---------%-----------------|||-----------------------------------------------------------------
%%%%%%%%%%-||||||||----------||-------||||-r---||||||||||-------||---||%%%--%%%%%%%%%%%------------##---##--------|-----------%%%%%%%%%%%%%%%%%%--------------------------------------------------------
||||||||||-||g|||||------g---rg--%%%%%%%%%%%%%-||||||||||y------||---|||||--|||||||||||-----------###---###--%%%%%%%%---------||||||||||||||||||--------------------------------------------------------
||||||||||XXXXXXXXXXXXXXXXXXXXXXX|||||||||||||XXXXXXXXXXXXXXXXXX||---|||||--|||||||||||XXX---XXXXXXXX---XXXXX||||||||XXX---XXX||||||||||||||||||XXXXXXXXFXXXXXXXXXXXXXXXXXXXXXXXXXXXXXXXXXXXXXXXXXXXXXXX
