HEIGHT=16;WIDTH=201;THEME=0;OVERRIDE=false
--------------------------------------------------------------------------------------------------------------------------------------------------------------------------------------------------------
--------------------------------------------------------------------------------------------------------------------------------------------------------------------------------------------------------
-----------------------------------------------------------------------------------------------------------------%%%------------------------------------------------------------------------------------
-----------------------------------------------------------------------------------------------------------------|||------------------------------------------------------------------------------------
-----------------------------------------------------------------------------------------------------------------|||------------------------------------------------------------------------------------
-----------------------------------------------------------------------------------------------------------------|||------------------------------------------------------------------------------------
--------------------------------------------------------------------------------------------------------%%%%%%%--|||------------------------------------------------------------------------------------
--------------------------------------------------------------------------------------------------------|||||||--|||---------------------%%%%%----------------------------------------------------------
--------------------------------------------------------------------------------------------------------|||||||--|||---------------------|||||----------------------------------------------------------
--------------------tt---------------------------CCSUC--------------------------------------------------|||||||--|||---------------------y||||----------------------------------------------------------
--------------------tt---------#--#---------------------------------------------------------------------|%%%|||--|||----------------%%%%%%||||----------------------------------------------------------
--------------------tt--------##--##--------------------------------------------------------------------|||||||--|||----------------||||||||||----------------------------------------------------------
%%%%%%%%%%%%%--%%%%%%%%%%%%--###--###---------------r--------------%%%%%---%%%%%------------------------|||||||--|||---------------%%%%%%%%%%%%%--------------------------------------------------------
|||||||||||||--||||||||||||%%%%%--%%%%%%%--%%%%%%%%%%%%%-----------|||||---|||||%%%%%--%%%%%%%%%--%%%%-y||||rr|--|r|----%%%%---%%%%|||||||||||||--------------------------------------------------------
|||||||||||||--|||||||||||||||||--|||||||--|||||||||||||%%%%---%%%%|||||---||||||||||--|||||||||--||||%%%%%%%%%%%%%%%%%%||||---|||||||||||||||||--------------------------------------------------------
|||||||||||||--|||||||||||||||||--|||||||--|||||||||||||||||---|||||||||---||||||||||--|||||||||--||||||||||||||||||||||||||---|||||||||||||||||XXXXXXXXFXXXXXXXXXXXXXXXXXXXXXXXXXXXXXXXXXXXXXXXXXXXXXXX
