HEIGHT=16;WIDTH=201;THEME=0;OVERRIDE=false
--------------------------------------------------------------------------------------------------------------------------------------------------------------------------------------------------------
--------------------------------------------------------------------------------------------------------------------------------------------------------------------------------------------------------
--------------------------------------------------------------------------------------------------------------------------------------------------------------------------------------------------------
--------------------------------------------------------------------------------------------------------------------------------------------------------------------------------------------------------
--------------------------------------------------------------------------------------------------------------------------------------------------------------------------------------------------------
----------------k---------------------------------------------------------------------------------------------------------------------------------------------------------------------------------------
----------------%%%-------------------------------------------------------------------------------------------------------------------------------------------------------------------------------------
----------------|||-------------------------------------------------------------------------------------------------------------------------------------------------------------------------------------
----------------|||-------------------------------------------------------------------------------------------------------------------------------------------------------------------------------------
----------------|%%%%-----------------------------------------------------------------------------------------------------------------------------------------------------------------------------------
----------------|||||-------------------------------------------------------------------------------------------#---#-----------------------------------------------------------------------------------
----------------|||||--------------------------------------#---#-----------------------------------------------##---##------------------#--#------------------------------------------------------------
--------------%%%%%%%%%%----------------------------------##---##-------#--#--------%%---%%--------#--#------%%%%---%%%%---------------##--##--%%%%%%%%F%%%%%%%%%%%%%%%%%%%%%%%%%%%%%%%%%%%%%%%%%%%%%%%%
--------------||||||||||%%%---%%%----------------%%%%%%--###---###-----##--##-------||---||------%%%--%%%--%%||||---||||-------------%%%%--%%%%||||||||%||||||||||||||||||||||||||||||||||||||||||||||||
----------%%%%|||||||||||||---|||%%%%--%%%%------||||||%%%%%---%%%%%--###--###--%%%%||---||------|||--|||%%||||||---||||%%--%%-------||||--|||||||||||||||||||||||||||||||||||||||||||||||||||||||||||||
XXXXXXXXXX|||||||||||||||||---|||||||--||||XX--XX|||||||||||---|||||XXXXX--XXXXX||||||---||XX--XX|||--|||||||||||---||||||--||XX---XX||||--|||||||||||||||||||||||||||||||||||||||||||||||||||||||||||||
