HEIGHT=16;WIDTH=201;THEME=0;OVERRIDE=false
--------------------------------------------------------------------------------------------------------------------------------------------------------------------------------------------------------
--------------------------------------------------------------------------------------------------------------------------------------------------------------------------------------------------------
--------------------------------------------------------------------------------------------------------------------------------------------------------------------------------------------------------
--------------------------------------------------------------------------------------------------------------------------------------------------------------------------------------------------------
--------------------------------------------------------------------------------------------------------------------------------------------------------------------------------------------------------
--------------------------------------------------------------------------------------------------------------------------------------------------------------------------------------------------------
--------------------------------------------------------------------------------------------------------------------------------------------------------------------------------------------------------
--------------------------------------------------------------------------------------------------------------------------------------------------------------------------------------------------------
--------------------------------SCSS--------------------------------------------------------------------------------------------------------------------------------------------------------------------
--------------------------------------------------------------------------------------------------------------------------------------------------------------------------------------------------------
-------------------------------------------#--#---------------------------------------------------------------------------------------------------------------------------------------------------------
------------------------------------------##--##-------------------------------------------------------------------------------------#---#--------------------------------------------------------------
-------------%%%%---%%%%------%%%%%%%%%--###--###---------------------%%---%%----------------%%%--%%%-------------------------------##---##-------------------------------------------------------------
%%%%%%%%%%%%%||||---||||%%--%%|||||||||%%%%%--%%%%%-------------%%--%%||---||---------%%---%%|||--|||%%%%---%%%%%%%---%%%----------###---###------------------------------------------------------------
|||||||||||||||||---||||||--||||||||||||||||--|||||%%%%%%%--%%%%||--||||---||---------||---|||||--|||||||---|||||||---|||%%%--%%%%%%%%---%%%%%%%%%%%%%F%%%%%%%%%%%%%%%%%%%%%%%%%%%%%%%%%%%%%%%%%%%%%%%%%
|||||||||||||||||---||||||--||||||||||||||||--||||||||||||--||||||--||||---||XXX---XXX||---|||||--|||||||---|||||||---||||||--||||||||---|||||||||||||X|||||||||||||||||||||||||||||||||||||||||||||||||
