HEIGHT=16;WIDTH=201;THEME=0;OVERRIDE=false
--------------------------------------------------------------------------------------------------------------------------------------------------------------------------------------------------------
--------------------------------------------------------------------------------------------------------------------------------------------------------------------------------------------------------
--------------------------------------------------------------------------------------------------------------------------------------------------------------------------------------------------------
--------------------------------------------------------------------------------------------------------------------------------------------------------------------------------------------------------
--------------------------------------------------------------------------------------------------------------------------------------------------------------------------------------------------------
--------------------------------------------------------------------------------------------------------------------------------------------------------------------------------------------------------
--------------------------------------------------------------------------------------------------------------------------------------------------------------------------------------------------------
--------------------------------------------------------------------------------------------------------------------------------------------------------------------------------------------------------
------------------------------------------------------------%%%%------------------------------------------------------------------S2SCCCS---------------------------------------------------------------
------------------------------------------------------------||||----------------------------------------------------------------------------------------------------------------------------------------
------------------------------------------------------------||||----------------------------------------------------------------------------------------------------------------------------------------
------------------------------------------------------------||||g-------------------------------------------------------------------------r-------------------------------------------------------------
-----------------%%%%%%%%%%%%%--%%--------------------------|%%%%%----------%%--%%------%%--%%-----------------------------------%%%%%%%%%%%%%%%%%%%F%%%%%%%%%%%%%%%%%%%%%%%%%%%%%%%%%%%%%%%%%%%%%%%%%%%
--------------%%%|||||||||||||--||--------------------------||||||-r--------||--||------||--||-----------------------------------|||||||||||||||||||%|||||||||||||||||||||||||||||||||||||||||||||||||||
--------------||||||||||||||||--||---------------------%%%%%%%%%%%%%%-------||--||%%--%%||--||%%%%%%%%%%%%%--#---#--%%%%%---%%%%%|||||||||||||||||||||||||||||||||||||||||||||||||||||||||||||||||||||||
XXXXXXXXXXXXXX||||||||||||||||--||XXXXXXXXX--XXXXX--XXX||||||||||||||XX---XX||--||||--||||--|||||||||||||||XXX---XXX|||||---||||||||||||||||||||||||||||||||||||||||||||||||||||||||||||||||||||||||||||
