HEIGHT=16;WIDTH=201;THEME=0;OVERRIDE=false
--------------------------------------------------------------------------------------------------------------------------------------------------------------------------------------------------------
--------------------------------------------------------------------------------------------------------------------------------------------------------------------------------------------------------
--------------------------------------------------------------------------------------------------------------------------------------------------------------------------------------------------------
--------------------------------------------------------------------------------------------------------------------------------------------------------------------------------------------------------
----------------------------------------------------------------------------%%%%%%%---------------------------------------------------------------------------------------------------------------------
----------------------------------------------------------------------------|||||||---------------------------------------------------------------------------------------------------------------------
----------------------------------------------------------------------------|||||||---------------------------------------------------------------------------------------------------------------------
---------------------------------------------------------------------------y|||||||---------------------------------------------------------------------------------------------------------------------
--------------------------------------------------------------------------%%%%%%|||---------------------------------------------------------------------------------------------------------------------
--------------------------------------------------------------------------|||||||||---------------------------------------------------------------------------------------------------------------------
---------------------------------------------SSSS-------------------------|||||||||---------------------------------------------------------------------------------------------------------------------
-----------------------------------------------------%%%------------------GYy|||k||--g-g-------------------UCU------------------------------------------------------------------------------------------
---------------tt----tt---%%%---%%%%%---%%-----------|||----------------%%%%%%%%%%%%%%%%%%%%---%%%---------------------------%%%%-------------------%%%%%%%%F%%%%%%%%%%%%%%%%%%%%%%%%%%%%%%%%%%%%%%%%%%%
---------------tt----tt---|||---|||||---||-y---------|k|g-y-------------||||||||||||||||||||---|||---------------%%--%%------||||--%%%%-------------||||||||%|||||||||||||||||||||||||||||||||||||||||||
%%%%%%%%%%%%%%%%%%%%%%%%%%|||---|||||---||%%%%%%%%%%%%%%%%%%%-----------||||||||||||||||||||---|||---g---r-------||--||%%%%%%%%%%%%||||-------------||||||||||||||||||||||||||||||||||||||||||||||||||||
|||||||||||||||||||||||||||||---|||||---|||||||||||||||||||||XXXX---XXXX||||||||||||||||||||---|||XXXXXXXXXXXXXXX||--||||||||||||||||||XXXXX---XXXXX||||||||||||||||||||||||||||||||||||||||||||||||||||
