HEIGHT=16;WIDTH=201;THEME=0;OVERRIDE=false
--------------------------------------------------------------------------------------------------------------------------------------------------------------------------------------------------------
--------------------------------------------------------------------------------------------------------------------------------------------------------------------------------------------------------
--------------------------------------------------------------------------------------------------------------------------------------------------------------------------------------------------------
--------------------------------------------------------------------------------------------------------------------------------------------------------------------------------------------------------
--------------------------------------------------------------------------------------------------------------------------------------------------------------------------------------------------------
--------------------------------------------------------------------------------------------------------------------------------------------------------------------------------------------------------
--------------------------------------------------------------------------------------------------------------------------------------------------------------------------------------------------------
--------------------------------------------------------------------------------------------------------------------------------------------------------------------------------------------------------
--------------------------------------------------------------------------------------------------------------------------------------------------------------------------------------------------------
--------------------------------------------------------------------------------------------------------------------------------------------------------------------------------------------------------
--------------------------------------------------------------------------------------------------------------------------#--#--------------------------------------------------------------------------
-------------------------------------------------------------------------#--#--------------------------------------------##--##-------------------------------------------------------------------------
------------------------------tt----%%%%%--%%%%%----------%%---%%%%%%---##--##---%%--%%---------------------------------###--###------------%%%%%%%%F%%%%%%%%%%%%%%%%%%%%%%%%%%%%%%%%%%%%%%%%%%%%%%%%%%%
------------------------------tt----|||||--|||||----------||---||||||--###--###--||--||------------%%--%%-------------%%%%%--%%%%%----------||||||||%|||||||||||||||||||||||||||||||||||||||||||||||||||
----------%%--%%%%%%%%--%%%---tt----|||||--|||||%%%%--%%%%||---||||||%%%%%--%%%%%||--||%%%%%--%%%%%||--||%%%%%---%%%%%|||||--|||||----------||||||||||||||||||||||||||||||||||||||||||||||||||||||||||||
XXXXXXXXXX||--||||||||--|||XXXXXXXXX|||||--|||||||||--||||||---|||||||||||--|||||||--|||||||--|||||||--|||||||---||||||||||--|||||XXXX--XXXX||||||||||||||||||||||||||||||||||||||||||||||||||||||||||||
