HEIGHT=16;WIDTH=201;THEME=0;OVERRIDE=false
--------------------------------------------------------------------------------------------------------------------------------------------------------------------------------------------------------
--------------------------------------------------------------------------------------------------------------------------------------------------------------------------------------------------------
--------------------------------------------------------------------------------------------------------------------------------------------------------------------------------------------------------
--------------------------------------------------------------------------------------------------------------------------------------------------------------------------------------------------------
--------------------------------------------------------------------------------------------------------------------------------------------------------------------------------------------------------
--------------------------------------------------------------------------------------------------------------------------------------------------------------------------------------------------------
--------------------------------------------------------------------------------------------------------------------------------------------------------------------------------------------------------
--------------------------------------------------------------------------------------------------------------------------------------------------------------------------------------------------------
--------------------------------------------------------------------------------------------------------------------------------------------------------------------------------------------------------
---------------------------------------------------------------------------------------------------------------------------------------#--#-------------------------------------------------------------
-----------------------------------------------------------------------------------------------------------------S2-SS----------------##--##------------------------------------------------------------
-------------------------------------------------------------------------------------------------------y---g-------------------------###--###-----------------------------------------------------------
---------------------------------r-r-----------------------------------------------#---#------------%%%%%%%%%------|---------------%%%%%--%%%%%%%%%%%%%F%%%%%%%%%%%%%%%%%%%%%%%%%%%%%%%%%%%%%%%%%%%%%%%%
%%%%%%%%%%%%%-----------------%%%%%%%---------------------------%%%--%%%----------##---##-------%%%%|||||||||--g--yy---------------|||||--|||||||||||||%||||||||||||||||||||||||||||||||||||||||||||||||
|||||||||||||%%%--%%%---------|||||||-------------%%%--%%%------|||--|||--------%%%%---%%%%%%%%%|||||||||||||%%%%%%%%%%%%%%%---%%%%|||||--||||||||||||||||||||||||||||||||||||||||||||||||||||||||||||||
||||||||||||||||--|||XXX---XXX|||||||XXXXX---XXXXX|||--|||XX--XX|||--|||XXX--XXX||||---|||||||||||||||||||||||||||||||||||||---|||||||||--||||||||||||||||||||||||||||||||||||||||||||||||||||||||||||||
