HEIGHT=16;WIDTH=201;THEME=0;OVERRIDE=false
--------------------------------------------------------------------------------------------------------------------------------------------------------------------------------------------------------
--------------------------------------------------------------------------------------------------------------------------------------------------------------------------------------------------------
--------------------------------------------------------------------------------------------------------------------------------------------------------------------------------------------------------
--------------------------------------------------------------------------------------------------------------------------------------------------------------------------------------------------------
--------------------------------------------------------------------------------------------------------------------------------------------------------------------------------------------------------
--------------------------------------------------------------------------------------------------------------------------------------------------------------------------------------------------------
--------------------------------------------------------------------------------------------------------------------------------------%%%---------------------------------------------------------------
--------------------------------------------------------------------------------------------------------------------------------------|||---------------------------------------------------------------
----------------------------------------------------------------------------------K-------------------------------------------------%%%||---------------------------------------------------------------
---------------------------------------------------------------------------------%%%------------------------------------------------|||||---------------------------------------------------------------
-----------------------------------------------------------------SSSSUS----------|||------------------------------------------------|||||---------------------------------------------------------------
-------------------------------------#---#---------------22SS2-------------------|||------------------------------------------------K||||---------------------------------------------------------------
-----------------------------------%%%---%%%-------------------------------------|||-----y--------------------------Tt-------------%%%%%%%%%%%----------------------------------------------------------
%%%%%%%%%%%%%-------------%%---%%--|||---|||-----------------------------------%%%%%%%%%%%%%%%%%%------%%%---%%%----tt--%%%%---%%%%|||||||||||----------------------------------------------------------
|||||||||||||%%%%---%%%%%%||---||--|||---|||-------------------%%%%%%%%%%%%%%%%||||||||||||||||||%%--%%|||---|||%%%%%%%%||||---|||||||||||||||----------------------------------------------------------
|||||||||||||||||---||||||||---||XX|||---|||XXXX---XXXXXXXXXXXX||||||||||||||||||||||||||||||||||||--|||||---|||||||||||||||---|||||||||||||||XXXXXXXXFXXXXXXXXXXXXXXXXXXXXXXXXXXXXXXXXXXXXXXXXXXXXXXXXX
