HEIGHT=16;WIDTH=201;THEME=0;OVERRIDE=false
--------------------------------------------------------------------------------------------------------------------------------------------------------------------------------------------------------
--------------------------------------------------------------------------------------------------------------------------------------------------------------------------------------------------------
--------------------------------------------------------------------------------------------------------------------------------------------------------------------------------------------------------
--------------------------------------------------------------------------------------------------------------------------------------------------------------------------------------------------------
--------------------------------------------------------------------------------------------------------------------------------------------------------------------------------------------------------
--------------------------------------------------------------------------------------------------------------------------------------------------------------------------------------------------------
--------------------------------------------------------------------------------------------------------------------------------------------------------------------------------------------------------
--------------------------------------------------------------------------------------------------------------------------------------------------------------------------------------------------------
---------------------SS-U-------------------------------------------------------------------------------------------------------------------------------------------------------------------------------
-----------------------------------------------------------------------------------tt-------------------------------------------------------------------------------------------------------------------
-----------------------%---------r-------------------------------------------------tt-------------------------------------------------------------------------------------------------------------------
---------------------g-|------%%%%%%-----------------------------------------------tt-------------------------------------------------------------------------------------------------------------------
--------------------%%%%%%%---||||||----%%---%%--------------------------------%%%%%%%%%%%%---%%%%%-------------------r---------------%%%--%%%----------------------------------------------------------
%%%%%%%%%%%%%%---%%%|||||||---||||||----||---||------------------------#---#---||||||||||||---|||||---#---#------%%%%%%%%%%--%%%------|||--|||----------------------------------------------------------
||||||||||||||---||||||||||---|y||||----||---||-----------------------##---##--||||||||||||---|||||--##---##--%%%||||||||||--|||------|||--|||----------------------------------------------------------
||||||||||||||---||||||||||XXXXXXXXXXXXX||---||XX--XXXXXX--XXXXXXXXXXXXX---XXXX||||||||||||---|||||XXXX---XXXX|||||||||||||--|||XX--XX|||--|||XXXXXXXXFXXXXXXXXXXXXXXXXXXXXXXXXXXXXXXXXXXXXXXXXXXXXXXXXX
