HEIGHT=16;WIDTH=201;THEME=0;OVERRIDE=false
--------------------------------------------------------------------------------------------------------------------------------------------------------------------------------------------------------
--------------------------------------------------------------------------------------------------------------------------------------------------------------------------------------------------------
--------------------------------------------------------------------------------------------------------------------------------------------------------------------------------------------------------
--------------------------------------------------------------------------------------------------------------------------------------------------------------------------------------------------------
--------------------------------------------------------------------------------------------------------------------------------------------------------------------------------------------------------
--------------------------------------------------------------------------------------------------------------------------------------------------------------------------------------------------------
--------------------------------------------------------------------------------------------------------------------------------------------------------------------------------------------------------
--------------------------------------------------------------------------------------------------------------------------------------------------------------------------------------------------------
------------------------------------------------r--------------------------------C2-------------------------------------------CSS-----------------------------------------------------------------------
----------------------------------------------%%%-----------------------------------------------------#--#----------------------------------------------------------------------------------------------
----------------------------------------------|||---------#---#----------------%%--------------------##--##---------------------------------------------------------------------------------------------
----------------------------------------------|||-gg-----##---##---------------||-k-----------------###--###-----------------gkg-r----------------------------------------------------------------------
----------------#--#---------------------%%%%%%%%%%%%%%%%%%---%%%%------------%%%%%%%%%---%%------%%%%%--%%%%%---------------%%%%%----------------------------------------------------------------------
---------------##--##--------------------||||||||||||||||||---||||------------|||||||||---||------|||||--|||||---------------|||||----%%%%%---%%%%%-----------------------------------------------------
%%%%%%%%%%%%--###--###----------%%-------||||||||||||||||||---||||------------|||||||||---||------|||||--|||||---------------|||||----|||||---|||||%%%%%%%%F%%%%%%%%%%%%%%%%%%%%%%%%%%%%%%%%%%%%%%%%%%%%
||||||||||||XXXXX--XXXXXXXX--XXX||XX---XX||||||||||||||||||---||||XXXXX--XXXXX|||||||||---||XX--XX|||||--|||||XX--XXXXXXXXXXXXXXXXXXXX|||||---|||||||||||||X||||||||||||||||||||||||||||||||||||||||||||
