HEIGHT=16;WIDTH=201;THEME=0;OVERRIDE=false
--------------------------------------------------------------------------------------------------------------------------------------------------------------------------------------------------------
--------------------------------------------------------------------------------------------------------------------------------------------------------------------------------------------------------
--------------------------------------------------------------------------------------------------------------------------------------------------------------------------------------------------------
--------------------------------------------------------------------------------------------------------------------------------------------------------------------------------------------------------
--------------------------------------------------------------------------------------------------------------------------------------------------------------------------------------------------------
--------------------------------------------------------------------------------------------------------------------------------------------------------------------------------------------------------
--------------------------------------------------------------------------------------------------------------------------------------------------------------------------------------------------------
--------------------------------------------------------------------------------------------------------------------------------------------------------------------------------------------------------
--------------------------------------------------------------------------------------------------------------------------------------------------------------------------------------------------------
--------------------------------------------------------------------------------------------------------------------------------------------------------------------------------------------------------
--------------------------------------------------------------------#--#--------------------------------------------------------------------------------------------------------------------------------
-------------------------------------------------------------------##--##----------------g---------#---#------------------------------------------------------------------------------------------------
%%%%%%%%%%%------%%%%%--%%%%%%%--%%%%---%%%%%%%--%%%%%%%%%--%%%%--###--###-----------%%%%%%%------##---##-----%%%%%---%%%%%-----------------------------------------------------------------------------
|||||||||||------|||||--|||||||--||||---|||||||--|||||||||--||||%%%%%--%%%%%---------|||||||-----###---###--%%|||||---|||||-----------#--#--------------------------------------------------------------
|||||||||||------|||||--|||||||--||||---|||||||--|||||||||--|||||||||--|||||-g-------|||||||---%%%%%---%%%%%|||||||---|||||---------%%%--%%%------------------------------------------------------------
|||||||||||XX--XX|||||--|||||||--||||---|||||||--|||||||||--|||||||||--|||||XXXXXXXXXXXXXXXXXXX|||||---||||||||||||---|||||XXX---XXX|||--|||XXXXXXXXFXXXXXXXXXXXXXXXXXXXXXXXXXXXXXXXXXXXXXXXXXXXXXXXXXXX
