HEIGHT=16;WIDTH=201;THEME=0;OVERRIDE=false
--------------------------------------------------------------------------------------------------------------------------------------------------------------------------------------------------------
--------------------------------------------------------------------------------------------------------------------------------------------------------------------------------------------------------
--------------------------------------------------------------------------------------------------------------------------------------------------------------------------------------------------------
--------------------------------------------------------------------------------------------------------------------------------------------------------------------------------------------------------
--------------------------------------------------------------------------------------------------------------------------------------------------------------------------------------------------------
--------------------------------------------------------------------------------------------------------------------------------------------------------------------------------------------------------
--------------------------------------------------------------------------------------------------------------------------SSS--------SSSUS--------------------------------------------------------------
--------------------------------------------------------------------------------------------------------------------------------------------------------------------------------------------------------
--------------------------------------------------------------------------------------------------------------------------------------------------------------------------------------------------------
-----------------------------------------------------------------tt---Tt-------------------------------------------------------------ky-----------------------------------------------------------------
-----------------------------------------------------------------tt---tt--------------------------------------------------%%%%-------%%%%%--------------------------------------------------------------
---------------------%%%%%%%-------------------------------------tt---tt--------------------------2CSUSSS-----------------||||-------|||||--------------------------------------------------------------
%%%%%%%%%%%%%--------|||||||------------%%%%---%%%%%%%%--------%%%%%%%%%%%%%------------------------------%%%%%%%%%%------||||-------|||gg---%%%%%%%%F%%%%%%%%%%%%%%%%%%%%%%%%%%%%%%%%%%%%%%%%%%%%%%%%%%
|||||||||||||--------|y||||y---r-%%---%%||||---||||||||--------|||||||||||||%%%%---%%%%--------%%---------||||||||||--yr-g|Y||----%%%%%%%%%%%||||||||%||||||||||||||||||||||||||||||||||||||||||||||||||
|||||||||||||-------%%%%%%%%%%%%%||---||||||---||||||||--------|||||||||||||||||---||||%%%--%%%||-------y-||||||||||%%%%%%%%%%%%%%||||||||||||||||||||||||||||||||||||||||||||||||||||||||||||||||||||||
|||||||||||||XX---XX|||||||||||||||---||||||---||||||||XXX--XXX|||||||||||||||||---|||||||--|||||XXXXXXXXX||||||||||||||||||||||||||||||||||||||||||||||||||||||||||||||||||||||||||||||||||||||||||||||
