HEIGHT=16;WIDTH=201;THEME=0;OVERRIDE=false
--------------------------------------------------------------------------------------------------------------------------------------------------------------------------------------------------------
--------------------------------------------------------------------------------------------------------------------------------------------------------------------------------------------------------
--------------------------------------------------------------------------------------------------------------------------------------------------------------------------------------------------------
--------------------------------------------------------------------------------------------------------------------------------------------------------------------------------------------------------
--------------------------------------------------------------------------------------------------------------------------------------------------------------------------------------------------------
-----------------------------------------------C2SS-----------------------------------------------------------------------------------------------------------------------------------------------------
-------------------------------------------------------------------------------------------------------SSCCCS-------------------------------------------------------------------------------------------
--------------------------------------------------------------------------------------------------------------------------------------------------------------------------------------------------------
---------------------------------------------g-r-g------------------------------------------------------------------------------------------------------------------------------------------------------
---------------------------------------------%%%%%%------------------------------------------------------r-y--------------------------------------------------------------------------------------------
---------------------------------------------||||||---------------------------------S2U---------------%%%%%%%-------------------------------------------------------------------------------------------
----------------#---#------------------------||||||---------------------------------------------------|||||||-------------------------------------------------------------------------------------------
--------------%%%---%%%-----------------yg-y-||||||------------%%%%----------------------------------%%%%%%%%%%-----------------------------------------------------------------------------------------
--------------|||---|||%%--%%----------%%%%%%%%%%%%%%%%--------||||--------------k-------------------||||||||||-----------------------------------------------------------------------------------------
--------------|||---|||||--||%%---%%%%%||||||||||||||||%%%--%%%||||-------------%%%%%%%%%%----%%---%%||||||||||%%%--%%%%%%%---%%%%-------#---#----------------------------------------------------------
XXXXXXXXXXXXXX|||---|||||--||||---||||||||||||||||||||||||--|||||||XXXXX---XXXXX||||||||||XXXX||---|||||||||||||||--|||||||---||||XXXXXXXX---XXXXXXXXXXXFXXXXXXXXXXXXXXXXXXXXXXXXXXXXXXXXXXXXXXXXXXXXXXX
