HEIGHT=16;WIDTH=201;THEME=0;OVERRIDE=false
--------------------------------------------------------------------------------------------------------------------------------------------------------------------------------------------------------
--------------------------------------------------------------------------------------------------------------------------------------------------------------------------------------------------------
--------------------------------------------------------------------------------------------------------------------------------------------------------------------------------------------------------
--------------------------------------------------------------------------------------------------------------------------------------------------------------------------------------------------------
--------------------------------------------------------------------------------------------------------------------------------------------------------------------------------------------------------
--------------------------------------------------------------------------------------------------------------------------------------------------------------------------------------------------------
--------------------------------------------------------------------------------------------------------------------------------------------------------------------------------------------------------
--------------------------------------------------------------------------------------------------------------------------------------------------------------------------------------------------------
--------------------------------------------------------------------------------------------------------------------------------------------------------------------------------------------------------
--------------------------------------------------------------------------------------------------------------------------------------------------------------------------------------------------------
----------------#---#-----------------------#---#-------------------------------------------------------------------------------------------------------------------------------------------------------
---------------##---##---------------------##---##------g-----------------------------------------------------------------------------------------------------------------------------------------------
-------------%%%%---%%%%-----------------%%%%---%%%%%%%%%%--------%%%---%%%----------------------------------------------------------------%%%%%%%%F%%%%%%%%%%%%%%%%%%%%%%%%%%%%%%%%%%%%%%%%%%%%%%%%%%%%
-------------||||---||||--k--------------||||---||||||||||--------|||---|||---#---#-------------------------------------%%---%%%%%%%--%%%%%||||||||%||||||||||||||||||||||||||||||||||||||||||||||||||||
%%%%%%%%%%%%%||||---||||%%%%%%-----------||||---||||||||||--#--#--|||---|||--##---##--%%%%--%%%%%%---%%-----------------||---|||||||--||||||||||||||||||||||||||||||||||||||||||||||||||||||||||||||||||
|||||||||||||||||---||||||||||XXXX---XXXX||||---||||||||||XXX--XXX|||---|||XXXX---XXXX||||--||||||---||XXX---XXXXXX--XXX||---|||||||--||||||||||||||||||||||||||||||||||||||||||||||||||||||||||||||||||
