HEIGHT=16;WIDTH=201;THEME=0;OVERRIDE=false
--------------------------------------------------------------------------------------------------------------------------------------------------------------------------------------------------------
--------------------------------------------------------------------------------------------------------------------------------------------------------------------------------------------------------
--------------------------------------------------------------------------------------------------------------------------------------------------------------------------------------------------------
--------------------------------------------------------------------------------------------------------------------------------------------------------------------------------------------------------
--------------------------------------------------------------------------------------------------------------------------------------------------------------------------------------------------------
--------------------------------------------------------------------------------------------------------------------------------------------------------------------------------------------------------
--------------------------------------------------22C---------------------------------------------------------------------------------------------------------------------------------------------------
--------------------------------------------------------------------------------------------------------------------------------------------------------------------------------------------------------
--------------------------------------------------------------------------------------------------------------------------------------------------------------------------------------------------------
-----------------------%%%%%%------------------y-g------------------------------------------------------------------------------------------------------------------------------------------------------
-----------------------||||||-y-y--------------%%%%%%%-----------tt-------------------------------------------------------------------------------------------------------------------------------------
---------------SSCS----||||%%%%%%-------------g|||Gr||k-ky-------tt---Tt--------------------------------------------------------------------------------------------------------------------------------
-----------------------||||||y|||------------%%%%%%%%%%%%%%%%%---tt---tt------#---#---------------------------------------------------------------------------------------------------------------------
---------------------%%%%%%%%%%%%%%%%--------|||||||||||||||||%%%%%%%%%%%%%--##---##----------------------%%---%%---------%%%--%%%----------------------------------------------------------------------
--------------k------||||||||||||||||--------||||||||||||||||||||||||||||||%%%%---%%%%%%---%%-------------||---||---------|||--|||--#--#----------------------------------------------------------------
XXXXXXXXXXXXXXXXXXXXX||||||||||||||||XXX--XXX||||||||||||||||||||||||||||||||||---||||||---||XXXXX---XXXXX||---||XXX---XXX|||--|||XXX--XXXXXXXXXXXFXXXXXXXXXXXXXXXXXXXXXXXXXXXXXXXXXXXXXXXXXXXXXXXXXXXXX
