HEIGHT=16;WIDTH=201;THEME=0;OVERRIDE=false
--------------------------------------------------------------------------------------------------------------------------------------------------------------------------------------------------------
--------------------------------------------------------------------------------------------------------------------------------------------------------------------------------------------------------
--------------------------------------------------------------------------------------------------------------------------------------------------------------------------------------------------------
--------------------------------------------------------------------------------------------------------------------------------------------------------------------------------------------------------
--------------------------------------------------------------------------------------------------------------------------------------------------------------------------------------------------------
--------------------------------------------------------------------------------------------------------------------------------------------------------------------------------------------------------
--------------------------------------------------------------------------------------------------------------------------------------------------------------------------------------------------------
--------------------------------------------------------------------------------------------------------------------------------------------------------------------------------------------------------
--------------------------------------------------------------------------------------------------------------------------------------------------------------------------------------------------------
--------------------------------------------------------------------------------------------------------------------------------------------------------------------------------------------------------
----------------------------------------%%%%--------------------------------g---------------------------------------------------------------------------------------------------------------------------
----------------------------------------||||-----------------------------%%%%------#--#------------------------------------------#---#------------------------------------------------------------------
----------------------#---#----%%%--%%%-||||--------#--#-----------------||||-----##--##----r-g-%%%%%--%%%%%-------------------%%%---%%%----------------------------------------------------------------
-----------%%---%%---##---##---|||--|||-|||y----r-%%%--%%%---------------||||---%%%%--%%%%%%%%%%|||||--|||||%%%%%---%%%%%------|||---|||----------------------------------------------------------------
%%%%%%%%%%%||---||--###---###--|||--|||%%%%%%%%%%%|||--|||%%%%--%%%%---y-||g|---||||--|||||||||||||||--||||||||||---|||||------|||---|||%%%%%%%%F%%%%%%%%%%%%%%%%%%%%%%%%%%%%%%%%%%%%%%%%%%%%%%%%%%%%%%%
|||||||||||||---||XXXXX---XXXXX|||--|||||||||||||||||--|||||||--||||XXXXXXXXXXXX||||--|||||||||||||||--||||||||||---|||||XX--XX|||---|||||||||||X|||||||||||||||||||||||||||||||||||||||||||||||||||||||
