HEIGHT=16;WIDTH=201;THEME=0;OVERRIDE=false
--------------------------------------------------------------------------------------------------------------------------------------------------------------------------------------------------------
--------------------------------------------------------------------------------------------------------------------------------------------------------------------------------------------------------
--------------------------------------------------------------------------------------------------------------------------------------------------------------------------------------------------------
--------------------------------------------------------------------------------------------------------------------------------------------------------------------------------------------------------
--------------------------------------------------------------------------------------------------------------------------------------------------------------------------------------------------------
-------------------------------------------------r-r----------------------------------------------------------------------------------------------------------------------------------------------------
------------------------------------------------%%%%----------------------------------------------------------------------------------------------------------------------------------------------------
------------------------------------------------||||-y--------------------------------------------------------------------------------------------------------------------------------------------------
------------------------------------------------|||%%%-----------------------------------------------------SUSCC----------------------------------------------------------------------------------------
------------------------------------------------||||||--------------------------------------------------------------------------------------------------------------------------------------------------
---------------SSS------------------------------||||||--------------------------------------------------------------------------------------------------------------------------------------------------
------------------------------------------------||||||---g---------------------------------------------------------g------------------------------------------------------------------------------------
--------------------------------%%%%%%%-------%%%%%%%%%%%%%%%%---%%%%%%%---%%%%%%%---%%%--#--#------------%%%%%%%%%%%%%%%%%%%--%%%%%-------------%%%%%%%%F%%%%%%%%%%%%%%%%%%%%%%%%%%%%%%%%%%%%%%%%%%%%%%
%%%%%%%%%%%%%%-----r------------|||||||-------||||||||||||||||---|||||||---|||||||---|||%%%--%%%----------|||||||||||||||||||--|||||-------------||||||||%||||||||||||||||||||||||||||||||||||||||||||||
||||||||||||||%%%%%%%%%%%--%%%%-|||||||-y--r--||||||||||||||||---|||||||---|||||||---||||||--|||----------|||||||||||||||||||--|||||-------------|||||||||||||||||||||||||||||||||||||||||||||||||||||||
|||||||||||||||||||||||||--||||XXXXXXXXXXXXXXX||||||||||||||||---|||||||---|||||||---||||||--|||XXXXXXXXXX|||||||||||||||||||--|||||XXXXX---XXXXX|||||||||||||||||||||||||||||||||||||||||||||||||||||||
