HEIGHT=16;WIDTH=201;THEME=0;OVERRIDE=false
--------------------------------------------------------------------------------------------------------------------------------------------------------------------------------------------------------
--------------------------------------------------------------------------------------------------------------------------------------------------------------------------------------------------------
--------------------------------------------------------------------------------------------------------------------------------------------------------------------------------------------------------
--------------------------------------------------------------------------------------------------------------------------------------------------------------------------------------------------------
----------------------------------------------------------------------SSS2S-----------------------------------------------------------------------------------------------------------------------------
--------------------------------------------------------------------------------------------------------------------------------------------------------------------------------------------------------
--------------------------------------------------------------------------------------------------------------------------------------------------------------------------------------------------------
----------------------------------------------------------------------g-k--k----------------------------------------------------------------------------------------------------------------------------
------------------------------------------------SSSS------------------%%%%%%%-------C2SSCS--------------------------------------------------------------------------------------------------------------
----------------------------------------------------------------------|||||||---------------------------------------------------------------------------------------------------------------------------
----------------------------------------------------%-----------------||||||g---------------------------------------------------------------------------------------------------------------------------
----------------------------------------------------|-----------------|||||%%%%%-----r-y----------------------------------------------------------------------------------------------------------------
-------------------------------%%%%%---%%%%%%%%%%%%%%%%--------------y||||||||||--%%%%%%%%%%----------------------r------%%%%%---%%%%%--y---y-----------------------------------------------------------
-------------------------------|||||---||||||||||||||||%%%%%---%%%%%%%%%%%%%%%%%%%||||||||||%%%%%---%%%%%-------%%%%%%%%%|||||---|||||%%%%%%%%%%%%%%%%%F%%%%%%%%%%%%%%%%%%%%%%%%%%%%%%%%%%%%%%%%%%%%%%%%
%%%%%%%%%%%%%%%%%---%%%%-------|||||---|||||||||||||||||||||---||||||||||||||||||||||||||||||||||---|||||%%---%%||||||||||||||---||||||||||||||||||||||%||||||||||||||||||||||||||||||||||||||||||||||||
|||||||||||||||||---||||XX---XX|||||---|||||||||||||||||||||---||||||||||||||||||||||||||||||||||---|||||||---||||||||||||||||---|||||||||||||||||||||||||||||||||||||||||||||||||||||||||||||||||||||||
