HEIGHT=16;WIDTH=201;THEME=0;OVERRIDE=false
--------------------------------------------------------------------------------------------------------------------------------------------------------------------------------------------------------
--------------------------------------------------------------------------------------------------------------------------------------------------------------------------------------------------------
--------------------------------------------------------------------------------------------------------------------------------------------------------------------------------------------------------
--------------------------------------------------------------------------------------------------------------------------------------------------------------------------------------------------------
--------------------------------------------------------------------------------------------------------------------------------------------------------------------------------------------------------
--------------------------------------------------------------------------------------------------------------------------------------------------------------------------------------------------------
--------------------------------------------------------------------------------------------------------------------------------------------------------------------------------------------------------
--------------------------------------------------------------------------------------------------------------------------------------------------------------------------------------------------------
-------------SCSSS2SSS----------------------------------------------------------------------------------------------------------------------------------------------------------------------------------
--------------------------------------------------------------------------------------------------------------------------------------------------------------------------------------------------------
----------------------------------------%%%%%-----------------------------------------------------------------------------------------------------------------------------------------------------------
------------------------------------k---g||||-----------------------------------------------------------------------------------------------------------------------------------------------------------
------------%%%%%%%%%%%-----------%%%%%%%%%%%%%%%%%%%-------------%%--%%--------------------------%%---%%%%--%%-----------------------------------------------------------------------------------------
------------|||||||||||-----------|||||||||||||||||||-------------||--||--#---#-------------------||---||||--||%%%%%--%%%%%%%%%%--%%%%%%%%%%%%%%%%%%F%%%%%%%%%%%%%%%%%%%%%%%%%%%%%%%%%%%%%%%%%%%%%%%%%%%
------------|||||||||||%%%%---%%%%|||||||||||||||||||%%%%%---%%%%%||--||%%%---%%%-----k-%%%%--%%%%||---||||--|||||||--||||||||||--||||||||||||||||||%|||||||||||||||||||||||||||||||||||||||||||||||||||
XXXXXXXXXXXX|||||||||||||||---||||||||||||||||||||||||||||---|||||||--|||||---|||XXXXXXX||||--||||||---||||--|||||||--||||||||||--||||||||||||||||||||||||||||||||||||||||||||||||||||||||||||||||||||||
