HEIGHT=16;WIDTH=201;THEME=0;OVERRIDE=false
--------------------------------------------------------------------------------------------------------------------------------------------------------------------------------------------------------
--------------------------------------------------------------------------------------------------------------------------------------------------------------------------------------------------------
--------------------------------------------------------------------------------------------------------------------------------------------------------------------------------------------------------
--------------------------------------------------------------------------------------------------------------------------------------------------------------------------------------------------------
--------------------------------------------------------------------------------------------------------------------------------------------------------------------------------------------------------
-------------------------------------------------------------------------------------------------------------------------------SCSSS--------------------------------------------------------------------
--------------------------------------------------------------------------------------------------------------------------------------------------------------------------------------------------------
--------------------------------------------------------------------------------------------------------------------------------------------------------------------------------------------------------
-------------------------------------------------------------------------------------------------------------------------------gg-----------------------------------------------------------------------
--------------------------------------------y----------------------------------------------------------------------------------%%%%%--------------------------------------------------------------------
------------------------------------------%%%----------------------------------------------------------------------------------|||||--------------------------------------------------------------------
---------------------tt-Tt----------------|||---------22C---------------------------------------------------------%%%%%%%------|||||----g---------------------------------------------------------------
%%%%%%%%%%%%%--------tt-tt----------------|||------------------------------------------------------tt----Tt-------|||||||------|||||--%%%---------------------------------------------------------------
|||||||||||||--------tt-tt-------------%%%%%%%%%%%%------------------------------------------------tt----tt-------||g||||r-----y|||gr-|||---k-----------------------------------------------------------
|||||||||||||%%---%%%%%%%%%------------||||||||||||-------r---------------%%%--%%%%%%---%%%--------tt----tt-----%%%%%%%%%%%%%%%%%%%%%%%%%%%%%%----------------------------------------------------------
|||||||||||||||---|||||||||XXXXX--XXXXX||||||||||||XXXXXXXXXXXXXXX---XXXXX|||--||||||---|||XX---XXXXXXXXXXXXXXXX||||||||||||||||||||||||||||||XXXXXXXXFXXXXXXXXXXXXXXXXXXXXXXXXXXXXXXXXXXXXXXXXXXXXXXXXX
