HEIGHT=16;WIDTH=201;THEME=0;OVERRIDE=false
--------------------------------------------------------------------------------------------------------------------------------------------------------------------------------------------------------
--------------------------------------------------------------------------------------------------------------------------------------------------------------------------------------------------------
--------------------------------------------------------------------------------------------------------------------------------------------------------------------------------------------------------
--------------------------------------------------------------------------------------------------------------------------------------------------------------------------------------------------------
--------------------------------------------------------------------------------------------------------------------------------------------------------------------------------------------------------
--------------------------------------------------------------------------------------------------------------------------------------------------------------------------------------------------------
--------------------------------------------------------------------------------------------------------------------------------------------------------------------------------------------------------
--------------------------------------------------------------------------------------------------------------------------------------------------------------------------------------------------------
--------------------------------------------------------------------------------------------------------------------------------------------------------------------------------------------------------
---------------------------------------------------------------------------------------------------------------------------------------------r-y--------------------------------------------------------
-----------------------------------------------------------------------------------------------------------------------------------------%%%%%%%--------------------------------------------------------
-----------------------------------------------------------------------------------------------------------------------------------------|||||||--------------------------------------------------------
---------------tt---tt----%%--%%--------------------------------------------%%%---%%%---------------------------%%%---%%%----------------|||||||--r-%%%%%%%%F%%%%%%%%%%%%%%%%%%%%%%%%%%%%%%%%%%%%%%%%%%%
---------------tt---tt----||--||%%%%%--%%%%%--#---#--%%%--%%%---------------|||---|||---%%%%%%%-----------------|||---|||%%%----------%%%%%%%%%%%%%%||||||||%|||||||||||||||||||||||||||||||||||||||||||
%%%%%%%%%%%%%%%%%%%%%%%%%%||--|||||||--|||||%%%---%%%|||--|||-------%%%--%%%|||---|||---||y||||---------%%%--%%%|||---||||||----------||||||||||||||||||||||||||||||||||||||||||||||||||||||||||||||||||
||||||||||||||||||||||||||||--|||||||--||||||||---||||||--|||XX---XX|||--||||||---|||XXXXXXXXXXXXXXXXXXX|||--||||||---||||||XXXX--XXXX||||||||||||||||||||||||||||||||||||||||||||||||||||||||||||||||||
