HEIGHT=16;WIDTH=201;THEME=0;OVERRIDE=false
--------------------------------------------------------------------------------------------------------------------------------------------------------------------------------------------------------
--------------------------------------------------------------------------------------------------------------------------------------------------------------------------------------------------------
--------------------------------------------------------------------------------------------------------------------------------------------------------------------------------------------------------
--------------------------------------------------------------------------------------------------------------------------------------------------------------------------------------------------------
--------------------------------------------------------------------------------------------------------------------------------------------------------------------------------------------------------
--------------------------------------------------------------------------------------------------------------------------------------------------------------------------------------------------------
--------------------------------------------------------------------------------------------------------------------------------------------------------------------------------------------------------
--------------------------------------------------------------------------------------------------------------------------------------------------------------------------------------------------------
--------------------------------------------------------------------------------------------------------------------------------r-----------------------------------------------------------------------
--------------------------------------------------------------CC--------------------------------------------------------------%%%%%%--------------------------------------------------------------------
-----------------------SC2SSC-----------------------------------------SSS-----------------------------------------------------||||||--------------------------------------------------------------------
-------------------------------------------------------------%----------------------------------------------------------------||||||g-------------------------------------------------------------------
---------------#--#------------------------------------------|-r-------------------------------------------------------------%%%%%%%%%%%%%%%%%%%%%F%%%%%%%%%%%%%%%%%%%%%%%%%%%%%%%%%%%%%%%%%%%%%%%%%%%%%
--------------##--##--------g-------------#---#------------%%%%%%%-K-------Y---------------------------%%%--%%%--------------|||||||||||||||||||||%|||||||||||||||||||||||||||||||||||||||||||||||||||||
------------%%%%--%%%%%%%%%%%%%%%%%%%%%%%%%---%%%----------|||||||%%%%%%%%%%%--------------------------|||--|||--------------|||||||||||||||||||||||||||||||||||||||||||||||||||||||||||||||||||||||||||
XXXXXXXXXXXX||||--|||||||||||||||||||||||||---|||XXXX--XXXX||||||||||||||||||XXXXXXXXX--XXXXXXXXX--XXXX|||--|||XX--XXXXX--XXX|||||||||||||||||||||||||||||||||||||||||||||||||||||||||||||||||||||||||||
