HEIGHT=16;WIDTH=201;THEME=0;OVERRIDE=false
--------------------------------------------------------------------------------------------------------------------------------------------------------------------------------------------------------
--------------------------------------------------------------------------------------------------------------------------------------------------------------------------------------------------------
--------------------------------------------------------------------------------------------------------------------------------------------------------------------------------------------------------
--------------------------------------------------------------------------------------------------------------------------------------------------------------------------------------------------------
--------------------------------------------------------------------------------------------------------------------------------------------------------------------------------------------------------
--------------------------------------------------------------------------------------------------------------------------------------------------------------------------------------------------------
--------------------------------------------------------------------------------------------------------------------------------------------------------------------------------------------------------
--------------------------------------------------------------------------------------------------------------------------------------------------------------------------------------------------------
--------------------------------------------------------------------------------------------------------------------------------------------------------------------------------------------------------
--------------------------------------------------------------------------------------------------------------------------------------------------------------------------------------------------------
------------------------------------------------------------SSSSC2---------------------------------------#--#-------------------------------------------------------------------------------------------
---------------#--#---------------------------------------------------------------#--#------------------##--##------------------------------------------------------------------------------------------
-------------%%%--%%%----------%%%--%%%----------------------------%%%%---%%%%---##--##----------------###--###-----------------------------------------------------------------------------------------
-------------|||--|||----------|||--|||------------%%%--%%%--------||||---||||--###--###--%%%%---%%%%%%%%%--%%%%%---------------------------------------------------------------------------------------
%%%%%%%%%%%%%|||--|||----------|||--|||%%%%%--%%%%%|||--|||%%%%%%%%||||---||||%%%%%--%%%%%||||---|||||||||--|||||%%%%%--%%%%%---------------------------------------------------------------------------
||||||||||||||||--|||XXXX--XXXX|||--||||||||--||||||||--|||||||||||||||---|||||||||--|||||||||---|||||||||--||||||||||--|||||XXXXX--XXXXXXXXXXXXXFXXXXXXXXXXXXXXXXXXXXXXXXXXXXXXXXXXXXXXXXXXXXXXXXXXXXXX
