HEIGHT=16;WIDTH=201;THEME=0;OVERRIDE=false
--------------------------------------------------------------------------------------------------------------------------------------------------------------------------------------------------------
--------------------------------------------------------------------------------------------------------------------------------------------------------------------------------------------------------
--------------------------------------------------------------------------------------------------------------------------------------------------------------------------------------------------------
--------------------------------------------------------------------------------------------------------------------------------------------------------------------------------------------------------
--------------------------------------------------------------------------------------------------------------------------------------------------------------------------------------------------------
--------------------------------------------------------------------------------------------------------------------------------------------------------------------------------------------------------
--------------------------------------------------------------------------------------------------------------------------------------------------------------------------------------------------------
--------------------------------------------------------------------------------------------------------------------------------------------------------------------------------------------------------
--------------------------------------------------------------------------------------------------------------------------------------------------------------------------------------------------------
----------------------------------CSSS------------------------------------------------------------------------------------------------------------------------------------------------------------------
--------------------------------------------------------------------------------------------------------------------------------------------------------------------------------------------------------
-------------------------%%%%%--------------------------------------------------#--#--------------------------------------------------------------------------------------------------------------------
%%%%%%%%%%%%%%%---%%-----|||||-----k-------------------------------------------##--##---------------------------------y--k------------------------------------------------------------------------------
|||||||||||||||---||-----|||||--%%%%%%%%%%-----------------%%%%---%%%%-------%%%%--%%%%-------------%%---%%--------%%%%%%%-----------------%%%%%%%%F%%%%%%%%%%%%%%%%%%%%%%%%%%%%%%%%%%%%%%%%%%%%%%%%%%%%
|||||||||||||||---||--g--g|y||--||||||||||%%--%%%%%%---%%%%||||---||||-------||||--||||%%%%%---%%%%%||---||-----k-r|rKG|||r----------------||||||||%||||||||||||||||||||||||||||||||||||||||||||||||||||
|||||||||||||||---||XXXXXXXXXXXX||||||||||||--||||||---||||||||---||||XX---XX||||--|||||||||---|||||||---||XXXXXXXXXXXXXXXXXXXXXXXX---XXXXX|||||||||||||||||||||||||||||||||||||||||||||||||||||||||||||
