HEIGHT=16;WIDTH=201;THEME=0;OVERRIDE=false
--------------------------------------------------------------------------------------------------------------------------------------------------------------------------------------------------------
--------------------------------------------------------------------------------------------------------------------------------------------------------------------------------------------------------
--------------------------------------------------------------------------------------------------------------------------------------------------------------------------------------------------------
--------------------------------------------------------------------------------------------------------------------------------------------------------------------------------------------------------
--------------------------------------------------------------------------------------------------------------------------------------------------------------------------------------------------------
--------------------------------------------------------------------------------------------------------------------------------------------------------------------------------------------------------
--------------------------------------------------------------------------------------------------------------------------------------------------------------------------------------------------------
--------------------------------------------------------------------------------------------------------------------------------------------------------------------------------------------------------
---------------------------------------------------------------------------------------SUSCSSS----------------------------------------------------------------------------------------------------------
--------------------------------------------------------------------------------------------------------------------------------------------------------------------------------------------------------
---------------------------------------------------------------------2C-2S------------------------------------------------------------------------------------------------------------------------------
-----------------------------------------------------------------------------------------------------k----------------------------#--#------------------------------------------------------------------
--------------%%---%%-----------#---#-------%%%%%%---------------------%--------------%%%%%%%%%%%%%%%%%%%%%%%-------------tt-----##--##-----------------------------------------------------------------
--------------||---||----------##---##------||||||---------------------|--------------|||||||||||||||||||||||-------------tt---%%%%--%%%%%%%%%%%%F%%%%%%%%%%%%%%%%%%%%%%%%%%%%%%%%%%%%%%%%%%%%%%%%%%%%%%
%%%%%%%%%%%%%%||---||---------###---###-----||||||%%%-------------%%%%%%%%%%%%%---%%%%|||||||||||||||||||||||-------------tt---||||--||||||||||||%||||||||||||||||||||||||||||||||||||||||||||||||||||||
||||||||||||||||---||XX---XXXXXXX---XXXXXXXX|||||||||XXXXX---XXXXX|||||||||||||---|||||||||||||||||||||||||||XX--XXXXXXXXXXXXXX||||--|||||||||||||||||||||||||||||||||||||||||||||||||||||||||||||||||||
