HEIGHT=16;WIDTH=201;THEME=0;OVERRIDE=false
--------------------------------------------------------------------------------------------------------------------------------------------------------------------------------------------------------
--------------------------------------------------------------------------------------------------------------------------------------------------------------------------------------------------------
--------------------------------------------------------------------------------------------------------------------------------------------------------------------------------------------------------
--------------------------------------------------------------------------------------------------------------------------------------------------------------------------------------------------------
--------------------------------------------------------------------------------------------------------------------------------------------------------------------------------------------------------
--------------------------------------------------------------------------------------------------------------------------------------------------------------------------------------------------------
--------------------------------------------------------------------------------------------------------------------------------------------------------------------------------------------------------
--------------------------------------------------------------------------------------------------------------------------------------------------------------------------------------------------------
--------------------------------------------------------------------------------------------------------------------------------------------------------------------------------------------------------
--------------------------------------------------------------------------------------------------------------------gy---y------------------------------------------------------------------------------
--------------------------------------------------------------------------------------------------------------------%%%%%%%-----------------------------------------------------------------------------
--------------------------------#--#--------------------------------------------------------------------------------|||||||-----------------------------------------------------------------------------
-------------------------------##--##------------------------%%--%%%%%%%--%%%%%-------------------------%%%%---%%%%-|||||||------------------%%%%%%%%F%%%%%%%%%%%%%%%%%%%%%%%%%%%%%%%%%%%%%%%%%%%%%%%%%%
----------------G-----%%--%%--###--###-------------%%%%--%%%%||--|||||||--|||||%%%%%--%%%%%%%%%%---%%%%%||||---||||-g||y|||-----------%%---%%||||||||%||||||||||||||||||||||||||||||||||||||||||||||||||
-------------%%%%%%%%%||--||%%%%%--%%%%%-----------||||--||||||--|||||||--||||||||||--||||||||||---|||||||||---||||%%%%%%%%%%%%%%--%%%||---|||||||||||||||||||||||||||||||||||||||||||||||||||||||||||||
XXXXXXXXXXXXX|||||||||||--|||||||--|||||XXXX---XXXX||||--||||||--|||||||--||||||||||--||||||||||---|||||||||---||||||||||||||||||--|||||---|||||||||||||||||||||||||||||||||||||||||||||||||||||||||||||
