HEIGHT=16;WIDTH=201;THEME=0;OVERRIDE=false
--------------------------------------------------------------------------------------------------------------------------------------------------------------------------------------------------------
--------------------------------------------------------------------------------------------------------------------------------------------------------------------------------------------------------
--------------------------------------------------------------------------------------------------------------------------------------------------------------------------------------------------------
--------------------------------------------------------------------------------------------------------------------------------------------------------------------------------------------------------
--------------------------------------------------------------------------------------------------------------------------------------------------------------------------------------------------------
---------------------------------------------------------------------------------------------------------y----------------------------------------------------------------------------------------------
------------------------------------------------------------------------------------------------------%%%%%%%-------------------------------------------------------------------------------------------
------------------------------------------------------------------------------------------------------|||||||-------------------------------------------------------------------------------------------
------------------------------------------------------------------------------------------------------|||||||-------------------------------------------------------------------------------------------
------------------------------------------------------------------------------------------------------|||||||-------------------------------------------------------------------------------------------
-------------------------#---#------------------------------------------------------------------------||||%%%%%%------#--#------------------------------------------------------------------------------
------------------------##---##-----SC2S--------------------------------------------------------------|r|||y||k|-----##--##-----------------------------------------------------------------------------
----------------------%%%%---%%%%--------------------------------------------------%%---%%-----------%%%%%%%%%%%%%--###--###----------------------------------------------------------------------------
----------%%----------||||---||||-----------#--#--%%%%%---%%%%%-------------%%---%%||---||-----------|||||||||||||%%%%%--%%%%%-----------%%%%%%%%F%%%%%%%%%%%%%%%%%%%%%%%%%%%%%%%%%%%%%%%%%%%%%%%%%%%%%%
%%%%%%%%%%||%%%%%--%%%||||---||||---------%%%--%%%|||||---|||||%%%--%%%-----||---||||---||----%%---%%||||||||||||||||||--|||||%%%%%%%%%%%||||||||%||||||||||||||||||||||||||||||||||||||||||||||||||||||
|||||||||||||||||--|||||||---||||XXXXXXXXX|||--||||||||---||||||||--|||XXXXX||---||||---||XXXX||---||||||||||||||||||||--|||||||||||||||||||||||||||||||||||||||||||||||||||||||||||||||||||||||||||||||
