HEIGHT=16;WIDTH=201;THEME=0;OVERRIDE=false
--------------------------------------------------------------------------------------------------------------------------------------------------------------------------------------------------------
--------------------------------------------------------------------------------------------------------------------------------------------------------------------------------------------------------
--------------------------------------------------------------------------------------------------------------------------------------------------------------------------------------------------------
--------------------------------------------------------------------------------------------------------------------------------------------------------------------------------------------------------
--------------------------------------------------------------------------------------------------------------------------------------------------------------------------------------------------------
--------------------------------------------------------------------------------------------------------------------------------------------------------------------------------------------------------
--------------------------------------------------------------------------------------------------------------------------------------------------------------------------------------------------------
--------------------------------------------------------------------------------------------------------------------------------------------------------------------------------------------------------
--------------------------------------------------------------------------------------------------------------------------------------------------------------------------------------------------------
--------------------------------------------------------------------------------------------------------------------------------------------------------------------------------------------------------
-----------------r--------------------------------------------------r-----------------------------------------------------------------------------------------------------------------------------------
---------------%%%%%------------------------------------------------%%%%--------------------------------------------------------------------------------------------------------------------------------
---------------|||||-------------------------------------------y--y-G|||----%%%%---%%%%-----------------------------------------------------------------------------------------------------------------
%%%%%%%%%%%%%--||||y---%%%---%%%%%%%%--%%%%%--------------%%%%%%%%%%%%%%%%%%||||---||||--------%%%---%%%%%%--%%%%%%-----------#--#----------------------------------------------------------------------
|||||||||||||%%%%%%%%%%|||---||||||||--|||||%%%%--%%------||||||||||||||||||||||---||||--#--#--|||---||||||--||||||%%%---%%%%%%--%%%%%%%%%%%%-----------------------------------------------------------
||||||||||||||||||||||||||---||||||||--|||||||||--||XXXXXX||||||||||||||||||||||---||||XXX--XXX|||---||||||--|||||||||---||||||--||||||||||||XXXXXXXXFXXXXXXXXXXXXXXXXXXXXXXXXXXXXXXXXXXXXXXXXXXXXXXXXXX
