HEIGHT=16;WIDTH=201;THEME=0;OVERRIDE=false
--------------------------------------------------------------------------------------------------------------------------------------------------------------------------------------------------------
--------------------------------------------------------------------------------------------------------------------------------------------------------------------------------------------------------
--------------------------------------------------------------------------------------------------------------------------------------------------------------------------------------------------------
--------------------------------------------------------------------------------------------------------------------------------------------------------------------------------------------------------
--------------------------------------------------------------------------------------------------------------------------------------------------------------------------------------------------------
------------------------------------------------------------------------------------------------------------------------------S2SC----------------------------------------------------------------------
--------------------------------------------------------------------------------------------------------------------------------------------------------------------------------------------------------
--------------------------------------------------------------------------------------------------------------------------------------------------------------------------------------------------------
------------------------------------------------------g----------------------------------------------------------------------y--Yk-g--------------------------------------------------------------------
--------------------------------------------------%%%%%%----------%%%%-------------------------------------------------------%%%%%%%--------------------------------------------------------------------
--------------------tt----------------------------||||||----------||||-------------------------------------------------------|||||||--------------------------------------------------------------------
--------------------tt----------------------------|||||y---------r||||-------------------------------------------------------|||||||---k----------------------------------------------------------------
------------------%%%%%%%%------------------------|||%%%%%---%%%%%%%%%%%%-------%%%%%---%%%%%------%%%%-----------%%%%%%%%%%%%%%%%%%%%%%%%--------------------------------------------------------------
%%%%%%%%%%%%%%----||||||||-----------------------g||||||g|---||||||||||||%%---%%|||||---|||||------||||-----------||||||||||||||||||||||||--------------------------------------------------------------
||||||||||||||%%%%||||||||--#---#---------------%%%%%%%%%%%%%||||||||||||||---|||||||---|||||%%--%%||||%%%%---%%%%||||||||||||||||||||||||--------------------------------------------------------------
||||||||||||||||||||||||||XXX---XXXXXXXX---XXXXX|||||||||||||||||||||||||||---|||||||---|||||||--||||||||||---||||||||||||||||||||||||||||XXXXXXXXFXXXXXXXXXXXXXXXXXXXXXXXXXXXXXXXXXXXXXXXXXXXXXXXXXXXXX
