HEIGHT=16;WIDTH=201;THEME=0;OVERRIDE=false
--------------------------------------------------------------------------------------------------------------------------------------------------------------------------------------------------------
--------------------------------------------------------------------------------------------------------------------------------------------------------------------------------------------------------
--------------------------------------------------------------------------------------------------------------------------------------------------------------------------------------------------------
--------------------------------------------------------------------------------------------------------------------------------------------------------------------------------------------------------
--------------------------------------------------------------------------------------------------------------------------------------------------------------------------------------------------------
--------------------------------------------------------------------------------------------------------------------------------------------------------------------------------------------------------
--------------------------------------------------------------------------------------------------------------------------------------------------------------------------------------------------------
--------------------------------------------------------------------------------------------------------------------------------------------------------------------------------------------------------
--------------------------------------------------------------------------------------------------------------------------------------------------------------------------------------------------------
--------------------------------------------------------------------------------------------------------------------------------------------------------------------------------------------------------
---------------------------#--#-------------------------------------------------------------------------------------------------------#---#-------------------------------------------------------------
--------------------------##--##-----------------------------------------------------------------------------------------------------##---##------------------------------------------------------------
-------------------------###--###--%%%%%---%%%%%---------------------------------------------#---#----------------------%%%%%---%%%%%%%---%%%%----------------------------------------------------------
%%%%%%%%%%%%%%---------%%%%%--%%%%%|||||---|||||%%---%%-------------------------------------##---##---------------------|||||---|||||||---||||----------------------------------------------------------
||||||||||||||---------|||||--||||||||||---|||||||---||-----------%%%%%---%%%%%------------###---###--%%%%--%%%%%%%%%%%%|||||---|||||||---||||----------------------------------------------------------
||||||||||||||XXX---XXX|||||--||||||||||---|||||||---||XXXX---XXXX|||||---|||||XXXX--XXXXXXXXX---XXXXX||||--|||||||||||||||||---|||||||---||||XXXXXXXXFXXXXXXXXXXXXXXXXXXXXXXXXXXXXXXXXXXXXXXXXXXXXXXXXX
