HEIGHT=16;WIDTH=201;THEME=0;OVERRIDE=false
--------------------------------------------------------------------------------------------------------------------------------------------------------------------------------------------------------
--------------------------------------------------------------------------------------------------------------------------------------------------------------------------------------------------------
--------------------------------------------------------------------------------------------------------------------------------------------------------------------------------------------------------
--------------------------------------------------------------------------------------------------------------------------------------------------------------------------------------------------------
--------------------------------------------------------------------------------------------------------------------------------------------------------------------------------------------------------
--------------------------------------------------------------------------------------------------------------------------------------------------------------------------------------------------------
--------------------------------------------------------------------------------------------------------------------------------------------------------------------------------------------------------
----------------------------2CS-------------------------------------------------------------------------------------------------------------------------------------------------------------------------
--------------------------------------------------------------------------------------------------------------------------------------------------------------------------------------------------------
-------------------------------%-----------------------------------------------------------SSS2-----------------%%%%------------------------------------------------------------------------------------
-------------------------------|----------------------------SUSSC-----------------------------------------------||||------------------------------------------------------------------------------------
----------------Tt---Tt-----%%%%%---------------------------------------------------------%---------------------||||-r----------------------------------------------------------------------------------
%%%%%%%%%%%%%%%-tt---tt-----|||||--%%%%---%%%%--------------------------------------------|------%%%%%--%%%%%%%%%%%%%%%----------tt----------%%%%%%%%F%%%%%%%%%%%%%%%%%%%%%%%%%%%%%%%%%%%%%%%%%%%%%%%%%%
|||||||||||||||-tt---tt-----|||||--||||---||||-----------------------------------------%%%%%%%%%%|||||--|||||||||||||||----------tt----------||||||||%||||||||||||||||||||||||||||||||||||||||||||||||||
|||||||||||||||%%%%%%%%%%---|||||--||||---||||-------------%%%%%%%%%%------------------|||||||||||||||--|||||||||||||||---------%%%%%%%%---%%|||||||||||||||||||||||||||||||||||||||||||||||||||||||||||
|||||||||||||||||||||||||XXXXXXXXXX||||---||||XXXXX---XXXXX||||||||||XXXXXXXXXXXXX--XXX|||||||||||||||--|||||||||||||||XXX---XXX||||||||---|||||||||||||||||||||||||||||||||||||||||||||||||||||||||||||
