HEIGHT=16;WIDTH=201;THEME=0;OVERRIDE=false
--------------------------------------------------------------------------------------------------------------------------------------------------------------------------------------------------------
--------------------------------------------------------------------------------------------------------------------------------------------------------------------------------------------------------
--------------------------------------------------------------------------------------------------------------------------------------------------------------------------------------------------------
--------------------------------------------------------------------------------------------------------------------------------------------------------------------------------------------------------
--------------------------------------------------------------------------------------------------------------------------------------------------------------------------------------------------------
--------------------------------------------------------------------------------------------------------------------------------------------------------------------------------------------------------
--------------------------------------------------------------------------------------------------------------------------------------------------------------------------------------------------------
--------------------------------------------------------------------------------------------------------------------------------------------------------------------------------------------------------
---------------------------------------------------------------------------------------------------------------------------SSS--------------------------------------------------------------------------
--------------------------------------------------------------------------------------------------------------------------------------------------------------------------------------------------------
---------------------------------------------------------------------------------------------------------------tt---------------------------------------------------------------------------------------
---------------------------------------------------------------------------------------2SS---------------------tt-------ky------------------------------------------------------------------------------
%%%%%%%%%%%%%%%%%%%%%---%%-----%%---%%---------------------------------%%%%%%%%%%%%%%--------------------------tt-------%%%%%%--------------------------------------------------------------------------
|||||||||||||||||||||---||%%%%%||---||%%%%%--%%%%%%%%---%%%------------||||||||||||||------------------#---#--%%%%%%----||||||----------%%%%%%%%F%%%%%%%%%%%%%%%%%%%%%%%%%%%%%%%%%%%%%%%%%%%%%%%%%%%%%%%
|||||||||||||||||||||---|||||||||---|||||||--||||||||---|||%%%--%%%%%%%||||||||||||||-r--------------%%%---%%%||||||--y-||||||---%%---%%||||||||%|||||||||||||||||||||||||||||||||||||||||||||||||||||||
|||||||||||||||||||||---|||||||||---|||||||--||||||||---||||||--|||||||||||||||||||||XXXXXXXXXXX---XX|||---|||||||||XXXXXXXXXXXXX||---||||||||||||||||||||||||||||||||||||||||||||||||||||||||||||||||||
