HEIGHT=16;WIDTH=201;THEME=0;OVERRIDE=false
--------------------------------------------------------------------------------------------------------------------------------------------------------------------------------------------------------
--------------------------------------------------------------------------------------------------------------------------------------------------------------------------------------------------------
--------------------------------------------------------------------------------------------------------------------------------------------------------------------------------------------------------
--------------------------------------------------------------------------------------------------------------------------------------------------------------------------------------------------------
--------------------------------------------------------------------------------------------------------------------------------------------------------------------------------------------------------
--------------------------------------------------------------------------------------------------------------------------------------------------------------------------------------------------------
--------------------------------------------------------------------------------------------------------------------------------------------------------------------------------------------------------
---------------------------------------------%%%%-------------------------------------------------------------------------------------------------------------------------------------------------------
---------------------------------------------||||--------------------------------------------------------------------------SSS-CS2----------------------------------------------------------------------
-------------------------------------------%%%%%|-------------------------------------------------------------------------------------------------------------------------------------------------------
-------------------------------------------||||||--------------------------------------------------------#--#-----------------%-------------------------------------------------------------------------
-------------------------------------------||||||-------------------------------------------------------##--##----------------|--y----------------------------------------------------------------------
-----------------------------------------%%%%%%%%%%---------------------------------%%%---%%%---------%%%%--%%%%---------%%%%%%%%%%---------------------------------------------------------------------
%%%%%%%%%%%------------------------------||||||||||-------------------------------y-|||---|||%%%---%%%||||--||||---------||||||||||---------------------------------------------------------------------
|||||||||||--------%%%%%--%%%%%----------||||||||||%%---%%-------------------%%%%%%%|||---||||||---|||||||--||||--#---#--||||||||||%%%%%---%%%%%%%%%%%%%F%%%%%%%%%%%%%%%%%%%%%%%%%%%%%%%%%%%%%%%%%%%%%%%
|||||||||||XXX--XXX|||||--|||||XXXX--XXXX||||||||||||---||XXXX---XXXXXXX--XXX||||||||||---||||||---|||||||--||||XXX---XXX|||||||||||||||---|||||||||||||X|||||||||||||||||||||||||||||||||||||||||||||||
