HEIGHT=16;WIDTH=201;THEME=0;OVERRIDE=false
--------------------------------------------------------------------------------------------------------------------------------------------------------------------------------------------------------
--------------------------------------------------------------------------------------------------------------------------------------------------------------------------------------------------------
--------------------------------------------------------------------------------------------------------------------------------------------------------------------------------------------------------
--------------------------------------------------------------------------------------------------------------------------------------------------------------------------------------------------------
--------------------------------------------------------------------------------------------------------------------------------------------------------------------------------------------------------
---------------------------------------------------------------------------------%%%%%%--------------------------------------------------ky-------------------------------------------------------------
---------------------------------------------------------------------------------||||||-------------------------------------------------%%%%%-----------------------------------------------------------
--------------------------------------------------------------------------g------||||||-------------------------------------------------|||||-----------------------------------------------------------
----------------------------------------------------------------U22CS-----%%%%%--||||||---------------------------------------------k---|||||-----------------------------------------------------------
--------------------------------------------------------------------------|||||--||||||r--------------------------------------------%%%%%%%||-----------------------------------------------------------
--------------------------------------------------------------------------|||||--|||%%%%%----S-CCSC---------------------------------|||||||||-----------------------------------------------------------
-----------------------------------------------------SCCSS-----------g----|||||--||||||||-------------------------------------------|||||||||-----------------------------------------------------------
%%%%%%%%%%%%%%-g------------------%%%%---%%%%-----------------%%%%%%%%%%%-|||||--||||||||-----|-------------------------------%%%%%%%%%%%%%%%%%%%-------------------------------------------------------
||||||||||||||%%%%%%--------------||||---||||-----------------|||||||||||-|||||--||||||||-----y-y-----%%%%---%%%%%%%%%---%%%%%|||||||||||||||||||-------------------------------------------------------
||||||||||||||||||||%%---%%-------||||---||||-------------g---|||||||||||%%%%%%%%%%%%%%%%%%%%%%%%%%%%%||||---|||||||||---||||||||||||||||||||||||%%%%%%%%F%%%%%%%%%%%%%%%%%%%%%%%%%%%%%%%%%%%%%%%%%%%%%%
||||||||||||||||||||||---||XX---XX||||---||||XX--XXXXXXXXXXXXX||||||||||||||||||||||||||||||||||||||||||||---|||||||||---||||||||||||||||||||||||||||||||X||||||||||||||||||||||||||||||||||||||||||||||
