HEIGHT=16;WIDTH=201;THEME=0;OVERRIDE=false
--------------------------------------------------------------------------------------------------------------------------------------------------------------------------------------------------------
--------------------------------------------------------------------------------------------------------------------------------------------------------------------------------------------------------
--------------------------------------------------------------------------------------------------------------------------------------------------------------------------------------------------------
--------------------------------------------------------------------------------------------------------------------------------------------------------------------------------------------------------
--------------------------------------------------------------------------------------------------------------------------------------------------------------------------------------------------------
--------------------------------------------------------------------------------------------------------------------------------------------------------------------------------------------------------
--------------------------------------------------------------------------------------------------------------------------------------------------------------------------------------------------------
--------------------------------------------------------------------------------------------------------------------------------------------------------------------------------------------------------
--------------------------------------------------------------------------------------------------------------------------------------------------------------------------------------------------------
----------------------------------------------------------------------------2SCC--------------k---------------------------------------------------------------------------------------------------------
---------------------------------------------------------------------------------------------%%%%%------------------------------------------------------------------------------------------------------
---------------------------------------------------------------------------------------------|||K|g--r--------------------------------------------------------------------------------------------------
-------------------------------------------%%%%---%%%%--------------------------------------%%%%%%%%%%%-------------------------------------------------------------------------------------------------
--------------------------------------%%%%%||||---||||-------------------%%%%%%%%%%%--------|||||||||||%%%--%%%-y-------%%%--%%%%%---%%%%%%%%%%%%%%F%%%%%%%%%%%%%%%%%%%%%%%%%%%%%%%%%%%%%%%%%%%%%%%%%%%%
%%%%%%%%%%%%%---------%%%--%%%%%%--%%%|||||||||---||||-------------------|||||||||||%%%--%%%||||||||||||||--|||%%%%%%%%%|||--|||||---||||||||||||||%||||||||||||||||||||||||||||||||||||||||||||||||||||
|||||||||||||XXX---XXX|||--||||||--||||||||||||---||||XXX---XXXXXXX--XXXX||||||||||||||--|||||||||||||||||--|||||||||||||||--|||||---|||||||||||||||||||||||||||||||||||||||||||||||||||||||||||||||||||
