HEIGHT=16;WIDTH=201;THEME=0;OVERRIDE=false
--------------------------------------------------------------------------------------------------------------------------------------------------------------------------------------------------------
--------------------------------------------------------------------------------------------------------------------------------------------------------------------------------------------------------
--------------------------------------------------------------------------------------------------------------------------------------------------------------------------------------------------------
--------------------------------------------------------------------------------------------------------------------------------------------------------------------------------------------------------
--------------------------------------------------------------------------------------------------------------------------------------------------------------------------------------------------------
----------------------------------------------------------------------------------------------------------------------------------G-g-------------------------------------------------------------------
---------------------------------------------------------C-SS--------------------------------------------------------------------%%%%%------------------------------------------------------------------
---------------------------------------------------------------------------------------------------------------------------------||k||------------------------------------------------------------------
----------------------------------------------------------%----------------------------------------------------------------------|%%%|------------------------------------------------------------------
-------------------------------------------------------r--|---------------------------------------S2SUUS-------------------------|||||------------------------------------------------------------------
------------------------------------------------------%%%%%%%---------------Tt---------------------------------------------------|||||------------------------------------------------------------------
------------------------------------------------------|||||||---------------tt---------------------------------------------------|||||------------------------------------------------------------------
---------------------------------------------Tt---tt--|||g|||--------------%%%%%%%------------------------------------%%%--%%%%%%%%%%%%%----------------------------------------------------------------
----------------------------#---#------------tt---tt-%%%%%%%%%%%%%%%---%%%%|||||||%%%---%%%%%%%%%%%%%%%%%-------------|||--|||||||||||||%%%%%%%%F%%%%%%%%%%%%%%%%%%%%%%%%%%%%%%%%%%%%%%%%%%%%%%%%%%%%%%%
---------------------------##---##--%%---%%--tt---tt-|||||||||||||||---||||||||||||||---|||||||||||||||||%%--%%%%---%%|||--|||||||||||||||||||||%|||||||||||||||||||||||||||||||||||||||||||||||||||||||
XXXXXXXXXXXXXXXXXX--XXXXXXXXX---XXXX||---||XXXXXXXXXX|||||||||||||||---||||||||||||||---|||||||||||||||||||--||||---|||||--|||||||||||||||||||||||||||||||||||||||||||||||||||||||||||||||||||||||||||||
