HEIGHT=16;WIDTH=201;THEME=0;OVERRIDE=false
--------------------------------------------------------------------------------------------------------------------------------------------------------------------------------------------------------
--------------------------------------------------------------------------------------------------------------------------------------------------------------------------------------------------------
--------------------------------------------------------------------------------------------------------------------------------------------------------------------------------------------------------
--------------------------------------------------------------------------------------------------------------------------------------------------------------------------------------------------------
--------------------------------------------------------------------------------------------------------------------------------------------------------------------------------------------------------
--------------------------------------------------------------------------------------------------------------------------------------------------------------------------------------------------------
--------------------------------------------------------------------------------------------------------------------------------------------------------------------------------------------------------
--------------------------------------------------------------------------------------------------------------------------------------------------------------------------------------------------------
--------------------------------------------------------------------------------------------------------------------------------------------------------------------------------------------------------
-----------------------------------------------------------------------------------------------------------#--#-----------------------------------------------------------------------------------------
-------------------------------------------------------------------------SSSSS----------------------------##--##----------------------------------------------------------------------------------------
------------------------------------------------------Tt-------------------------------------------------###--###---------#---#-------------------------------------------------------------------------
------------------------------------------------------tt------------%%--------------#---#--------------%%%%%--%%%%%------##---##------------------------------------------------------------------------
-------------------%%%---%%%--------------------------tt----%%%--%%%||--yr---------##---##-------------|||||--|||||----%%%%---%%%%%%--%%----------------------------------------------------------------
%%%%%%%%%%---------|||---|||-------------%%%---%%%%%%%%%%%%%|||--|||||%%%%%%%%%%--###---###------------|||||--|||||----||||---||||||--||%%%%%%%%F%%%%%%%%%%%%%%%%%%%%%%%%%%%%%%%%%%%%%%%%%%%%%%%%%%%%%%%
||||||||||XXX---XXX|||---|||XXXXX---XXXXX|||---||||||||||||||||--|||||||||||||||XXXXX---XXXXXXXXX--XXXX|||||--|||||XXXX||||---||||||--||||||||||X|||||||||||||||||||||||||||||||||||||||||||||||||||||||
