HEIGHT=16;WIDTH=201;THEME=0;OVERRIDE=false
--------------------------------------------------------------------------------------------------------------------------------------------------------------------------------------------------------
--------------------------------------------------------------------------------------------------------------------------------------------------------------------------------------------------------
--------------------------------------------------------------------------------------------------------------------------------------------------------------------------------------------------------
--------------------------------------------------------------------------------------------------------------------------------------------------------------------------------------------------------
--------------------------------------------------------------------------------------------------------------------------------------------------------------------------------------------------------
--------------------------------------------------------------------------------------------------------------------------------------------------------------------------------------------------------
--------------------------------------------------------------------------------------------------------------------------------------------------------------------------------------------------------
--------------------------------------------------------------------------------------------------------------------------------------------------------------------------------------------------------
--------------------------------------------------------------------------------------------------------------------------------------------------------------------------------------------------------
--------------------------------------------------------------------------------------------------------------------------------------------------------------------------------------------------------
--------------------------------------------------------------------------------------------------------------------------------------------------------------------------------------------------------
--------------------------------------------------------------------------------------------------------------------------------------------------------------------------------------------------------
------------%%%---%%%--#--#----------%%%--------%%-----------------------------------%%%%--%%%%--------------------------------------%%--%%-------------------------------------------------------------
------------|||---|||%%%--%%%--------|||--------||%%%%%%---%%------------------------||||--||||-----------------------%%%--%%%-------||--||-------------------------------------------------------------
%%%%%%%%%%%%|||---||||||--|||--------|||--#--#--||||||||---||-------------%%%%---%%%%||||--||||%%%%%--%%%%%%%%%---%%%%|||--|||%%---%%||--||-------------------------------------------------------------
|||||||||||||||---||||||--|||XXX--XXX|||XXX--XXX||||||||---||XXXXX---XXXXX||||---||||||||--|||||||||--|||||||||---|||||||--|||||---||||--||XXXXXXXXFXXXXXXXXXXXXXXXXXXXXXXXXXXXXXXXXXXXXXXXXXXXXXXXXXXXX
