HEIGHT=16;WIDTH=201;THEME=0;OVERRIDE=false
--------------------------------------------------------------------------------------------------------------------------------------------------------------------------------------------------------
--------------------------------------------------------------------------------------------------------------------------------------------------------------------------------------------------------
--------------------------------------------------------------------------------------------------------------------------------------------------------------------------------------------------------
--------------------------------------------------------------------------------------------------------------------------------------------------------------------------------------------------------
--------------------------------------------------------------------------------------------------------------------------------------------------------------------------------------------------------
------------------------------%%%%%%%-------------------------------------------------------------------------------------------------------------------------------------------------------------------
------------------------------|||||||-------------------------------------------------------------------------------------------------------------------------------------------------------------------
------------------------------|||||||-------------------------------------------------------------------------------------------------------------------------------------------------------------------
----------------------------%%%%|||||-------------------------------------------------------------------------------------------------------------------------------------------------------------------
----------------------------|||||||||-------------------------------------------------------------------------------------------------------------------------------------------------------------------
----------------------------||||||||%%%-----------------------------------------------------------------------------------------------------------------------------------------------------------------
----------------------------|||||||||||-----------------------------------------------------------------------------------------------------------------------------------------------------------------
----------------------------||r||y|||||gk-%%%%%%%%%%---%%%%%---#--#---%%%%%%%%%%---%%%%%%%%%---------------------------------%%%%%%%--------------------------------------------------------------------
%%%%%%%%%%%------------%%%%%%%%%%%%%%%%%%%||||||||||---|||||--##--##--||||||||||---|||||||||%%%%---%%%%%%%---%%%%%%%%---%%%%%|||||||%%%--%%%%%%%%%%%F%%%%%%%%%%%%%%%%%%%%%%%%%%%%%%%%%%%%%%%%%%%%%%%%%%%
|||||||||||------------|||||||||||||||||||||||||||||---|||||%%%%--%%%%||||||||||---|||||||||||||---|||||||---||||||||---|||||||||||||||--|||||||||||%|||||||||||||||||||||||||||||||||||||||||||||||||||
|||||||||||XXXXX--XXXXX|||||||||||||||||||||||||||||---|||||||||--||||||||||||||---|||||||||||||---|||||||---||||||||---|||||||||||||||--|||||||||||||||||||||||||||||||||||||||||||||||||||||||||||||||
