HEIGHT=16;WIDTH=201;THEME=0;OVERRIDE=false
--------------------------------------------------------------------------------------------------------------------------------------------------------------------------------------------------------
--------------------------------------------------------------------------------------------------------------------------------------------------------------------------------------------------------
--------------------------------------------------------------------------------------------------------------------------------------------------------------------------------------------------------
--------------------------------------------------------------------------------------------------------------------------------------------------------------------------------------------------------
--------------------------------------------------------------------------------------------------------------------------------------------------------------------------------------------------------
--------------------------------------------------------------------------------------------------------------------------------------------------------------------------------------------------------
--------------------------------------------------------------------------------------------------------------------------------------------------------------------------------------------------------
--------------------------------------------------------------------------------------------------------------------------------------------------------------------------------------------------------
------------------------------------------------------------------------------------SCCCSC--------------------------------------------------------------------------------------------------------------
-------------------------------------------------------------------------------------------------------------------CSC----------------------------------------------------------------------------------
--------------------------------------------------------------------------------------------------------------------------------tt----------------------------------------------------------------------
--------------------------------tt---------------------------------------------r-------y----------------------------------------tt----%%%%%%%-----------------------------------------------------------
-------------%%%---%%%----------tt-tt---------------------%%%--%%%-------%%%%%%%%%%%%%%%%%%%%%%%-------------------r------------tt----|||||y|-----------------------------------------------------------
-------------|||---|||--#---#---tt-tt---------------------|||--|||-------|||||||||||||||||||||||-------%%%---%%%%%%%%%%%%--g-k-%%%%%%%%%%%%%%%%%%%%%%%--------------------------------------------------
%%%%%%%%%%%%%|||---|||%%%---%%%%%%%%%%%-------%%%%%--%%%%%|||--|||-------|||||||||||||||||||||||%%---%%|||---||||||||||||%%%%%%|||||||||||||||||||||||--------------------------------------------------
||||||||||||||||---||||||---|||||||||||XX---XX|||||--||||||||--|||XXXXXXX|||||||||||||||||||||||||---|||||---|||||||||||||||||||||||||||||||||||||||||XXXXXXXXFXXXXXXXXXXXXXXXXXXXXXXXXXXXXXXXXXXXXXXXXX
