HEIGHT=16;WIDTH=201;THEME=0;OVERRIDE=false
--------------------------------------------------------------------------------------------------------------------------------------------------------------------------------------------------------
--------------------------------------------------------------------------------------------------------------------------------------------------------------------------------------------------------
--------------------------------------------------------------------------------------------------------------------------------------------------------------------------------------------------------
--------------------------------------------------------------------------------------------------------------------------------------------------------------------------------------------------------
--------------------------------------------------------------------------------------------------------------------------------------------------------------------------------------------------------
-----------------%%%%-----------------------------------------------------------------------------------------------------------------------------------------------------------------------------------
-----------------||||-----------------------------------------------------------------------------------------------------------------------------------------------------------------------------------
-----------------||||----------------y---y--------------------------------------------------------------------------------------------------------------------------------------------------------------
-----------------||||y---------------%%%%%%%------------------------------------------------------------------------------------------------------------------------------------------------------------
-----------------|%%%%%--------------|||||||---------------------------------------------------------------------tt-------------------------------------------------------------------------------------
-----------------||||||--------------|||||||---------------------------------------------------------------------tt--Tt---------------------------------------------------------------------------------
--------------%%%%%%|||------g-K-r---|||||||----------------#--#-------------------------------------------------tt--tt---------------------------------------------------------------------------------
--------------|||||||||---%%%%%%%%%--||||||%%%-------------##--##------------%%%%%%%--------------------------%%%%%%%%%%---------%%%%--%%%%-------------------------------------------------------------
--------------|||||||||---|||||||||--|||||||||------------###--###--%%%---%%%|||||||%%%%%---------------------||||||||||%%%---%%%||||--||||-------------------------------------------------------------
--------------|||y|||k|---|||||||||--|||||||g|--%%%%--%%%%%%%--%%%%%|||---|||||||||||||||---------------------|||||||||||||---|||||||--||||%%%%%%%%F%%%%%%%%%%%%%%%%%%%%%%%%%%%%%%%%%%%%%%%%%%%%%%%%%%%%
XXXXXXXXXXXXXXXXXXXXXXXXXX|||||||||XXXXXXXXXXXXX||||--|||||||--||||||||---|||||||||||||||XX--XXXXX--XXXXXXXXXX|||||||||||||---|||||||--||||||||||||X||||||||||||||||||||||||||||||||||||||||||||||||||||
