HEIGHT=16;WIDTH=201;THEME=0;OVERRIDE=false
--------------------------------------------------------------------------------------------------------------------------------------------------------------------------------------------------------
--------------------------------------------------------------------------------------------------------------------------------------------------------------------------------------------------------
--------------------------------------------------------------------------------------------------------------------------------------------------------------------------------------------------------
--------------------------------------------------------------------------------------------------------------------------------------------------------------------------------------------------------
--------------------------------------------------------------------------------------------------------------------------------------------------------------------------------------------------------
--------------------------------------------------------------------------------------------------------------------------------------------------------------------------------------------------------
--------------------------------------------------------------------------------------------------------------------------------------------------------------------------------------------------------
----------------------------------------K--g------------------------------------------------------------------------------------------------------------------------------------------------------------
----------------------------------------%%%%------------------------------------------------------------------------------------------------------------------------------------------------------------
----------------------------------------||||------------------------------y------------k-k-------------------------gyr----------------------------------------------------------------------------------
----------------------------#---#-------||||--------------------------%%%%%%---------%%%%%-------------------------%%%----------------------------------------------------------------------------------
---------------------------##---##------g|||--------------------------||||||---------g||||K------------------------|||----------------------------------------------------------------------------------
--------------------------###---###--%%%%%%%%%%%%%--------%%--%%------||||||----%%%%%%%%%%%%%-------------%%%%%%-y-|||g--rk-----------------------------------------------------------------------------
------------%%%%%--%%%%%%%%%%---%%%%%|||||||||||||--------||--||---gy-||||||-y--|||||||||||||%%--%%-------||||||%%%%%%%%%%%%%%%%%-----------------------------------------------------------------------
%%%%%%%%%%%%|||||--||||||||||---||||||||||||||||||%%%--%%%||--||%%%%%%%%%%%%%%%%|||||||||||||||--||-------|||||||||||||||||||||||-----------------------------------------------------------------------
|||||||||||||||||--||||||||||---|||||||||||||||||||||--|||||--|||||||||||||||||||||||||||||||||--||XXXXXXX|||||||||||||||||||||||XX---XXXXXXXXXXFXXXXXXXXXXXXXXXXXXXXXXXXXXXXXXXXXXXXXXXXXXXXXXXXXXXXXXX
