HEIGHT=16;WIDTH=201;THEME=0;OVERRIDE=false
--------------------------------------------------------------------------------------------------------------------------------------------------------------------------------------------------------
--------------------------------------------------------------------------------------------------------------------------------------------------------------------------------------------------------
--------------------------------------------------------------------------------------------------------------------------------------------------------------------------------------------------------
--------------------------------------------------------------------------------------------------------------------------------------------------------------------------------------------------------
--------------------------------------------------------------------------------------------------------------------------------------------------------------------------------------------------------
--------------------------------------------------------------------------------------------------------------------------------------------------------------------------------------------------------
--------------------------------------------------------------------------------------------------------------------------------------------------------------------------------------------------------
--------------------------------------------------------------------------------------------------------------------------------------------------------------------------------------------------------
--------------------------------------------------------------------------------------------------------------------------------------------------------------------------------------------------------
---------------%%%%-------------------------------------------------------------------------------------------------------------------------------------------------------------------------------------
---------------||||-------------------------------------------------------------------------------------------------------------------------------------------------------------------------------------
---------------||||-----------------------------------------------------------------------------------------#--#----SSSSS----#--#-----------------------------------------------------------------------
---------------||||--ky-%%%%%%%%%%%%%-------------%%%%%--%%%%%%%%%%---%%%%%---Tt------------%%%%%---%%%%%--##--##-----------##--##----------------------------------------------------------------------
%%%%%%%%%%%%%%%%%%%%%%%%|||||||||||||-------%%--%%|||||--||||||||||---|||||---tt------------|||||---|||||%%%%--%%%%-------%%%%--%%%%%%%%%---%%%%%-------------------------------------------------------
|||||||||||||||||||||||||||||||||||||%%%%%%%||--|||||||--||||||||||---|||||---tt-----%%---%%|||||---|||||||||--||||-------||||--|||||||||---|||||%%%%%%%%F%%%%%%%%%%%%%%%%%%%%%%%%%%%%%%%%%%%%%%%%%%%%%%
||||||||||||||||||||||||||||||||||||||||||||||--|||||||--||||||||||---|||||XXXXXXXXXX||---|||||||---|||||||||--||||XXXXXXX||||--|||||||||---|||||||||||||X||||||||||||||||||||||||||||||||||||||||||||||
