HEIGHT=16;WIDTH=201;THEME=0;OVERRIDE=false
--------------------------------------------------------------------------------------------------------------------------------------------------------------------------------------------------------
--------------------------------------------------------------------------------------------------------------------------------------------------------------------------------------------------------
--------------------------------------------------------------------------------------------------------------------------------------------------------------------------------------------------------
--------------------------------------------------------------------------------------------------------------------------------------------------------------------------------------------------------
--------------------------------------------------------k-----------------------------------------------------------------------------------------------------------------------------------------------
-----------------------------------------------------%%%%-----------------------------------------------------------------------------------------------------------------------------------------------
-----------------------------------------------------||||-----------------------------------------------------------------------------------------------------------------------------------------------
-----------------------------------------------------||||-----------------------------------------------------------------------------------------------------------------------------------------------
----------------------------------------------r-k----||||-----------------------------------------------------------------------------------------------------------------------------------------------
----------------------------------#---#-----%%%%%%%--||||------------------------------------%%%%%%%----------------------r-----------------------------------------------------------------------------
---------------------------------##---##----|||||||--||||------------------------------------|||||||--------------------%%%-----------------------------------------------------------------------------
--------------------------------###---###---|||||||--||||---------------------------SCS2S----|||||||--------------------|||-----------------------------------------------------------------------------
-----------%%%%%--%%%%%-------%%%%%---%%%%%-g||||||--y||r--%%%%%---%%%%%-%%%%%%%------------%%%%%%%%%%%-----------------Y||-----------------------------------------------------------------------------
-----------|||||--|||||-------|||||---|||||%%%%%%%%%%%%%%%%|||||---|||||-|||||||------------|||||||||||---#---#-------%%%%%%%---------------------------------------------------------------------------
-----------|||||--|||||%%---%%|||||---||||||||||||||||||||||||||---|||||-||kg|K|-----g------|||||||||||--##---##------|r|||||--k--------%%%%%%%%F%%%%%%%%%%%%%%%%%%%%%%%%%%%%%%%%%%%%%%%%%%%%%%%%%%%%%%%
XXXXXXXXXXX|||||--|||||||---|||||||---||||||||||||||||||||||||||---|||||XXXXXXXXXXXXXXXXXXXX|||||||||||XXXX---XXXXXXXXXXXXXXXXXXXXX---XX||||||||X|||||||||||||||||||||||||||||||||||||||||||||||||||||||
