HEIGHT=16;WIDTH=201;THEME=0;OVERRIDE=false
--------------------------------------------------------------------------------------------------------------------------------------------------------------------------------------------------------
--------------------------------------------------------------------------------------------------------------------------------------------------------------------------------------------------------
--------------------------------------------------------------------------------------------------------------------------------------------------------------------------------------------------------
--------------------------------------------------------------------------------------------------------------------------------------------------------------------------------------------------------
--------------------------------------------------------------------------------------------------------------------------------------------------------------------------------------------------------
--------------------------------------------------------------------------------------------------------------------------------------------------------------------------------------------------------
--------------------------------------------------------------------------------------------------------------------------------------------------------------------------------------------------------
--------------------------------------------------------------------------------------------------------------------------------------------------------------------------------------------------------
--------------------------------------------------------------------------------------------------------------------------------------------------------------------------------------------------------
--------------------------------------------------------------------------------------------------------------------------------------------------------------------------------------------------------
--------------------------------------------------------------------------------------------------------------------------------------------------------------------------------------------------------
--------------Tt----------------------------------------------------------------------------------------------------------------------------------------------------------------------------------------
%%%%%%%%%%----tt----%%%%%---%%%%%%%---%%-----------------------------------------%%%---%%%--------------------------------------------------------------------------------------------------------------
||||||||||%%%%%%%%%%|||||---|||||||---||------------%%%%-------------------------|||---|||------------------------%%%---%%%-----------%%%%%-------------------------------------------------------------
|||||||||||||||||||||||||---|||||||---||%%%%%--%%%%%||||--#---#--%%%%--%%%%------|||---|||%%%%---%%%%%%%%%---%%%%%|||---|||--#---#--%%|||||%%%%%%%%F%%%%%%%%%%%%%%%%%%%%%%%%%%%%%%%%%%%%%%%%%%%%%%%%%%%%
|||||||||||||||||||||||||---|||||||---|||||||--|||||||||XXX---XXX||||--||||XX--XX|||---|||||||---|||||||||---||||||||---|||XXX---XXX|||||||||||||||X||||||||||||||||||||||||||||||||||||||||||||||||||||
