HEIGHT=16;WIDTH=201;THEME=0;OVERRIDE=false
--------------------------------------------------------------------------------------------------------------------------------------------------------------------------------------------------------
--------------------------------------------------------------------------------------------------------------------------------------------------------------------------------------------------------
--------------------------------------------------------------------------------------------------------------------------------------------------------------------------------------------------------
--------------------------------------------------------------------------------------------------------------------------------------------------------------------------------------------------------
--------------------------------------------------------------------------------------------------------------------------------------------------------------------------------------------------------
--------------------------------------------------------------------------------------------------------------------------------------------------------------------------------------------------------
-------------------------------------------------------------------------------------------------y------------------------------------------------------------------------------------------------------
----------------------------------------------------------------------------------------------%%%%%%%---------------------------------------------------------------------------------------------------
----------------------------------------------------------------------------------------------|||||||---------------------------------------------------------------------------------------------------
---------------------------------------------------------SCSSCS-------------------------------|||||||---------------------------------------------------------------------------------------------------
-----------------------------------------------------------------------------------------%%%%%%%|||||---------------------------------------------------------------------------------------------------
-----------------------------------------------------------------------------------------||||||||||||-----------------------------#---#-----------------------------------------------------------------
-----------------------------------------------------------kk----------------------------||||||||||||----------------------------##---##---%%%%%%%%F%%%%%%%%%%%%%%%%%%%%%%%%%%%%%%%%%%%%%%%%%%%%%%%%%%%%
%%%%%%%%%%%%%%------------------------------------------%%%%%%%%----------#--#---%%--%%--|||||||||r||---------------------------###---###--||||||||%||||||||||||||||||||||||||||||||||||||||||||||||||||
||||||||||||||----------------------#--#--%%%%---%%%%%%%||||||||---------##--##--||--||%%%%%%%%%%%%%%%%%------------%%%%--%%%%%%%%%---%%%%%|||||||||||||||||||||||||||||||||||||||||||||||||||||||||||||
||||||||||||||XXXXX---XXXXXXXXXXXXXXX--XXX||||---|||||||||||||||XX---XXXXXX--XXXX||--|||||||||||||||||||XXXXX--XXXXX||||--|||||||||---||||||||||||||||||||||||||||||||||||||||||||||||||||||||||||||||||
