HEIGHT=16;WIDTH=201;THEME=0;OVERRIDE=false
--------------------------------------------------------------------------------------------------------------------------------------------------------------------------------------------------------
--------------------------------------------------------------------------------------------------------------------------------------------------------------------------------------------------------
--------------------------------------------------------------------------------------------------------------------------------------------------------------------------------------------------------
--------------------------------------------------------------------------------------------------------------------------------------------------------------------------------------------------------
--------------------------------------------------------------------------------------------------------------------------------------------------------------------------------------------------------
--------------------------------------------------------------------------------------------------------------------------------------------------------------------------------------------------------
--------------------------------------------------------------------------------------------------------------------------------------------------------------------------------------------------------
--------------------------------------------------------------------------------------------------------------------------------------------------------------------------------------------------------
------------------------------CCS2S---------------------------------------------------------------------------------------------------------------------------------------------------------------------
---------------2SS------2S2-----------------------------------------------------------------------------------------------------------------------------------------------------------------------------
-------------------------------------------------------------------------------------CSS----------------------------------------------------------------------------------------------------------------
----------------------------------g---------------------------------------------------------S-SSS-------------------------------------------------------------------------------------------------------
---------------g------------%%%%%%%%%---------------------------------------------------%---------------------------#--#--------------------------------------------------------------------------------
--------------%%%%%%%%%%%%%%|||||||||%%%%--#---#---------------%%%%---%%%%--------------|----%------------%%%%%%---##--##---%%---%%---------------------------------------------------------------------
%%%%%%%%%%%%%%|||||||||||||||||||||||||||%%%---%%%%%%%%---%%%%%||||---||||%%%--%%%%%%%%%%%---|------------||||||--###--###--||---||---%%%%%--%%%%%%%%%%%%%F%%%%%%%%%%%%%%%%%%%%%%%%%%%%%%%%%%%%%%%%%%%%%
||||||||||||||||||||||||||||||||||||||||||||---||||||||---|||||||||---|||||||--|||||||||||XXXXXXXXXXX---XX||||||XXXXX--XXXXX||---||XXX|||||--|||||||||||||X|||||||||||||||||||||||||||||||||||||||||||||
