HEIGHT=16;WIDTH=201;THEME=0;OVERRIDE=false
--------------------------------------------------------------------------------------------------------------------------------------------------------------------------------------------------------
--------------------------------------------------------------------------------------------------------------------------------------------------------------------------------------------------------
--------------------------------------------------------------------------------------------------------------------------------------------------------------------------------------------------------
--------------------------------------------------------------------------------------------------------------------------------------------------------------------------------------------------------
--------------------------------------------------------------------------------------------------------------------------------------------------------------------------------------------------------
--------------------------------------------------------------------------------------------------------------------------------------------------------------------------------------------------------
--------------------------------------------------------------------------------------------------------------------------------------------------------------------------------------------------------
--------------------------------------------------------------------------------------------------------------------------------------------------------------------------------------------------------
------------------------------------------------------------------------------------------------------%%%%------------------C2SS------------------------------------------------------------------------
------------------------------------------------------------------------------------------------------||||---------yy-----------------------------------------------------------------------------------
--------------------------------------------------------------------y---------------------------------||||-------%%%%-----------------------------------------------------------------------------------
--------------------------------------------------------------------%%%%----------------------#---#---|g||----g-r||||-----------------------------------------------------------------------------------
---------------------------------%%%%------------------------%%--%%-||||--------------------%%%---%%%%%%%%%%%%%%%%%%%%%%%%%%%%%%%----%%%%%%-------------------------------------------------------------
---------------------------------||||%%%%---%%%%-------------||--||-|||%%%%%%%--------------|||---|||||||||||||||||||||||||||||||%%%%||||||%%%%%%%%F%%%%%%%%%%%%%%%%%%%%%%%%%%%%%%%%%%%%%%%%%%%%%%%%%%%%
-------------%%%%---%%%%---------||||||||---||||--#---#------||--||-||||||||r|--%%%%%--%%%%%|||---|||||||||||||||||||||||||||||||||||||||||||||||||%||||||||||||||||||||||||||||||||||||||||||||||||||||
XXXXXXXXXXXXX||||---||||XXX---XXX||||||||---||||XXX---XXXXXXX||--||XXXXXXXXXXXXX|||||--||||||||---||||||||||||||||||||||||||||||||||||||||||||||||||||||||||||||||||||||||||||||||||||||||||||||||||||||
