HEIGHT=16;WIDTH=201;THEME=0;OVERRIDE=false
--------------------------------------------------------------------------------------------------------------------------------------------------------------------------------------------------------
--------------------------------------------------------------------------------------------------------------------------------------------------------------------------------------------------------
--------------------------------------------------------------------------------------------------------------------------------------------------------------------------------------------------------
--------------------------------------------------------------------------------------------------------------------------------------------------------------------------------------------------------
--------------------------------------------------------------------------------------------------------------------------------------------------------------------------------------------------------
--------------------------------------------------------------------------------------------------------------------------------------------------------------------------------------------------------
--------------------------------------------------------------------------------------------------------------------------------------------------------------------------------------------------------
--------------------------------------------------------------------------------------------------------------------------------------------------------------------------------------------------------
--------------------------------------------------------------------------------------------------------------------------------------------------------------------------------------------------------
--------------------------------------------------------------------------------------------------------------------------------------------------------------------------------------------------------
------------------------------------------SSS-----------------------------------------------------------------------------------------------------------------------------------------------------------
--------------------------------------------------------------------------------------------------------------------------------------------------------------------------------------------------------
%%%%%%%%%%%%----------#--#---%%%%%%%%%-----------------------------%%%-----------------%%%%-----------------------------%%%%%---------------------------------------------------------------------------
||||||||||||---------##--##--|||||||||----------%%%--%%%-----------|||---#--#----------||||-----------------------------|||||%%%%%---%%%%%--------------------------------------------------------------
||||||||||||%%%%%%%%%%%--%%%%|||||||||%%%%%%%%%%|||--|||%%%%---%%%%|||--##--##--%%%%%%%%%%%%%%%%%%%---%%%%%-------------||||||||||---|||||--------------------------------------------------------------
|||||||||||||||||||||||--||||||||||||||||||||||||||--|||||||---|||||||XXXX--XXXX|||||||||||||||||||---|||||XXXXX---XXXXX||||||||||---|||||XXXXXXXXFXXXXXXXXXXXXXXXXXXXXXXXXXXXXXXXXXXXXXXXXXXXXXXXXXXXXX
