HEIGHT=16;WIDTH=201;THEME=0;OVERRIDE=false
--------------------------------------------------------------------------------------------------------------------------------------------------------------------------------------------------------
--------------------------------------------------------------------------------------------------------------------------------------------------------------------------------------------------------
--------------------------------------------------------------------------------------------------------------------------------------------------------------------------------------------------------
--------------------------------------------------------------------------------------------------------------------------------------------------------------------------------------------------------
--------------------------------------------------------------------------------------------------------------------------------------------------------------------------------------------------------
--------------%%%%%----------------------------------------------------------------------------------------------------------------USSS-----------------------------------------------------------------
--------------|||||-------------------------------------------------------------------------------------------------------------------------------------------------------------------------------------
--------------|||||-------------------------------------------------------------------------------------------------------------------------------------------------------------------------------------
--------------|r|||-g-------------------------------------------------------------------------------------------------------------------r---------------------------------------------------------------
--------------|%%%%%%--------------2CC2---------SS2USS----------------------------------------------------------------------------%%%%%%%---------------------------------------------------------------
--------------|||||||-------------------------------------------------------------------------------------------------------------|||||||---------------------------------------------------------------
--------------|||||||-------------%-----------------------------------------------------------------------------------------------|||||||---------------------------------------------------------------
%%%%%%%%%%%%%-||yy|||-------------|-kr---------------g----------------------------%%%%%--%%%%%-%%%%%%-----%%%%%--%%%%%------------|||||||---------------------------------------------------------------
|||||||||||||%%%%%%%%%%%%%%%%%%%%%%%%%%%-------%%%%%%%%%%%%%%%--%%%%--------------|||||--|||||-||||||-----|||||--|||||%%%---%%%%%%%%%%%%%%%-------------------------------------------------------------
||||||||||||||||||||||||||||||||||||||||-------|||||||||||||||--||||%%%%%%%-----y-|||||--|||||-||r|||-----|||||--||||||||---|||||||||||||||-------------------------------------------------------------
||||||||||||||||||||||||||||||||||||||||XX---XX|||||||||||||||--|||||||||||XXXXXXX|||||--|||||XXXXXXXXXXXX|||||--||||||||---|||||||||||||||XXXXXXXXFXXXXXXXXXXXXXXXXXXXXXXXXXXXXXXXXXXXXXXXXXXXXXXXXXXXX
