HEIGHT=16;WIDTH=201;THEME=0;OVERRIDE=false
--------------------------------------------------------------------------------------------------------------------------------------------------------------------------------------------------------
--------------------------------------------------------------------------------------------------------------------------------------------------------------------------------------------------------
--------------------------------------------------------------------------------------------------------------------------------------------------------------------------------------------------------
--------------------------------------------------------------------------------------------------------------------------------------------------------------------------------------------------------
--------------------------------------------------------------------------------------------------------------------------------------------------------------------------------------------------------
--------------------------------------------------------------------------------------------------------------------------------------------------------------------------------------------------------
--------------------------------------------------------------------------------------------------------------------------------------------------------------------------------------------------------
--------------------------------------------------------------------------------------------------------------------------------------------------------------------------------------------------------
----------------------CSC--------------------k----------------------------------------------------------------------------------------------------------------------------------------------------------
-------------------------------------------%%%----------------------------------------------------------------------------------------------------------------------------------------------------------
-------------------------------------------|||----------------------------------------------------------------------------------------------------------------------------------------------------------
-------------------y--y--------------------|||----------------------------------------------------------------------------------------------------------------------------------------------------------
%%%%%%%%%%%----tt-%%%%%%%%%%%--------------r||-------------%%%%%---%%%%%-------------%%%%%---%%%%%%%%%---%%%%-------------%%%%%%%------%%--%%%%%%%%%%F%%%%%%%%%%%%%%%%%%%%%%%%%%%%%%%%%%%%%%%%%%%%%%%%%%
|||||||||||----tt-|||||||||||----------%%%%%%%%%%%---------|||||---|||||-------------|||||---|||||||||---||||-------------|||||||------||--||||||||||%||||||||||||||||||||||||||||||||||||||||||||||||||
|||||||||||----tt-|||||||||||----------|||||||||||%%%---%%%|||||---|||||-------------|||||---|||||||||---||||%%%%%---%%%%%|||||||---g--||--|||||||||||||||||||||||||||||||||||||||||||||||||||||||||||||
|||||||||||XXXXXXX|||||||||||XX---XXXXX||||||||||||||---||||||||---|||||XXXXX---XXXXX|||||---|||||||||---|||||||||---||||||||||||XXXXXX||--|||||||||||||||||||||||||||||||||||||||||||||||||||||||||||||
