HEIGHT=16;WIDTH=201;THEME=0;OVERRIDE=false
--------------------------------------------------------------------------------------------------------------------------------------------------------------------------------------------------------
--------------------------------------------------------------------------------------------------------------------------------------------------------------------------------------------------------
--------------------------------------------------------------------------------------------------------------------------------------------------------------------------------------------------------
--------------------------------------------------------------------------------------------------------------------------------------------------------------------------------------------------------
--------------------------------------------------------------------------------------------------------------------------------------------------------------------------------------------------------
--------------------------------------------------------------------------------------------------------------------------------------------------------------------------------------------------------
------------------------------------------------------------------------------------------------------SCS-----------------------------------------------------------------------------------------------
--------------------------------------------------------------------------------------------------------------------------------------------------------------------------------------------------------
--------------------------------------------------------------------------------------------------------------------------------------------------------------------------------------------------------
----------------------------------------------SCC2-CS-------------------------------------------------gr------------------------------------------------------------------------------------------------
-------------------#---#-----------------------------------------------------------r-r----------------%%%%%--------------------%%%%%%-------------------------------------------------------------------
------------------##---##-------------------------%------#--#----------------------%%%----------------|||||-----------tt-------||||k|-------------------------------------------------------------------
-----------------###---###--%%%%%%%%%%%%%--%%-----|-----##--##---------------------|||----------------|||||-----------tt---Tt-%%%%%%%%%%%%%%%%%%%F%%%%%%%%%%%%%%%%%%%%%%%%%%%%%%%%%%%%%%%%%%%%%%%%%%%%%%
---------------%%%%%---%%%%%|||||||||||||--||%%%%%%%%%%%%%--%%%%%%---%%--------%%%%%%%%%%%%%%%%%--k---|||||----%%%%%--tt---tt-|||||||||||||||||||%||||||||||||||||||||||||||||||||||||||||||||||||||||||
%%%%%%%%%%%%%%%|||||---||||||||||||||||||--|||||||||||||||--||||||---||--#--#--|||||||||||||||||%%%%%%%%%%%%%%%|||||%%%%%%%%%%||||||||||||||||||||||||||||||||||||||||||||||||||||||||||||||||||||||||||
||||||||||||||||||||---||||||||||||||||||--|||||||||||||||--||||||---||XXX--XXX|||||||||||||||||||||||||||||||||||||||||||||||||||||||||||||||||||||||||||||||||||||||||||||||||||||||||||||||||||||||||
