HEIGHT=16;WIDTH=201;THEME=0;OVERRIDE=false
--------------------------------------------------------------------------------------------------------------------------------------------------------------------------------------------------------
--------------------------------------------------------------------------------------------------------------------------------------------------------------------------------------------------------
--------------------------------------------------------------------------------------------------------------------------------------------------------------------------------------------------------
--------------------------------------------------------------------------------------------------------------------------------------------------------------------------------------------------------
--------------------------------------------------------------------------------------------------------------------------------------------------------------------------------------------------------
--------------------------------------------------------------------------------------------------------------------------------------------------------------------------------------------------------
--------------------------------------------------------------------------------------------------------------------------------------------------------------------------------------------------------
--------------------------------------------------------------------------------------------------------------------------------------------------------------------------------------------------------
--------------------------------------------------------------------------------------------------------------------------------------------------------------------------------------------------------
---------------------------------------------------------------------------------------------------------------------tt-------Tt-Tt---------------------------------------------------------------------
-----------------SUSSC2----------------------------------------------------------------------------------------------tt-------tt-tt---------------------------------------------------------------------
-----------------------------------------------------------------------------Tt--------------------------------------tt-------tt-tt---------------------------------------------------------------------
-----------------------------------------#--#----------------------%%%%%%----tt---%%--%%%%---%%----------%%%%---%%%%%%%%%%%%%%%%%%%%---------%%%%%%%%F%%%%%%%%%%%%%%%%%%%%%%%%%%%%%%%%%%%%%%%%%%%%%%%%%%
--------------------------%%%%%%--------##--##---------------------||||||%%%%%%%%%||--||||---||----------||||---||||||||||||||||||||%%%---%%%||||||||%||||||||||||||||||||||||||||||||||||||||||||||||||
--------------%%%%%%%%%%%%||||||%%--%%%%%%--%%%%-------------------|||||||||||||||||--||||---||%%%%--%%%%||||---|||||||||||||||||||||||---||||||||||||||||||||||||||||||||||||||||||||||||||||||||||||||
XXXXXXXXXXXXXX||||||||||||||||||||--||||||--||||XXX--XXXXXXX---XXXX|||||||||||||||||--||||---||||||--||||||||---|||||||||||||||||||||||---||||||||||||||||||||||||||||||||||||||||||||||||||||||||||||||
