HEIGHT=16;WIDTH=201;THEME=0;OVERRIDE=false
--------------------------------------------------------------------------------------------------------------------------------------------------------------------------------------------------------
--------------------------------------------------------------------------------------------------------------------------------------------------------------------------------------------------------
--------------------------------------------------------------------------------------------------------------------------------------------------------------------------------------------------------
-------------------------------------------------------------------------------------------------------------------k------------------------------------------------------------------------------------
--------------------------------------------------------------------------------------------------------------%%%%%%------------------------------------------------------------------------------------
--------------------------------------------------------------------------------------------------------------||||||------------------------------------------------------------------------------------
--------------------------------------------------------------------------------------------------------------||||||------------------------------------------------------------------------------------
--------------------------------------------------------------------------------------------------------------||||||------------------------------------------------------------------------------------
----------------------------------------------------------------------------------------------------------%%%%%%||||------------------------------------------------------------------------------------
------------------------------------------------------SCCSCCS-------------------------------Tt------------||||||||||------------------------------------------------------------------------------------
---------------------------------------------------------------tt-Tt------------------------tt------------||||||||||------------------------------------------------------------------------------------
---------------------------------------------------------------tt-tt--2SSS2CSSS-------------tt------------||||||||||-k----------------------------------------------------------------------------------
---------------------%%%%--%%%%-------------------------------%%%%%%%-----------%%--------%%%%%%%--------%%%%%%%%%%%%%%---------------------------------------------------------------------------------
%%%%%%%%%%-----------||||--||||----------------------%%%%%%%%%|||||||-----------||--------|||||||---tt---||||||||||||||----------------------------%%%%%%%%F%%%%%%%%%%%%%%%%%%%%%%%%%%%%%%%%%%%%%%%%%%%%
||||||||||-----------||||--||||%%%%%------%%%%---%%%%||||||||||||||||----g------||%%%%%%%%|||||||---tt---||||||||||||||-----------%%%%%%%%%---%%%%%||||||||%||||||||||||||||||||||||||||||||||||||||||||
||||||||||XXXXXXXXXXX||||--|||||||||XX--XX||||---||||||||||||||||||||XXXXXXXXXXX|||||||||||||||||XXXXXXXX||||||||||||||XXXX---XXXX|||||||||---||||||||||||||||||||||||||||||||||||||||||||||||||||||||||
