HEIGHT=16;WIDTH=201;THEME=0;OVERRIDE=false
--------------------------------------------------------------------------------------------------------------------------------------------------------------------------------------------------------
--------------------------------------------------------------------------------------------------------------------------------------------------------------------------------------------------------
--------------------------------------------------------------------------------------------------------------------------------------------------------------------------------------------------------
--------------------------------------------------------------------------------------------------------------------------------------------------------------------------------------------------------
--------------------------------------------------------------------------------------------------------------------------------------------------------------------------------------------------------
--------------------------------------------------------------------------------------------------------------------------------------------------------------------------------------------------------
--------------------------------------------------------------------------------------------------------------------------------------------------------------------------------------------------------
--------------------------------------------------------------------------------------------------------------------------------------------------------------------------------------------------------
-----------------------------------------------------------------------------------------------------------------------C-2C-----------------------------------------------------------------------------
--------------------------------------------------------------------------------------------------------------------------------------------------------------------------------------------------------
-------------------#---#------------------------------------------------------------------------------------------------%----------------Tt---Tt--------------------------------------------------------
------------------##---##--------------------------SSS-----#---#-------------------------------ry-----------------------|----------------tt---tt--------------------------------------------------------
----------------%%%%---%%%%-tt--%%---%%------------------%%%---%%%----------------%%%-------%%%%%%---#--#-----#--#--%%%%%%%%%%-----------tt---tt--------------------------------------------------------
%%%%%%%%%%------||||---||||-tt--||---||------------------|||---|||----------------|||%%---%%||||||--##--##--%%%--%%%||||||||||%%---%%%%%%%%%%%%%%%%%%%%%%%F%%%%%%%%%%%%%%%%%%%%%%%%%%%%%%%%%%%%%%%%%%%%%
||||||||||%%--%%||||---||||-tt--||---||%%%%%%%%----y-r-r-|||---|||%%---%%--#---#--|||||---||||||||%%%%--%%%%|||--|||||||||||||||---|||||||||||||||||||||||%|||||||||||||||||||||||||||||||||||||||||||||
||||||||||||--||||||---||||XXXXX||---||||||||||XXXXXXXXXX|||---|||||---||XXX---XXX|||||---||||||||||||--|||||||--|||||||||||||||---|||||||||||||||||||||||||||||||||||||||||||||||||||||||||||||||||||||
