HEIGHT=16;WIDTH=201;THEME=0;OVERRIDE=false
--------------------------------------------------------------------------------------------------------------------------------------------------------------------------------------------------------
--------------------------------------------------------------------------------------------------------------------------------------------------------------------------------------------------------
--------------------------------------------------------------------------------------------------------------------------------------------------------------------------------------------------------
--------------------------------------------------------------------------------------------------------------------------------------------------------------------------------------------------------
--------------------------------------------------------------------------------------------------------------------------------------------------------------------------------------------------------
--------------------------------------------------------------------------------------------------------------------------------------------------------------------------------------------------------
--------------------------------------------------------------------------------------------------------------------------------------------------------------------------------------------------------
--------------------------------------------------------------------------------------------------------------------------------------------------------------------------------------------------------
--------------------------------------------------------------------------------------------------------------------------------------------------------------------------------------------------------
---------------------------------------------------------------------------------------------------g-y--------------------------------------------------------------------------------------------------
---------------------------------------------------------------------------------------------------%%%--------------------------------------------------------------------------------------------------
-------------------------------#---#--------------#--#---------------------------------------------|||--------%%%---------------------------------------------------------------------------------------
%%%%%%%%%%%%%---%%------------##---##------------##--##--------------------------------------------|||--------|||-------------------%%%%%--%%%%%--------------------------------------------------------
|||||||||||||---||---%%%%%%%%%%%---%%%%%%---%%--###--###--------------------%%%%%%%%%%%%--%%%%%%%%%%%%%%%%%--y|||-k----r------------|||||--|||||--------------------------------------------------------
|||||||||||||---||---|||||||||||---||||||---||%%%%%--%%%%%%%%%%--%%%%%------||||||||||||--|||||||||||||||||%%%%%%%%%%%%%%%%%%%%%%%%%|||||--|||||%%%%%%%%F%%%%%%%%%%%%%%%%%%%%%%%%%%%%%%%%%%%%%%%%%%%%%%%
|||||||||||||---||XXX|||||||||||---||||||---|||||||--||||||||||--|||||XX--XX||||||||||||--|||||||||||||||||||||||||||||||||||||||||||||||--|||||||||||||X|||||||||||||||||||||||||||||||||||||||||||||||
