HEIGHT=16;WIDTH=201;THEME=0;OVERRIDE=false
--------------------------------------------------------------------------------------------------------------------------------------------------------------------------------------------------------
--------------------------------------------------------------------------------------------------------------------------------------------------------------------------------------------------------
--------------------------------------------------------------------------------------------------------------------------------------------------------------------------------------------------------
--------------------------------------------------------------------------------------------------------------------------------------------------------------------------------------------------------
--------------------------------------------------------------------------------------------------------------------------------------------------------------------------------------------------------
---------------------------------------------y----------------------------------------------------------------------------------------------------------------------------------------------------------
----------------------------------------%%%%%%%---------------------------------------------------------------------------------------------------------------------------------------------------------
----------------------------------------|||||||---------------------------------------------------------------------------------------------------------------------------------------------------------
----------------------------------------|||||||---------------------------------------------------------------------------------------------------------------------------------------------------------
----------------------------------------|||||||---------------------------------------------------------------------------------------------------------------------------------------------------------
------------------------------------%%%%%%|||||---------------------------------------------------------------------------------------------------------------------------------------------------------
----------------#---#---------------|||||||||||----------------------------------------------------------------------------------#--#-------------------------------------------------------------------
--------------%%%---%%%-------------|||k|||||||kg-----#--#------------------%%%%%--%%%%%----------------------------------------##--##------------------------------------------------------------------
--------------|||---|||------------%%%%%%%%%%%%%%%---##--##---------%%%--%%%|||||--|||||--#--#--------------------------------%%%%--%%%%----------------------------------------------------------------
--------------|||---|||%%%%%--%%%%%|||||||||||||||--###--###--%%--%%|||--||||||||--|||||%%%--%%%------------%%%%%---%%%%%-----||||--||||----------------------------------------------------------------
XXXXXXXXXXXXXX|||---||||||||--||||||||||||||||||||XXXXX--XXXXX||--|||||--||||||||--||||||||--|||XXXXX--XXXXX|||||---|||||XXXXX||||--||||XXXXXXXXFXXXXXXXXXXXXXXXXXXXXXXXXXXXXXXXXXXXXXXXXXXXXXXXXXXXXXXX
