HEIGHT=16;WIDTH=201;THEME=0;OVERRIDE=false
--------------------------------------------------------------------------------------------------------------------------------------------------------------------------------------------------------
--------------------------------------------------------------------------------------------------------------------------------------------------------------------------------------------------------
--------------------------------------------------------------------------------------------------------------------------------------------------------------------------------------------------------
--------------------------------------------------------------------------------------------------------------------------------------------------------------------------------------------------------
--------------------------------------------------------------------------------------------------------------------------------------------------------------------------------------------------------
-------------------------------------------------------------------------------------------------------------------------------------UUCCSS-------------------------------------------------------------
--------------------------------------------------------------------------------------------------------------------------------------------------------------------------------------------------------
--------------------------------------------------------------------------------------------------------------------------------------------------------------------------------------------------------
---------------------------------------------------------------------------------------------------------------------------------------k----------------------------------------------------------------
------------------tt------------------------------------------------------------------------------------------------kk--------------%%%%%%%-------------------------------------------------------------
------------------tt---tt-----------------------------------------------------y---------------------------------%%%%%%%-------------|||||||-------------------------------------------------------------
------------------tt---tt-------------------------------------------------%%%%%---------------------------------|||||||-------------|||||||-------------------------------------------------------------
--------------%%%%%%%%%%%%%----#--#----------%%%%%--%%%%%-----------------|||||------%%---%%--------------------||%%%%%%%-----------|||||||-------------------------------------------------------------
%%%%%%%%%%%%%%|||||||||||||---##--##---------|||||--|||||-----------------|||r|------||---||%%%--%%%------------|||||||||---------%%%%%%|||--%%%%%%%%F%%%%%%%%%%%%%%%%%%%%%%%%%%%%%%%%%%%%%%%%%%%%%%%%%%
|||||||||||||||||||||||||||--###--###--%%--%%|||||--|||||-------%%%%%%%%%%%%%%%%%%%%%||---|||||--|||--------%%%%%%%%%%%%%%%-------||yg|k||y--||||||||%||||||||||||||||||||||||||||||||||||||||||||||||||
|||||||||||||||||||||||||||XXXXX--XXXXX||--|||||||--|||||XX---XX|||||||||||||||||||||||---|||||--|||XXXXXXXX|||||||||||||||XXXXXXXXXXXXXXXXXX|||||||||||||||||||||||||||||||||||||||||||||||||||||||||||
