HEIGHT=16;WIDTH=201;THEME=0;OVERRIDE=false
--------------------------------------------------------------------------------------------------------------------------------------------------------------------------------------------------------
--------------------------------------------------------------------------------------------------------------------------------------------------------------------------------------------------------
--------------------------------------------------------------------------------------------------------------------------------------------------------------------------------------------------------
--------------------------------------------------------------------------------------------------------------------------------------------------------------------------------------------------------
--------------------------------------------------------------------------------------------------------------------------------------------------------------------------------------------------------
--------------------------------------------------------------------------------------------------------------------------------------------------------------------------------------------------------
--------------------------------------------------------------------------------------------------------------------------------------------------------------------------------------------------------
--------------------------------------------------------------------------------------------------------------------------------------------------------------------------------------------------------
--------------------------------------------------------------------------------------------------------------------------------------------------------------------------------------------------------
------------------------------------------SSUSCC--------------------------------------------------------------------------------------------------------------------------------------------------------
------------------------------------------------------CUC-----------------------------------------------------------------------------------------------------------------------------------------------
---------------------------------------------------------------tt-tt--------------------SUSSCS2S----CSS-------------------------------------------------------------------------------------------------
%%%%%%%%%%%%%---#--#-------------------------------------------tt-tt---------------------------------------tt--------%%%--%%%---------------------------------------------------------------------------
|||||||||||||--##--##-----------%%------%%%%%%%%%%-------------tt-tt-------#--#--%%--%%---------%----------tt--tt----|||--|||---------------------------------------------------------------------------
|||||||||||||%%%%--%%%%%%%---%%%||%%--%%||||||||||%%%%%%%%%%%%%%%%%%%%%%%%%%--%%%||--||---------|----------tt--tt----|||--|||---------------------------------------------------------------------------
|||||||||||||||||--|||||||---|||||||--||||||||||||||||||||||||||||||||||||||--|||||--||XXXXXXXXXXXXXXXXXXXXXXXXXXXXXX|||--|||XXXXX---XXXXXXXXXXXXXFXXXXXXXXXXXXXXXXXXXXXXXXXXXXXXXXXXXXXXXXXXXXXXXXXXXXX
