HEIGHT=16;WIDTH=201;THEME=0;OVERRIDE=false
--------------------------------------------------------------------------------------------------------------------------------------------------------------------------------------------------------
--------------------------------------------------------------------------------------------------------------------------------------------------------------------------------------------------------
--------------------------------------------------------------------------------------------------------------------------------------------------------------------------------------------------------
--------------------------------------------------------------------------------------------------------------------------------------------------------------------------------------------------------
--------------------------------------------------------------------------------------------------------------------------------------------------------------------------------------------------------
--------------------------------------------------------------------------------------------------------------------------------------------------------------------------------------------------------
--------------------------------------------------------------------------------------------------------------------------------------------------------------------------------------------------------
--------------------------------------------------------------------------------------------------------------------------------------------------------------------------------------------------------
--------------------------------------------------------------------------------------------------------------------------------------------------------------------------------------------------------
--------------------------------------------------------------------------------------------------------------------------------------------------------------------------------------------------------
-----------------------------------------------------------------------------------------------#--#----------------------tt-----------------------------------------------------------------------------
---------------------------------------------------------------------------#--#---------------##--##----------------tt---tt-----------------------------------------------------------------------------
----------------#---#--------------------------------%%--%%---------------##--##----%%------%%%%--%%%%%%--%%--------tt---tt-------------%%%%%%%%F%%%%%%%%%%%%%%%%%%%%%%%%%%%%%%%%%%%%%%%%%%%%%%%%%%%%%%%
%%%%%%%%%%%%%--##---##----------------------%%%%%--%%||--||-------------%%%%--%%%%--||------||||--||||||--||------%%%%%%%%%%--tt--Tt----||||||||%|||||||||||||||||||||||||||||||||||||||||||||||||||||||
|||||||||||||%%%%---%%%%%%---%%%%%%%---%%%%%|||||--||||--||---------%%%%||||--||||--||%%--%%||||--||||||--||%%--%%||||||||||--tt--tt----||||||||||||||||||||||||||||||||||||||||||||||||||||||||||||||||
|||||||||||||||||---||||||---|||||||---||||||||||--||||--||XXXXXXXXX||||||||--||||XX||||--||||||--||||||--||||--||||||||||||XXXXXXXXXXXX||||||||||||||||||||||||||||||||||||||||||||||||||||||||||||||||
