HEIGHT=16;WIDTH=201;THEME=0;OVERRIDE=false
--------------------------------------------------------------------------------------------------------------------------------------------------------------------------------------------------------
--------------------------------------------------------------------------------------------------------------------------------------------------------------------------------------------------------
--------------------------------------------------------------------------------------------------------------------------------------------------------------------------------------------------------
-------------------------------------r----y-------------------------------------------------------------------------------------------------------------------------------------------------------------
------------------------------------%%%%%%%-------------------------------------------------------------------------------------------------------------------------------------------------------------
-----------------------------------yY||||||-------------------------------------------------------------------------------------------------------------------------------------------------------------
----------------------------------%%%||||||-------------------------------------------------------------------------------------------------------------------------------------------------------------
----------------------------------|||||||||--------------C2C--------------------------------------------------------------------------------------------------------------------------------------------
----------------------------------|||||||||-------------------------------------------------------------------------------------------------------------------------------------------------------------
----------------------------------|||||||||-------------------------------------------------------------------------------------------------------------------------------------------------------------
--------------------------------%%%%%%%||||----------------Y--------------------------------------------------------------------------------------------------------------------------------------------
--------------------------------|||||||||||------------%%%%%%-------------------#---#-----------------------------------#--#----------------------------------------------------------------------------
--------------------%%%%--%%%%--r|||g||||||------------||||||------------------##---##---------------------------------##--##---------------------------------------------------------------------------
--------------------||||--||||%%%%%%%%%%%%%%%%%%%%-----||||||-----------------###---###----------------k-------------%%%%--%%%%-------------------------------------------------------------------------
------------%%%--%%%||||--||||||||||||||||||||||||-----||||||----%%%%---%%%%%%%%%---%%%%%-------%%%%%%%%%%%%%%--%%%%%||||--||||%%-----------%%%%%%%%F%%%%%%%%%%%%%%%%%%%%%%%%%%%%%%%%%%%%%%%%%%%%%%%%%%%
XXXXXXXXXXXX|||--|||||||--||||||||||||||||||||||||XXXXXXXXXXXXXXX||||---|||||||||---|||||XX---XX||||||||||||||--|||||||||--||||||XXXX---XXXX||||||||X|||||||||||||||||||||||||||||||||||||||||||||||||||
