HEIGHT=16;WIDTH=201;THEME=0;OVERRIDE=false
--------------------------------------------------------------------------------------------------------------------------------------------------------------------------------------------------------
--------------------------------------------------------------------------------------------------------------------------------------------------------------------------------------------------------
--------------------------------------------------------------------------------------------------------------------------------------------------------------------------------------------------------
--------------------------------------------------------------------------------------------------------------------------------------------------------------------------------------------------------
--------------------------------------------------------------------------------------------------------------------------------------------------------------------------------------------------------
--------------------------------------------------------------------------------------------------------------------------------------------------------------------------------------------------------
--------------------------------------------------------------------------------------------------------------------------------------------------------------------------------------------------------
--------------------------------------------------------------------------------------------------------------------------------------------------------------------------------------------------------
--------------------------------------------SC2SC-------------------------------------------------------------------------------------------------------------------------------------------------------
----------------------------------------------------------------------------------------------------------------------------------------------%%%%------------------------------------------------------
-----------------------------------------------------------------------------------------------------Tt---------------------------------------||||------------------------------------------------------
---------------#---#--------------#--#--------yk-----------------------------------------------------tt----#--#--------------------------%%%%%%%||------------------------------------------------------
--------------##---##------------##--##---%%%%%%%%%%%%%---%%%%----------------Tt-----------------%%%%%%%%%%%--%%%-%%%%%%-----------------|||||||||------------------------------------------------------
%%%%%%%%%%%--###---###----------###--###--|||||||||||||---||||%%%%------------tt-----------------|||||||||||--|||-||||K|-------gy----g---y||||||||--%%%%%%%%F%%%%%%%%%%%%%%%%%%%%%%%%%%%%%%%%%%%%%%%%%%%
|||||||||||%%%%%---%%%%%%%--%%%%%%%--%%%%%|||||||||||||---||||||||------------tt-----------------|||||||||||--|||%%%%%%%%%%%%%%%%%%%%%%%%%%%%%%%%%%%||||||||%|||||||||||||||||||||||||||||||||||||||||||
||||||||||||||||---|||||||--|||||||--||||||||||||||||||---||||||||XXXX---XXXXXXXXXXXXXXXXX--XXXXX|||||||||||--||||||||||||||||||||||||||||||||||||||||||||||||||||||||||||||||||||||||||||||||||||||||||
