HEIGHT=16;WIDTH=201;THEME=0;OVERRIDE=false
--------------------------------------------------------------------------------------------------------------------------------------------------------------------------------------------------------
--------------------------------------------------------------------------------------------------------------------------------------------------------------------------------------------------------
--------------------------------------------------------------------------------------------------------------------------------------------------------------------------------------------------------
--------------------------------------------------------------------------------------------------------------------------------------------------------------------------------------------------------
--------------------------------------------------------------------------------------------------------------------------------------------------------------------------------------------------------
--------------------------------------------------------------------------------------------------------------------------------------------------------------------------------------------------------
--------------------------------------------------------------------------------------------------------------------------------------------------------------------------------------------------------
--------------------------------------------------------------------------------------------------------------------------------------------------------------------------------------------------------
--------------------------------------------------------------------------------------------------------------------------------------------------------------------------------------------------------
------------------------------------rrK-----------------------------------------------------------------------------------------------------------------------------------------------------------------
------------------------------------%%%%----------------------------------------------------------------------------------------------------------------------------------------------------------------
------------------------------------||||------------------------------------------------------------#--#------------------------------------------------------------------------------------------------
--------------------%%%%%--%%%%%---gY|||-----y------------------------------------%%--%%%%%%%%%%%--##--##--%%%%---%%%%%%%%---%%%%----------%%%%%%%%F%%%%%%%%%%%%%%%%%%%%%%%%%%%%%%%%%%%%%%%%%%%%%%%%%%%%
--------------------|||||--|||||%%%%%%%%%%%%%%%%%-------------------%%%%---%%%%---||--|||||||||||%%%%--%%%%||||---||||||||---||||----------||||||||%||||||||||||||||||||||||||||||||||||||||||||||||||||
%%%%%%%%%%%%%-----k-|||||--||||||||||||||||||||||-------------------||||---||||%%%||--|||||||||||||||--||||||||---||||||||---||||%%%%--%%%%|||||||||||||||||||||||||||||||||||||||||||||||||||||||||||||
|||||||||||||XXXXXXX|||||--||||||||||||||||||||||XX--XXXXXXX---XXXXX||||---|||||||||--|||||||||||||||--||||||||---||||||||---||||||||--|||||||||||||||||||||||||||||||||||||||||||||||||||||||||||||||||
