HEIGHT=16;WIDTH=201;THEME=0;OVERRIDE=false
--------------------------------------------------------------------------------------------------------------------------------------------------------------------------------------------------------
--------------------------------------------------------------------------------------------------------------------------------------------------------------------------------------------------------
--------------------------------------------------------------------------------------------------------------------------------------------------------------------------------------------------------
--------------------------------------------------------------------------------------------------------------------------------------------------------------------------------------------------------
--------------------------------------------------------------------------------------------------------------------------------------------------------------------------------------------------------
--------------------------------------------------------------------------------------------------------------------------------------------------------------------------------------------------------
--------------------------------------------------------------------------------------------------------------------------------------------------------------------------------------------------------
--------------------------------------------------------------------------------------------------------------------------------------------------------------------------------------------------------
--------------------------------------------------------------------------------------------------------------------------------------------------------------------------------------------------------
-------------------------------------------------------------------%%%%%--------------------------------------------------------------------------------------------------------------------------------
-------------------------------------------------------------------|||||--------------------------------------------------------------------------------------------------------------------------------
--------------------------------SSC------------------------------%%%%%%|-------------------------------------------------------------S222U2-------------------------------------------------------------
-----------------------------------------------------------------|||||||--------------------------------------%%---%%-----------------------------------------------------------------------------------
-------------------k---------------------------------------------|||||||-----------------%%%-----------#---#--||---||-----------------------%%%%%%%%F%%%%%%%%%%%%%%%%%%%%%%%%%%%%%%%%%%%%%%%%%%%%%%%%%%%
-------------%%%%%%%%%%%--%%----------------------%%%%--%%%%---r-|||Y|||-----------------|||---------%%%---%%%||---||-----------------------||||||||%|||||||||||||||||||||||||||||||||||||||||||||||||||
XXXXXXXXXXXXX|||||||||||--||XXXXXXXXXXXXXXX--XXXXX||||--||||XXXXXXXXXXXXXXXXXX---XXXXXXXXXXXXXXXXXXXX|||---|||||---||XX--XXXXX---XXXXXXXXXXX||||||||||||||||||||||||||||||||||||||||||||||||||||||||||||
