HEIGHT=16;WIDTH=201;THEME=0;OVERRIDE=false
--------------------------------------------------------------------------------------------------------------------------------------------------------------------------------------------------------
--------------------------------------------------------------------------------------------------------------------------------------------------------------------------------------------------------
--------------------------------------------------------------------------------------------------------------------------------------------------------------------------------------------------------
--------------------------------------------------------------------------------------------------------------------------------------------------------------------------------------------------------
--------------------------------------------------------------------------------------------------------------------------------------------------------------------------------------------------------
--------------------------------CCS---------------------------------------------------------------------------------%%%%%%%-----------------------------------------------------------------------------
--------------------------------------------------------------------------------------------------------------------|||||||-----------------------------------------------------------------------------
--------------------------------------------------------------------------------------------------------------------|||||||-----------------------------------------------------------------------------
--------------------------------y-----------------------------------------------------------------------------------|||||||-----------------------------------------------------------------------------
------------------------tt-----%%%%---------------------------------------------------------------------------------|%%%%%|---------#---#---------------------------------------------------------------
------------------------tt-----||||---------------------------------------------------------------------------------|||||||--------##---##--------------------------------------------------------------
------------------------tt-----||||-----------------------------------------------------------------------g---------|||||%%%%%----###---###-------------------------------------------------------------
---------------#--#--%%%%%%%---||||----------------------%%%%%--%%%%%%%%%%%%%--%%%%%%%%--%%%%-------------%%%%%-----||||||||||--%%%%%---%%%%%-----------------------------------------------------------
-------------%%%--%%%|||||||%%%%%%%%%%%%-----------%%--%%|||||--|||||||||||||--||||||||--||||-------------||k||-----||||||r|||--|||||---|||||%%%%%%%%F%%%%%%%%%%%%%%%%%%%%%%%%%%%%%%%%%%%%%%%%%%%%%%%%%%
-------------|||--||||||||||||||||||||||-----------||--|||||||--|||||||||||||--||||||||--||||%%%%%%%%%%%%%%%%%%%%%%%%%%%%%%%%%%%|||||---|||||||||||||%||||||||||||||||||||||||||||||||||||||||||||||||||
XXXXXXXXXXXXX|||--||||||||||||||||||||||XXXXXXXXXXX||--|||||||XX|||||||||||||--||||||||--||||||||||||||||||||||||||||||||||||||||||||---||||||||||||||||||||||||||||||||||||||||||||||||||||||||||||||||
