HEIGHT=16;WIDTH=201;THEME=0;OVERRIDE=false
--------------------------------------------------------------------------------------------------------------------------------------------------------------------------------------------------------
--------------------------------------------------------------------------------------------------------------------------------------------------------------------------------------------------------
--------------------------------------------------------------------------------------------------------------------------------------------------------------------------------------------------------
--------------------------------------------------------------------------------------------------------------------------------------------------------------------------------------------------------
--------------------------------------------------------------------------------------------------------------------------------------------------------------------------------------------------------
--------------------------------------------------------------------------------------------------------------------------------------------------------------------------------------------------------
--------------------------------------------------------------------------------------------------------------------------------------------------------------------------------------------------------
--------------------------------------------------------------------------------------------------------------------------------------------------------------------------------------------------------
--------------------------------------------------------------------------------------------------------------------------------------------------------------------------------------------------------
-----------------------------%%%%-----------------------------------------------------------------------------------------------------------------------------------------------------------------------
-----------------------------||||-----------------------------------------------------------------------------------------------------------------------------------------------------------------------
-----------------------------||||-----------------------------------------------------------------------------------------------------------------------------------------------------------------------
-------------------------r---||kg---------------------%%%--%%%%%%%---%%%%-----------------g-------------------------------------------------------------------------------------------------------------
-------------%%%------%%%%%%%%%%%%%-------------------|||--|||||||---||||------------%%%%%%%%--------------tt---tt-tt--------------------------%%%%%%%%F%%%%%%%%%%%%%%%%%%%%%%%%%%%%%%%%%%%%%%%%%%%%%%%%
%%%%%%%%%%%%%|||%%--%%|||||||||||||-------------------|||--|||||||---||||------------||||||||--------------tt---tt-tt-%%%%%--%%%%%%%%%%---%%%%%||||||||%||||||||||||||||||||||||||||||||||||||||||||||||
||||||||||||||||||--|||||||||||||||XXXXX---XXXXXXXXXXX|||--|||||||---||||XX--XXXX--XX||||||||XXXXX--XXXXXXXXXXXXXXXXXX|||||--||||||||||---||||||||||||||||||||||||||||||||||||||||||||||||||||||||||||||
