HEIGHT=16;WIDTH=201;THEME=0;OVERRIDE=false
--------------------------------------------------------------------------------------------------------------------------------------------------------------------------------------------------------
--------------------------------------------------------------------------------------------------------------------------------------------------------------------------------------------------------
--------------------------------------------------------------------------------------------------------------------------------------------------------------------------------------------------------
--------------------------------------------------------------------------------------------------------------------------------------------------------------------------------------------------------
--------------------------------------------------------------------------------------------------------------------------------------------------------------------------------------------------------
--------------------------------------------------------------------------------------------------------------------------------------------------------------------------------------------------------
--------------------------------------------------------------------------------------------------------------------------------------------------------------------------------------------------------
--------------------------------------------------------------------------------------------------------------------------------------------------------------------------------------------------------
--------------------------------------------------------------------------------------------------------------------------------------------------------------------------------------------------------
---------------------------------------------------------------------------------------------------------------------------------------------tt---------------------------------------------------------
------------------------CCU-------------------------------------------------------------SSSSSS22----tt-----------------------------------tt--tt---------------------------------------------------------
----------------------------------------------------------------SUC---------------------------------tt---#---#----------------#--#-------tt--tt---------------------------------------------------------
----------------------------------------------%%--%%------------------%%%%%------%%%%%-----------%%%%%%%%%---%%%-------------##--##--%%%%%%%%%%%%%%%%%%%%%%F%%%%%%%%%%%%%%%%%%%%%%%%%%%%%%%%%%%%%%%%%%%%
------------------------------------------%%%%||--||------------------|||||------|||||-----------|||||||||---|||-----------%%%%--%%%%||||||||||||||||||||||%||||||||||||||||||||||||||||||||||||||||||||
%%%%%%%%%%%%%%---%%%%%%%%%%%%%%%%%---%%%%%||||||--||------------------|||||------|||||%%%%%%%%%%%|||||||||---|||-------%%%%||||--|||||||||||||||||||||||||||||||||||||||||||||||||||||||||||||||||||||||
||||||||||||||---|||||||||||||||||---|||||||||||--||XXX---XXXXXXXXXXXX|||||XX--XX|||||||||||||||||||||||||---|||XXXXXXX||||||||--|||||||||||||||||||||||||||||||||||||||||||||||||||||||||||||||||||||||
