HEIGHT=16;WIDTH=201;THEME=0;OVERRIDE=false
--------------------------------------------------------------------------------------------------------------------------------------------------------------------------------------------------------
--------------------------------------------------------------------------------------------------------------------------------------------------------------------------------------------------------
--------------------------------------------------------------------------------------------------------------------------------------------------------------------------------------------------------
--------------------------------------------------------------------------------------------------------------------------------------------------------------------------------------------------------
--------------------------------------------------------------------------------------------------------------------------------------------------------------------------------------------------------
--------------------------------------------------------------------------------------------------------------------------------------------------------------------------------------------------------
--------------------------------------------------------------------------------------------------------------------------------------------------------------------------------------------------------
--------------------------------------------------------------------------------------------------------------------------------------------------------------------------------------------------------
-----------SSU2SCS------------------------------------------------------------------------------------------------------US2U-----%%%%%%-----------------------------------------------------------------
---------------------------------------------------------------------------------------------------------------------------------||||||-----------------------------------------------------------------
-------------------------------------------------------------------------------------------------------Tt------------------------||%%%%%%%--------------------------------------------------------------
------------------r-------------------------------------------tt-----------#--#---------------------Tt-tt----------------y-------||y||||||--------------------------------------------------------------
----------%%%%%%%%%%--#---#-----------------------------------tt---------%%%--%%%-------------------tt-tt-------------%%%%%%%%%%%%%%%%%%%%%%------------------------------------------------------------
----------||||||||||%%%---%%%%%%%%---%%%%%--------------------tt---#--#--|||--|||---------#--#--%%%%%%%%%%%%--%%------||||||||||||||||||||||------------------------------------------------------------
%%%%%%%%%%|||||||||||||---||||||||---|||||------------------%%%%%%%%--%%%|||--|||-------%%%--%%%||||||||||||--||%%--%%||||||||||||||||||||||%%%%%%%%F%%%%%%%%%%%%%%%%%%%%%%%%%%%%%%%%%%%%%%%%%%%%%%%%%%%
|||||||||||||||||||||||---||||||||---|||||XXXX--XXXXXXX--XXX||||||||--||||||--|||XX---XX|||--|||||||||||||||--||||--||||||||||||||||||||||||||||||||X|||||||||||||||||||||||||||||||||||||||||||||||||||
