HEIGHT=16;WIDTH=201;THEME=0;OVERRIDE=false
--------------------------------------------------------------------------------------------------------------------------------------------------------------------------------------------------------
--------------------------------------------------------------------------------------------------------------------------------------------------------------------------------------------------------
--------------------------------------------------------------------------------------------------------------------------------------------------------------------------------------------------------
--------------------------------------------------------------------------------------------------------------------------------------------------------------------------------------------------------
--------------------------------------------------------------------------------------------------------------------------------------------------------------------------------------------------------
------------------------------------------------------------------------------------SC2S22--------------------------------------------------------------------------------------------------------------
--------------------------------------------------------------------------------------------------------------------------------------------------------------------------------------------------------
--------------------------------------------------------------------------------------------------------------------------------------------------------------------------------------------------------
---------------------------------------------------------------SS2-----------------------r--------------------------------------------------------------------------------------------------------------
------------------------------------------------------------------------------------%%%%%%%-------------------------------------------------------------------------------------------------------------
--------------------------------------------------------------------------#---#-----|||||||--------------------------------SCSS2------------------------------------------------------------------------
------------------------------------------------%%%%%%-------------------##---##----||%%%%|-------#---#--------#--#-------------------------------------------------------------------------------------
------------------------------------------------||||||-----%%%%%%%%%%%--###---###---|||||||------##---##------##--##------------------------------------------------------------------------------------
-------------%%---%%-------------------------%%%%%%%%%%%%%%|||||||||||%%%%%---%%%%%-|||||||-----###---###----###--###-------kk--------------------------------------------------------------------------
%%%%%%%%%%%%%||---||%%%%%---%%%%%------------||||||||||||||||||||||||||||||---|||||-|||||||---%%%%%---%%%%%%%%%%--%%%%%%%%%%%%%%%--#---#----------------------------------------------------------------
|||||||||||||||---|||||||---|||||XX--XXXX--XX||||||||||||||||||||||||||||||---|||||XXXXXXXXXXX|||||---||||||||||--|||||||||||||||XXX---XXXXXXXXXXXFXXXXXXXXXXXXXXXXXXXXXXXXXXXXXXXXXXXXXXXXXXXXXXXXXXXXX
