HEIGHT=16;WIDTH=201;THEME=0;OVERRIDE=false
--------------------------------------------------------------------------------------------------------------------------------------------------------------------------------------------------------
--------------------------------------------------------------------------------------------------------------------------------------------------------------------------------------------------------
--------------------------------------------------------------------------------------------------------------------------------------------------------------------------------------------------------
--------------------------------------------------------------------------------------------------------------------------------------------------------------------------------------------------------
--------------------------------------------------------------------------------------------------------------------------------------------------------------------------------------------------------
-------------------------------------------------------------------------------------------------------------%%%%---------------------------------------------------------------------------------------
-------------------------------------------------------------------------------------------------------------||||---------------------------------------------------------------------------------------
-------------------------------------------------------------------------------------------------------------||||---------------------------------------------------------------------------------------
-------------------------------------------------------------------------------------------------------------||||---------------------------------------------------------------------------------------
--------------------------------------------------------------------------------------------------#---#------||||---%%%%%-------------------------------------------------------------------------------
-----------------------------------------------------------------------------------#--#----------##---##-----||||-g-|||||-------------------------------------------------------------------------------
-----------------------#---#-----#---#-------------SCS-----#--#-------------------##--##--------###---###----|||%%%%%%|||-------------------------------------------------------------------------------
%%%%%%%%%%%--------%%%%%---%%%--##---##--------%%--------%%%--%%%----------------###--###-----%%%%%---%%%%%--||||||||||||--%%%%%---%%%%%----------------------------------------------------------------
|||||||||||--------|||||---|||%%%%---%%%%%%--%%||--------|||--|||--------%%--%%%%%%%--%%%%%%%%|||||---|||||--|||||||||||r--|||||---|||||%%%%%%%%F%%%%%%%%%%%%%%%%%%%%%%%%%%%%%%%%%%%%%%%%%%%%%%%%%%%%%%%
|||||||||||--------|||||---|||||||---||||||--||||--------|||--|||--#--#--||--|||||||--|||||||||||||---|||||%%%%%%%%%%%%%%%%|||||---|||||||||||||%|||||||||||||||||||||||||||||||||||||||||||||||||||||||
|||||||||||XXX--XXX|||||---|||||||---||||||--||||XXXXXXXX|||--|||XXX--XXX||--|||||||--|||||||||||||---||||||||||||||||||||||||||---|||||||||||||||||||||||||||||||||||||||||||||||||||||||||||||||||||||
