HEIGHT=16;WIDTH=201;THEME=0;OVERRIDE=false
--------------------------------------------------------------------------------------------------------------------------------------------------------------------------------------------------------
--------------------------------------------------------------------------------------------------------------------------------------------------------------------------------------------------------
--------------------------------------------------------------------------------------------------------------------------------------------------------------------------------------------------------
--------------------------------------------------------------------------------------------------------------------------------------------------------------------------------------------------------
--------------------------------------------------------------------------------------------------------------------------------------------------------------------------------------------------------
--------------------------------------------------------------------------------------------------------------------------------------------------------------------------------------------------------
--------------------------------------------------------------------------------------------------------------------------------------------------------------------------------------------------------
----------------------------------------------------------------------------------------------------------------------------------k---------------------------------------------------------------------
--------------------------------------------------------------------------------------------------------------------------------%%%---------------------------------------------------------------------
----------------------------------------#---#------------------C-SU----------------#--#-----------------------------------------|||---------------------------------------------------------------------
---------------------------------------##---##------------------------------------##--##----------------------------------------|||---------------------------------------------------------------------
--------------------------------------###---###-----------------%----------------###--###---------------------------------------y|rk--r-----------------------------------------------------------------
-----------%%%--%%%-----------------%%%%%---%%%%%---------------|--g-----------%%%%%--%%%%%----#---#----------------%%%%---%%%%%%%%%%%%%%%%-------------------------------------------------------------
%%%%%%%%%%%|||--|||--------%%%---%%%|||||---|||||---#---#---%%%%%%%%%%%%%%--%%%|||||--|||||---##---##------------%%%||||---||||||||||||||||-------------------------------------------------------------
||||||||||||||--|||--------|||---||||||||---|||||--##---##--||||||||||||||--||||||||--|||||--###---###--%%%---%%%|||||||---||||||||||||||||-------------------------------------------------------------
||||||||||||||--|||XXX--XXX|||---||||||||---|||||XXXX---XXXX||||||||||||||--||||||||--|||||XXXXX---XXXXX|||---||||||||||---||||||||||||||||XXXXXXXXFXXXXXXXXXXXXXXXXXXXXXXXXXXXXXXXXXXXXXXXXXXXXXXXXXXXX
