HEIGHT=16;WIDTH=201;THEME=0;OVERRIDE=false
--------------------------------------------------------------------------------------------------------------------------------------------------------------------------------------------------------
--------------------------------------------------------------------------------------------------------------------------------------------------------------------------------------------------------
--------------------------------------------------------------------------------------------------------------------------------------------------------------------------------------------------------
--------------------------------------------------------------------------------------------------------------------------------------------------------------------------------------------------------
--------------------------------------------------------------------------------------------------------------------------------------------------------------------------------------------------------
--------------------------------------------------------------------------------------------------------------------------------------------------------------------------------------------------------
--------------------------------------------------------------------------------------------------------------------------------------------------------------------------------------------------------
--------------------------------------------------------------------------------------------------------------------------------------------------------------------------------------------------------
--------------------------------------------------------------------------------------------------------------------------------------------------------------------------------------------------------
----------------------------------------------------------------------#--#------------------------------------------------------------------------------------------------------------------------------
---------------------------------------------------------------------##--##------------------------------S--S------------S2SUCS-------------------------------------------------------------------------
----------------------------------------------#---#-----------------###--###----------------------------------------------------------------------------------------------------------------------------
-------------------------%%%----------------%%%---%%%-------------%%%%%--%%%%%-------%%%%%%%%--%%%%-------|%--%%%%--%%%%-----------------%%%%%%%%F%%%%%%%%%%%%%%%%%%%%%%%%%%%%%%%%%%%%%%%%%%%%%%%%%%%%%%
-----------%%%%%--%%%%%--|||---------%%---%%|||---|||-------------|||||--|||||-------||||||||--||||-------r|--||||--||||-----g-----------||||||||%||||||||||||||||||||||||||||||||||||||||||||||||||||||
%%%%%%%%%%%|||||--|||||--|||---------||---|||||---|||-------------|||||--|||||%%---%%||||||||--y|||-----%%%%%%||||--||||%%%%%%%%%--#--#--|||||||||||||||||||||||||||||||||||||||||||||||||||||||||||||||
||||||||||||||||--|||||XXXXXXXXXXXXXX||---|||||---|||XX---XXXX--XX|||||--|||||||---||||||||||XXXXXXXXXXX||||||||||--|||||||||||||XXX--XXX|||||||||||||||||||||||||||||||||||||||||||||||||||||||||||||||
