HEIGHT=16;WIDTH=201;THEME=0;OVERRIDE=false
--------------------------------------------------------------------------------------------------------------------------------------------------------------------------------------------------------
--------------------------------------------------------------------------------------------------------------------------------------------------------------------------------------------------------
--------------------------------------------------------------------------------------------------------------------------------------------------------------------------------------------------------
--------------------------------------------------------------------------------------------------------------------------------------------------------------------------------------------------------
--------------------------------------------------------------------------------------------------------------------------------------------------------------------------------------------------------
--------------------------------------------------------------------------------------------------------------------------------------------------------------------------------------------------------
------------------------------------------------------------------------%%%%%%%-------------------------------------------------------------------------------------------------------------------------
------------------------------------------------------------------------|||||||-------------------------------------------------------------------------------------------------------------------------
------------------------------------------------------------------------|||||||---------22--------------------------------------------------------------------------------------------------------------
------------------------------------------------------------------------|||||||-------------------------------------------------------------------------------------------------------------------------
-----------------------tt---------------------------------------------%%%%|||||--------|----------------------------------------------------------------------------------------------------------------
-----------------------tt------------------#---#----------------------|||||||||--------g-k--------------------------------------------------------------------------------------------------------------
----------------------%%%%%%%%%%---%%%%---##---##--------%%%%%%---%%%%%%%%%%%%%%%%--%%%%%%%%%-----------------%%%%%---%%%%%-----------------------------------------------------------------------------
%%%%%%%%%%----------%%||||||||||---||||--###---###-------||||||---||||||||||||||||%%|||||||||-----------------|||||---|||||----------%%%%---%%%%%%%%%%%%F%%%%%%%%%%%%%%%%%%%%%%%%%%%%%%%%%%%%%%%%%%%%%%%
||||||||||%%%%--%%%%||||||||||||---||||%%%%%---%%%%%-----||||||---|||||||||||||||||||||||||||%%%%%%%%%%%%--%%%|||||---|||||----------||||---||||||||||||%|||||||||||||||||||||||||||||||||||||||||||||||
||||||||||||||--||||||||||||||||---|||||||||---|||||XXXXX||||||---|||||||||||||||||||||||||||||||||||||||--||||||||---|||||XXXX--XXXX||||---||||||||||||||||||||||||||||||||||||||||||||||||||||||||||||
