HEIGHT=16;WIDTH=201;THEME=0;OVERRIDE=false
--------------------------------------------------------------------------------------------------------------------------------------------------------------------------------------------------------
--------------------------------------------------------------------------------------------------------------------------------------------------------------------------------------------------------
--------------------------------------------------------------------------------------------------------------------------------------------------------------------------------------------------------
--------------------------------------------------------------------------------------------------------------------------------------------------------------------------------------------------------
--------------------------------------------------------------------------------------------------------------------------------------------------------------------------------------------------------
--------------------------------------------------------------------------------------------------------------------------------------------------------------------------------------------------------
--------------------------------------------------------------------------------------------------------------------------------------------------------------------------------------------------------
--------------------------------------------------------------------------------------------------------------------------------------------------------------------------------------------------------
--------------------------------------------------------------------------------------------------------------------------------------------------------------------------------------------------------
--------------------------------------------------------------------------------------------------------------------g-----------------------------------------------------------------------------------
-------------------------------------------------tt---------------------------------tt-----------------------tt-----%%%%%%%-----------------------------------------------------------------------------
---------------------------------------------Tt--tt---------------------------------tt-----------------------tt-----|||||||-----------------------------------------------------------------------------
%%%%%%%%%%%%%%-------------------------------tt--tt----%%------%%%%%---%%%%%%%%%%%--tt-----------------------tt-----|||||||--------%%%---%%%%%%%%%%%F%%%%%%%%%%%%%%%%%%%%%%%%%%%%%%%%%%%%%%%%%%%%%%%%%%%
||||||||||||||-----------------%%%%%---%%%%%%%%%%%%%%%%||%%--%%|||||---|||||||||||%%%%%%%-------------------%%%%%%%-||||||y-yr-----|||---|||||||||||%|||||||||||||||||||||||||||||||||||||||||||||||||||
||||||||||||||------------%%%%%|||||---||||||||||||||||||||--|||||||---||||||||||||||||||---------%%%%--%%%%|||||||%%%%%%%%%%%%%%%%|||---|||||||||||||||||||||||||||||||||||||||||||||||||||||||||||||||
||||||||||||||XXXXX--XXXXX||||||||||---||||||||||||||||||||--|||||||---||||||||||||||||||XXX---XXX||||--||||||||||||||||||||||||||||||---|||||||||||||||||||||||||||||||||||||||||||||||||||||||||||||||
