HEIGHT=16;WIDTH=201;THEME=0;OVERRIDE=false
--------------------------------------------------------------------------------------------------------------------------------------------------------------------------------------------------------
--------------------------------------------------------------------------------------------------------------------------------------------------------------------------------------------------------
--------------------------------------------------------------------------------------------------------------------------------------------------------------------------------------------------------
--------------------------------------------------------------------------------------------------------------------------------------------------------------------------------------------------------
--------------------------------------------------------------------------------------------------------------------------------------------------------------------------------------------------------
--------------------------------------------------------------------------------------------------------------------------------------------------------------------------------------------------------
--------------------------------------------------------------------------------------------------------------------------------------------------------------------------------------------------------
--------------------------------------------------------------------------------------------------------------------------------------------------------------------------------------------------------
--------------------------------------------------------------------------------------------------------------------------------------------------------------------------------------------------------
--------------------------------------------------------------------------------------------------------------------------------------------------------------------------------------------------------
------------------------#--#-------Tt-------------------------------------------------------------------------------------------------------------------------------------------------------------------
-----------------------##--##------tt-------------------------------SCSS--------------------------------------------------------------------------------------------------------------------------------
----------------------###--###-----tt-------------------------------------------------------------%%--%%------------Tt-Tt-------------------------------------------------------------------------------
--------------------%%%%%--%%%%%%%%%%%%%%---%%%-----------%%---%%-------------------------%%%--%%%||--||------------tt-tt-----------------------%%%%%%%%F%%%%%%%%%%%%%%%%%%%%%%%%%%%%%%%%%%%%%%%%%%%%%%%
--------------------|||||--||||||||||||||---|||%%%%---%%%%||---||-g-----------------------|||--|||||--||%%%%%%%%%---tt-tt----%%---%%%%%%%--%%%%%||||||||%|||||||||||||||||||||||||||||||||||||||||||||||
XXXXXXXXXXXXXXX---XX|||||--||||||||||||||---|||||||---||||||---||XXXXXXXXXXXX---XXXXXX--XX|||--|||||--|||||||||||XXXXXXXXXXXX||---|||||||--|||||||||||||||||||||||||||||||||||||||||||||||||||||||||||||
