HEIGHT=16;WIDTH=201;THEME=0;OVERRIDE=false
--------------------------------------------------------------------------------------------------------------------------------------------------------------------------------------------------------
--------------------------------------------------------------------------------------------------------------------------------------------------------------------------------------------------------
--------------------------------------------------------------------------------------------------------------------------------------------------------------------------------------------------------
--------------------------------------------------------------------------------------------------------------------------------------------------------------------------------------------------------
--------------------------------------------------------------------------------------------------------------------------------------------------------------------------------------------------------
--------------------------------------------------------------------------------------------------------------------------------------------------------------------------------------------------------
--------------------------------------------------------------------------------------------------------------------------------------------------------------------------------------------------------
--------------------------------------------------------------------------------------------------------------------------------------------------------------------------------------------------------
--------------------------------------------------------------------------------------------------------------------------------------------------------------------------------------------------------
--------------------------------------------------------------------------------------------------------------------------------------#--#--------------------------------------------------------------
-----------------------------#--#--------------------C2SSS------------------g--------------------------------------------------------##--##-------------------------------------------------------------
----------------------------##--##------------yG------------------------%%%%%%%-------------------------------------------r-----k---###--###------------------------------------------------------------
--------------------------%%%%--%%%%----------%%%---------------#--#----|||r|||------------------%%%---%%%------------%%%%%%%%%%%%%%%%%--%%%%%----------------------------------------------------------
--------------------------||||--||||----------|||-----y-----g-%%%--%%%--||%%%||----------%%%--%%%|||---|||------------|||||||||||||||||--|||||----------------------------------------------------------
--------------------------||||--||||----g-yk--|||--%%%%%%%%%%%|||--|||--|||||g|--%%%--%%%|||--||||||---|||%%%%%--%%%%%|||||||||||||||||--|||||----------------------------------------------------------
XXXXXXXXXXXXXXXXXX---XXXXX||||--||||XXXXXXXXXXXXXXX||||||||||||||--|||XXXXXXXXXXX|||--||||||--||||||---||||||||--||||||||||||||||||||||--|||||XXXXXXXXFXXXXXXXXXXXXXXXXXXXXXXXXXXXXXXXXXXXXXXXXXXXXXXXXX
