HEIGHT=16;WIDTH=201;THEME=0;OVERRIDE=false
--------------------------------------------------------------------------------------------------------------------------------------------------------------------------------------------------------
--------------------------------------------------------------------------------------------------------------------------------------------------------------------------------------------------------
--------------------------------------------------------------------------------------------------------------------------------------------------------------------------------------------------------
--------------------------------------------------------------------------------------------------------------------------------------------------------------------------------------------------------
-------------------------------------------------%%%%%%-------------------------------------------------------------------------------------------------------------------------------------------------
-------------------------------------------------||||||-------------------------------------------------------------------------------------------------------------------------------------------------
-------------------------------------------------||||||-------------------------------------------------------------------------------------------------------------------------------------------------
-------------------------------------------------||||||-------------------------------------------------------------------------------------------------------------------------------------------------
--------------------------------------------%%%%%%%||||-------------------------------------------------------------------------------------------------------------------------------------------------
--------------------------------------------|||||||||||-----------------------------------CSSS---CSC----------------------------------------------------------------------------------------------------
--------------------------------------------|||||||||||-------------------------------------------------------------------------------------------------------------------------------------------------
---------------#--#-----#--#----------------||||g||g|||-k----------------------#---#--------------------------------------------------------------------------------------------------------------------
--------------##--##--%%%--%%%------------%%%%%%%%%%%%%%%%%%----%%%%%--%%%%%--##---##------r-----------------#---#--------------------%%%---------------------------------------------------------------
------------%%%%--%%%%|||--|||------------||||||||||||||||||----|||||--|||||%%%%---%%%%%%%%%%%%%%%%%%%%----%%%---%%%%%%%--%%%%%%%--%%%|||---------------------------------------------------------------
%%%%%%%%%%%%||||--|||||||--|||%%--%%------||||||||||||||||||----|||||--|||||||||---||||||||||||||||||||%%%%|||---|||||||--|||||||--||||||---------------------------------------------------------------
||||||||||||||||--|||||||--|||||--||XX--XX||||||||||||||||||XXXX|||||--|||||||||---|||||||||||||||||||||||||||---|||||||--|||||||--||||||XXXXXXXXFXXXXXXXXXXXXXXXXXXXXXXXXXXXXXXXXXXXXXXXXXXXXXXXXXXXXXX
