HEIGHT=16;WIDTH=201;THEME=0;OVERRIDE=false
--------------------------------------------------------------------------------------------------------------------------------------------------------------------------------------------------------
--------------------------------------------------------------------------------------------------------------------------------------------------------------------------------------------------------
--------------------------------------------------------------------------------------------------------------------------------------------------------------------------------------------------------
--------------------------------------------------------------------------------------------------------------------------------------------------------------------------------------------------------
----------------------------%%%%%-----------------------------------------------------------------------------------------------------------------------------------------------------------------------
----------------------------|||||-----------------------------------------------------------------------------------------------------------------------------------------------------------------------
----------------------------|||||-----------------------------------------------------------------------------------------------------------------------------------------------------------------------
----------------------------|||y|y----------------------------------------------------------------------------------------------------------------------------------------------------------------------
----------------------------|%%%%%%---------------------------------------------------------------------------------------------------------------------------------------------------------------------
----------------------------|||||||---------------------------%%%%%-------------------------------------------------------------------------------------------------------------------------------------
----------------------------|||||||---------------------------|||||-----------------------------------------------------------------------Tt---tt-------------------------------------------------------
----------------------------|||y|||-------------------------%%%%%%|-------------------------------------------------------------------tt--tt---tt-------------------------------------------------------
--------------------------%%%%%%%%%%%-----%%---%%%%%%%%%%%%-|||||||---------------------------------------tt--------------------------tt--tt---tt-------------------------------------------------------
%%%%%%%%%%%%%%%%%%%--%%%%%|||||||||||-----||---||||||||||||-|||||||-------%%%%--%%%%----------------------tt---%%%%%%--%%%%%%%--%%%%%%%%%%%%%%%%%%------------------------------------------------------
|||||||||||||||||||--||||||||||||||||-----||---||||||||||||-|||||||-------||||--||||--------%%%%---%%%%%%%%%%%%||||||--|||||||--||||||||||||||||||------------------------------------------------------
|||||||||||||||||||--||||||||||||||||XXXXX||---||||||||||||XXXXXXXXXXXXXXX||||--||||XXX--XXX||||---||||||||||||||||||--|||||||--||||||||||||||||||XXXXXXXXFXXXXXXXXXXXXXXXXXXXXXXXXXXXXXXXXXXXXXXXXXXXXX
