HEIGHT=16;WIDTH=201;THEME=0;OVERRIDE=false
--------------------------------------------------------------------------------------------------------------------------------------------------------------------------------------------------------
--------------------------------------------------------------------------------------------------------------------------------------------------------------------------------------------------------
--------------------------------------------------------------------------------------------------------------------------------------------------------------------------------------------------------
--------------------------------------------------------------------------------------------------------------------------------------------------------------------------------------------------------
-----------------------------------------------------------------------------------------------------------k--------------------------------------------------------------------------------------------
-----------------------------------------------------------------------------------------------------------%%%%-----------------------------------------------------------------------------------------
-----------------------------------------------------------------------------------------------------------||||-----------------------------------------------------------------------------------------
-----------------------------------------------------------------------------------------------------------||||-----------------------------------------------------------------------------------------
-----------------------------------------------------------------------------------------------------------||||-----------------------------------------------------------------------------------------
-------------------------------------------------------------------------------------------UCC---------%%%%%|||-----------------------------------------------------------------------------------------
----------------------------%%%%-----------------------------------------------------------------------||||||||-----------------------------------------------------------------------------------------
----------------------------||||-----------------------------------------------------------------------||||||||-------#---#-----------------------------------------------------------------------------
--------------------------%%%%||-----------------------------------------------------r--r-----rg-------||||||||------##---##----------------------------------------------------------------------------
%%%%%%%%%%%%------#---#---||||||-----------%%%%%--%%%%%%%%%---%%%%%%%%%%---------%%%%%%%%%%%%%%%%%%%%%%%%%%%%%%%%%%%%%%---%%%%--------------------------------------------------------------------------
||||||||||||%%%%%%%---%%%-||g|||----G------|||||--|||||||||---||||||||||---------||||||||||||||||||||||||||||||||||||||---||||--------%%%%%%%%%%%%%%F%%%%%%%%%%%%%%%%%%%%%%%%%%%%%%%%%%%%%%%%%%%%%%%%%%%
|||||||||||||||||||---|||XXXXXXXXXXXXXXXXXX|||||--|||||||||---||||||||||XXX---XXX||||||||||||||||||||||||||||||||||||||---||||XXX--XXX||||||||||||||X|||||||||||||||||||||||||||||||||||||||||||||||||||
