HEIGHT=16;WIDTH=201;THEME=0;OVERRIDE=false
--------------------------------------------------------------------------------------------------------------------------------------------------------------------------------------------------------
--------------------------------------------------------------------------------------------------------------------------------------------------------------------------------------------------------
--------------------------------------------------------------------------------------------------------------------------------------------------------------------------------------------------------
--------------------------------------------------------------------------------------------------------------------------------------------------------------------------------------------------------
--------------------------------------------------------------------------------------------------------------------------------------------------------------------------------------------------------
--------------------------------------------------------------------------------------------------------------------------------------------------------------------------------------------------------
--------------------------------------------------------------------------------------------------------------------------------------------------------------------------------------------------------
--------------------------------------------------------------------------------------------------------------------------------------------------------------------------------------------------------
--------------------------------------------------------------------------------------------------------------------------------------------------------------------------------------------------------
-----------------------#---#---------------------------------------------------------------------#---#---------------------SCS2C------------------------------------------------------------------------
----------------------##---##-------------------------------------------------------------------##---##--------------------------------#--#-------------------------------------------------------------
--------------SSS----###---###----------------------------------------SSSS2S-------------------###---###------------------------------##--##------------------------------------------------------------
-------------------%%%%%---%%%%%-------------------------------------------------------------%%%%%---%%%%%---------------------yk----###--###-----------------------------------------------------------
-------------------|||||---|||||------------%%---%%------------------------------------------|||||---|||||----------------%%%%%%%%%%%%%%--%%%%%---------------------------------------------------------
%%%%%%%%%%%%-------|||||---|||||---------%%%||---||------g---#---#----ky---------------------|||||---|||||---%%%%%---%%%%%||||||||||||||--|||||---------------------------------------------------------
||||||||||||XXXXXXX|||||---|||||XXXXXXXXX|||||---||XXXXXXXXXXX---XXXXXXXXXXXXXXXXX--XXXXX--XX|||||---|||||XXX|||||---|||||||||||||||||||--|||||XXXXXXXXFXXXXXXXXXXXXXXXXXXXXXXXXXXXXXXXXXXXXXXXXXXXXXXXX
