HEIGHT=16;WIDTH=201;THEME=0;OVERRIDE=false
--------------------------------------------------------------------------------------------------------------------------------------------------------------------------------------------------------
--------------------------------------------------------------------------------------------------------------------------------------------------------------------------------------------------------
--------------------------------------------------------------------------------------------------------------------------------------------------------------------------------------------------------
--------------------------------------------------------------------------------------------------------------------------------------------------------------------------------------------------------
--------------------------------------------------------------------------------------------------------------------------------------------------------------------------------------------------------
--------------------------------------------------------------------------------------------------------------------------------------------------------------------------------------------------------
--------------------------------------------------------------------------------------------------------------------------------------------------------------------------------------------------------
--------------------------------------------------------------------------------------------------------------------------------------------------------------------------------------------------------
--------------------------------------------------------------------------------------------------------------------------------------------------------------------------------------------------------
--------------------------------------------------------------------------------------------SSSCS-------------------------------------------------------------------------------------------------------
--------------------------------------------------------------------------------------------------------------------------------------------------------------------------------------------------------
---------------------------------------------------------------#---#-----------------------------------------------CC-S2S-S-----------------------------------------------------------------------------
-----------------%%%%%-----------------------%%%%--%%%%-------##---##---------------------------g-------%%%%--%%%---------------------------------%%%%%%%%F%%%%%%%%%%%%%%%%%%%%%%%%%%%%%%%%%%%%%%%%%%%%%
--------------%%%|||||-------%%%%---%%%%%%%%%||||--||||------###---###--------------%%%%%%%%%%%%%%%-----||||--|||----%---%------------------------||||||||%|||||||||||||||||||||||||||||||||||||||||||||
%%%%%%%%%%%%%%||||||||-------||||---|||||||||||||--||||%%%%%%%%%---%%%%%------------|||||||||||||||-----||||%%|||----|---|--%%%%---%%%%-----------||||||||||||||||||||||||||||||||||||||||||||||||||||||
||||||||||||||||||||||XX---XX||||---|||||||||||||--|||||||||||||---|||||XXXXX--XXXXX|||||||||||||||XXXXX|||||||||XXXXXXXXXXX||||---||||XXXX---XXXX||||||||||||||||||||||||||||||||||||||||||||||||||||||
