HEIGHT=16;WIDTH=201;THEME=0;OVERRIDE=false
--------------------------------------------------------------------------------------------------------------------------------------------------------------------------------------------------------
--------------------------------------------------------------------------------------------------------------------------------------------------------------------------------------------------------
--------------------------------------------------------------------------------------------------------------------------------------------------------------------------------------------------------
--------------------------------------------------------------------------------------------------------------------------------------------------------------------------------------------------------
--------------------------------------------------------------------------------------------------------------------------------------------------------------------------------------------------------
--------------------------------------------------------------------------------------------------------------------------------------------------------------------------------------------------------
------------------r-------------------------------------------------------------------------------------------------------------------------------------------------------------------------------------
---------------%%%%-------------------------------------------------------------------------------------------------------------------------------------------------------------------------------------
---------------||||-------------------------------------------------------------------------------------------------------------------------------------------------------------------------------------
---------------|||%%%%%%--------------------------------------------------------------------------------------------------------------------------------------------------------------------------------
---------------|||||||||----------Tt-----------------------------------------------------------------------------#--#-----------------------------------------------------------------------------------
---------------|||||||||----------tt----------------------------------------------------------------------Tt----##--##----------------------------------------------------------------------------------
---------------|||||||y|--r-------tt-%%%-----------------------%%%%%---------------------------------tt---tt--%%%%--%%%%----------------Tt--------------------------------------------------------------
------------%%%%%%%%%%%%%%%%%%%%%%%%%|||%%---------------------|||||---#---#---%%---%%---------------tt---tt--||||--||||------------tt--tt----%%%%%%%%F%%%%%%%%%%%%%%%%%%%%%%%%%%%%%%%%%%%%%%%%%%%%%%%%%
%%%%%%%%%%%%||||||||||||||||||||||||||||||%%%%---%%%%%%%%--%%%%|||||--##---##--||---||%%%%%---%%%%%%%%%%%%%%%%||||--||||%%%%--%%%%--tt--tt----||||||||%|||||||||||||||||||||||||||||||||||||||||||||||||
||||||||||||||||||||||||||||||||||||||||||||||---||||||||--|||||||||XXXX---XXXX||---|||||||---||||||||||||||||||||--||||||||--||||XXXXXXXXXXXX||||||||||||||||||||||||||||||||||||||||||||||||||||||||||
