HEIGHT=16;WIDTH=201;THEME=0;OVERRIDE=false
--------------------------------------------------------------------------------------------------------------------------------------------------------------------------------------------------------
--------------------------------------------------------------------------------------------------------------------------------------------------------------------------------------------------------
--------------------------------------------------------------------------------------------------------------------------------------------------------------------------------------------------------
--------------------------------------------------------------------------------------------------------------------------------------------------------------------------------------------------------
--------------------------------------------------------------------------------------------------------------------------------------------------------------------------------------------------------
--------------------------------------------------------------------------------------------------------------------------------------------------------------------------------------------------------
--------------------------------------------------------------------------------------------------------------------------------------------------------------------------------------------------------
--------------------------------------------------------------------------------------------------------------------------------------------------------------------------------------------------------
---------------r-----------------------------------------------------------------------------------------------------------SSCS2------------------------------------------------------------------------
---------------%%%%%%-----------------------------------------------------------------------------------------------------------------------------------------------------------------------------------
---------------||||||---------#--#------#---#------#--#-----SUS2----------------------------------#---#-----Tt------------------------------------------------------------------------------------------
---------------|||%%%%%%%----##--##----##---##----##--##-----------------------------------------##---##----tt---tt-tt--------g-------------------------------------------------------------------------
%%%%%%%%%%%%%--||||||||||--%%%%--%%%%%%%%---%%%%%%%%--%%%%-----------tt--Tt-------------#--#---%%%%---%%%%--tt---tt-tt-%%%%%%%%%%-----------------------------------------------------------------------
|||||||||||||--||||||||||--||||--||||||||---||||||||--||||-----------tt--tt------------##--##--||||---||||%%%%%%%%%%%%%||||||||||--------%%%%%%%%F%%%%%%%%%%%%%%%%%%%%%%%%%%%%%%%%%%%%%%%%%%%%%%%%%%%%%%
|||||||||||||--|k||||||||--||||--||||||||---||||||||--||||%%%%%%%%%%%%%%%%%%%--------%%%%--%%%%||||---|||||||||||||||||||||||||||%%%--%%%||||||||%||||||||||||||||||||||||||||||||||||||||||||||||||||||
|||||||||||||XXXXXXXXXXXXXX||||--||||||||---||||||||--|||||||||||||||||||||||XXXXXXXX||||--||||||||---||||||||||||||||||||||||||||||--||||||||||||||||||||||||||||||||||||||||||||||||||||||||||||||||||
