HEIGHT=16;WIDTH=201;THEME=0;OVERRIDE=false
--------------------------------------------------------------------------------------------------------------------------------------------------------------------------------------------------------
--------------------------------------------------------------------------------------------------------------------------------------------------------------------------------------------------------
--------------------------------------------------------------------------------------------------------------------------------------------------------------------------------------------------------
--------------------------------------------------------------------------------------------------------------------------------------------------------------------------------------------------------
--------------------------------------------------------------------------------------------------------------------------------------------------------------------------------------------------------
--------------------------------------------------------------------------------------------------------------------------------------------------------------------------------------------------------
--------------------------------------------------------------------------------------------------------------------------------------------------------------------------------------------------------
--------------------------------------------------------------------------------------------------------------------------------------------r-----------------------------------------------------------
--------------------------g-----------------------------------------------------------------------------------------------------------------%%%%--------------------------------------------------------
--------------------------%%%%%%%-----------------------------------------------------------------------------------------SS-SC2------------||||--------------------------------------------------------
--------------------------|||||||--------#--#-----------------------------------#---#-----------------------%%%-----------------------------||||--------------------------------------------------------
--------------------------|||||||-------##--##------tt------------%%%%%%-------##---##----------------------|||-------------%-----y---------||||--------------------------------------------------------
--------------------------||%%%%%%%----###--###-----tt------------||||||------###---###--%%---%%------------|||--%%---%%--y-|yy---%%%%%%----||||----%%%%%%%%F%%%%%%%%%%%%%%%%%%%%%%%%%%%%%%%%%%%%%%%%%%%
--------------------------|||||||||--%%%%%--%%%%%%%%%%%-----------||||||----%%%%%---%%%%%||---||------------|||--||---||%%%%%%%%%-||||||----||||----||||||||%|||||||||||||||||||||||||||||||||||||||||||
%%%%%%%%%%%%%%%%%--%%%%%--|||||||k|--|||||--|||||||||||%%--%%-----||||||--g-|||||---|||||||---||%%%%%%%%%%%%%%%%%||---|||||||||||-||||||g---||||y---||||||||||||||||||||||||||||||||||||||||||||||||||||
|||||||||||||||||--|||||XXXXXXXXXXXXX|||||--|||||||||||||--||XXXXXXXXXXXXXXX|||||---|||||||---|||||||||||||||||||||---|||||||||||XXXXXXXXXXXXXXXXXXX||||||||||||||||||||||||||||||||||||||||||||||||||||
