HEIGHT=16;WIDTH=201;THEME=0;OVERRIDE=false
--------------------------------------------------------------------------------------------------------------------------------------------------------------------------------------------------------
--------------------------------------------------------------------------------------------------------------------------------------------------------------------------------------------------------
--------------------------------------------------------------------------------------------------------------------------------------------------------------------------------------------------------
--------------------------------------------------------------------------------------------------------------------------------------------------------------------------------------------------------
--------------------------------------------------------------------------------------------------------------------------------------------------------------------------------------------------------
------------------------------------------------SCS-----------------------------------------------------------------------------------------------------------------------------------------------------
-------------------------------------------------------------------------------------------------------------%%%%%--------------------------------------------------------------------------------------
-------------------------------------------------------------------------------------------------------------|||||--------------------------------------------------------------------------------------
--------------------------------------------------y----------------------------------------------------------|||||--------------------------------------------------------------------------------------
------------------------------------------------%%%%---------------------------------------#--#-----%%%------|||||--------------------------------------------------------------------------------------
------------------------------------------------||||--------------------------------------##--##----|||------|||||--------------------------------------------------------------------------------------
---------------SCC------------#--#--------------|%%%%%%%---------------------------------###--###---|||-----k|||||--------------------------------------------------------------------------------------
------------------------tt--%%%--%%%%%%%---%%%%-|||gyr||r------#--#----%%%---%%%-------%%%%%--%%%%%%%%%%%%%%%%%%%%%%------------------------------------------------------------------------------------
%%%%%%%%%%%%------------tt--|||--|||||||---||||%%%%%%%%%%%%---##--##---|||---|||-------|||||--||||||||||||||||||||||------------------%%%%%--%%%%%%%%%%%%%F%%%%%%%%%%%%%%%%%%%%%%%%%%%%%%%%%%%%%%%%%%%%%
||||||||||||---------%%%%%%%|||--|||||||---||||||||||||||||--###--###--|||---|||%%---%%|||||--||||||||||||||||||||||%%%%--%%%%--------|||||--|||||||||||||%|||||||||||||||||||||||||||||||||||||||||||||
||||||||||||XXXXXXXXX||||||||||--|||||||---||||||||||||||||XXXXX--XXXXX|||---|||||---|||||||--||||||||||||||||||||||||||--||||XXX--XXX|||||--|||||||||||||||||||||||||||||||||||||||||||||||||||||||||||
