HEIGHT=16;WIDTH=201;THEME=0;OVERRIDE=false
--------------------------------------------------------------------------------------------------------------------------------------------------------------------------------------------------------
--------------------------------------------------------------------------------------------------------------------------------------------------------------------------------------------------------
--------------------------------------------------------------------------------------------------------------------------------------------------------------------------------------------------------
--------------------------------------------------------------------------------------------------------------------------------------------------------------------------------------------------------
--------------------------------------------------------------------------------------------------------------------------------------------------------------------------------------------------------
--------------------------------------------------------------------------------------------------------------------------------------------------------------------------------------------------------
--------------------------------------------------------------------------------------------------------------------------------------------------------------------------------------------------------
--------------------------------%%%---------------------------------------------------------------------------------------------------------------------------------------------------------------------
--------------------------------|||---------------------------------------------------------------------------------------------------------------------------------------------------------------------
--------------------------------|||---------------------------------------------------------------------------------------------------------------------------------------------------------------------
--------------------------------|||-------------------------------------------------------------------------------------------------------#---#---------------------------------------------------------
-------------#--#---------------||%%%%---------------------------------------------------------------------------------------------------##---##--------------------------------------------------------
------------##--##--------------||||||-------------------------%%%%--%%%%-------------------------%%---%%------------------------------%%%%---%%%%------------------------------------------------------
----------%%%%--%%%%%%%%---%%%%-||||||--------%%---%%----------||||--||||----%%%---%%%%%%%%--%%%%%||---||%%--%%-------------%%%%---%%%%||||---||||------------------------------------------------------
----------||||--||||||||---||||-|||r||--------||---||----------||||--||||----|||---||||||||--|||||||---||||--||-------------||||---||||||||---||||%%%%%%%%F%%%%%%%%%%%%%%%%%%%%%%%%%%%%%%%%%%%%%%%%%%%%%
XXXXXXXXXX||||--||||||||---||||XXXXXXXXXXXXXXX||---||XXXX--XXXX||||--||||XXXX|||---||||||||--|||||||---||||--||XXXXX---XXXXX||||---||||||||---||||||||||||X|||||||||||||||||||||||||||||||||||||||||||||
