HEIGHT=16;WIDTH=201;THEME=0;OVERRIDE=false
--------------------------------------------------------------------------------------------------------------------------------------------------------------------------------------------------------
--------------------------------------------------------------------------------------------------------------------------------------------------------------------------------------------------------
--------------------------------------------------------------------------------------------------------------------------------------------------------------------------------------------------------
--------------------------------------------------------------------------------------------------------------------------------------------------------------------------------------------------------
-----------------------------------------------------------------------------------------------------------------------------------%%%%-----------------------------------------------------------------
-----------------------------------------------------------------------------------------------------------------------------------||||-----------------------------------------------------------------
-----------------------------------------------------------------------------------------------------------------------------------||||-----------------------------------------------------------------
-----------------------------------------------------------------------------------------------------------------------------------||||-----------------------------------------------------------------
--------------------------------------------------------------------------------------------------------------------------%%%%-----||||-----------------------------------------------------------------
--------------------------------------------------------------------------------------------------------------------------||||-----||||-----------------------------------------------------------------
--------------------------------------------------------------------------------------------------------------------------||||-----||||-----------------------------------------------------------------
------------------------#--#------#---#-----------------------------------------------CU2---#--#-------------------------y|r||-----|y||-----------------------------------------------------------------
----------------------%%%--%%%---##---##--------------------------------------------------%%%--%%%--------%%%%%---%%%%%%%%%%%%%%%%%%%%%%%%%%%%%%%%F%%%%%%%%%%%%%%%%%%%%%%%%%%%%%%%%%%%%%%%%%%%%%%%%%%%%%
----------------#--#--|||--|||--###---###-------%%%%---%%%%------%%%---%%%----------------|||--|||%%%%%%--|||||---||||||||||||||||||||||||||||||||%|||||||||||||||||||||||||||||||||||||||||||||||||||||
%%%%%%%%%%%%%%%%%--%%%|||--|||%%%%%---%%%%%-----||||---||||%%--%%|||---|||----------ryr-k-|||--|||||||||%%|||||---||||||||||||||||||||||||||||||||||||||||||||||||||||||||||||||||||||||||||||||||||||||
|||||||||||||||||--||||||--||||||||---|||||XXXXX||||---||||||--|||||---|||XXX--XXXXXXXXXXX|||--||||||||||||||||---||||||||||||||||||||||||||||||||||||||||||||||||||||||||||||||||||||||||||||||||||||||
