HEIGHT=16;WIDTH=201;THEME=0;OVERRIDE=false
--------------------------------------------------------------------------------------------------------------------------------------------------------------------------------------------------------
--------------------------------------------------------------------------------------------------------------------------------------------------------------------------------------------------------
--------------------------------------------------------------------------------------------------------------------------------------------------------------------------------------------------------
--------------------------------------------------------------------------------------------------------------------------------------------------------------------------------------------------------
--------------------------------------------------------------------------------------------------------------------------------------------------------------------------------------------------------
--------------------------------------------------------------------------------------------------------------------------------------------------------------------------------------------------------
--------------------------------------------------------------------------------------------------------------------------------------------------------------------------------------------------------
--------------------------------------------------------------------------------------------------------------------------------------------------------------------------------------------------------
----------------------------------------------------------------------------------------------------------k---------------------------------------------------------------------------------------------
----------------------------------------------------------------------------------------------------------%%%%%-----------------------------------------------------------------------------------------
----------------------------------------------------------------------------------------------------------|||||-----------------------------------------------------------------------------------------
----------------------------------------------------------------------------------------------------------|||||-----------------------------------------------------------------------------------------
----------------------------------------#--#---------------------------------------------%%---------------||r||-------%%%%%--%%%%%%%%--%%%%%%%%%%%F%%%%%%%%%%%%%%%%%%%%%%%%%%%%%%%%%%%%%%%%%%%%%%%%%%%%%
--------------------%%--%%------------%%%--%%%--------%%%%---%%%%------------------%%%%%%||--------%%%%%%%%%%%%%%%%%%%|||||--||||||||--|||||||||||%|||||||||||||||||||||||||||||||||||||||||||||||||||||
%%%%%%%%%%%%%%%---%%||--||%%%%%--%%%%%|||--|||--------||||---||||------------------||||||||--------||||||||||||||||||||||||--||||||||--|||||||||||||||||||||||||||||||||||||||||||||||||||||||||||||||||
|||||||||||||||---||||--|||||||--||||||||--|||XXX--XXX||||---||||XXXX---XXXXXX---XX||||||||XXXXXXXX||||||||||||||||||||||||--||||||||--|||||||||||||||||||||||||||||||||||||||||||||||||||||||||||||||||
