HEIGHT=16;WIDTH=201;THEME=0;OVERRIDE=false
--------------------------------------------------------------------------------------------------------------------------------------------------------------------------------------------------------
--------------------------------------------------------------------------------------------------------------------------------------------------------------------------------------------------------
--------------------------------------------------------------------------------------------------------------------------------------------------------------------------------------------------------
--------------------------------------------------------------------------------------------------------------------------------------------------------------------------------------------------------
--------------------------------------------------------------------------------------------------------------------------------------------------------------------------------------------------------
--------------------------------------------------------------------------------------------------------------------------------------------------------------------------------------------------------
--------------------------------------------------------------------------------------------------------------------------------------------------------------------------------------------------------
--------------------------------------------------------------------------------------------------------------------------------------------------------------------------------------------------------
------------------------------------SSS-----------------------------------------------------------------------------------------------------------------------------------------------------------------
--------------------------------------------------------------------------------------------------------------------------------------------------------------------------------------------------------
----------------------------------------------------------------------------------------------------#--#------------------------------------------------------------------------------------------------
---------------------------------------------------------------------------------------------------##--##-----------------------------------------------------------------------------------------------
---------------tt-tt---------------%%%%%%-------------------------------------%%%%%--%%%%%-------%%%%--%%%%%%%%%--%%%%%---------------------------------------------------------------------------------
%%%%%%%%%%%%---tt-tt--tt----#--#---||||||-------------------%%%%%-------------|||||--|||||-------||||--|||||||||--|||||%%--%%---------------------------------------------------------------------------
||||||||||||---tt-tt--tt---##--##--||||||%%%%--%%%%%%-------|||||-------------|||||--|||||%%---%%||||--|||||||||--|||||||--||------%%%%---%%%%%%%%%%%%F%%%%%%%%%%%%%%%%%%%%%%%%%%%%%%%%%%%%%%%%%%%%%%%%%
||||||||||||XXXXXXXXXXXXXXXXX--XXXX||||||||||--||||||XX---XX|||||XXXXX---XXXXX|||||--|||||||---||||||--|||||||||--|||||||--||XX--XX||||---||||||||||||X|||||||||||||||||||||||||||||||||||||||||||||||||
