HEIGHT=16;WIDTH=201;THEME=0;OVERRIDE=false
--------------------------------------------------------------------------------------------------------------------------------------------------------------------------------------------------------
--------------------------------------------------------------------------------------------------------------------------------------------------------------------------------------------------------
--------------------------------------------------------------------------------------------------------------------------------------------------------------------------------------------------------
--------------------------------------------------------------------------------------------------------------------------------------------------------------------------------------------------------
--------------------------------------------------------------------------------------------------------------------------------------------------------------------------------------------------------
--------------------------------------------------------------------------------------------------------------------------------------------------------------------------------------------------------
--------------------------------------------------------------------------------------------------------------------------------------------------------------------------------------------------------
--------------------------------------------------------------------------------------------------------------------------------------------------------------------------------------------------------
--------------------------------------------------------------------------------------------------------------------------------------------------------------------------------------------------------
--------------------------------------------------------------------------------------------------------------------------------------------------------------------------------------------------------
----------------------------------------------------SCC-------------------------------------------------------------------------------------------------------------------------------------------------
-------------------------------------------------------------------------------------------------------tt-----------------------------------------------------------------------------------------------
------------------%%%%%----%%%%%%%%%%%-----------------------%%%%%--%%%%%%%--%%---------#---#-------tt-tt----%%%%--%%%%--------#---#---------%%%%%%%%F%%%%%%%%%%%%%%%%%%%%%%%%%%%%%%%%%%%%%%%%%%%%%%%%%%
------------------|||||----|||||||||||--------------------%%%|||||--|||||||--||--------##---##------tt-tt----||||--||||------%%%---%%%%%---%%||||||||%||||||||||||||||||||||||||||||||||||||||||||||||||
-------------g----||||r----|||||||||||%%%%%---%%%%%%%%%%%%||||||||--|||||||--||-------###---###--%%%%%%%%%%%%||||--||||%%--%%|||---|||||---|||||||||||||||||||||||||||||||||||||||||||||||||||||||||||||
XXXXXXXXXXXXXXXXXXXXXXXXXXX||||||||||||||||---||||||||||||||||||||--|||||||--||XXXXXXXXXX---XXXXX||||||||||||||||--||||||--|||||---|||||---|||||||||||||||||||||||||||||||||||||||||||||||||||||||||||||
