HEIGHT=16;WIDTH=201;THEME=0;OVERRIDE=false
--------------------------------------------------------------------------------------------------------------------------------------------------------------------------------------------------------
--------------------------------------------------------------------------------------------------------------------------------------------------------------------------------------------------------
--------------------------------------------------------------------------------------------------------------------------------------------------------------------------------------------------------
--------------------------------------------------------------------------------------------------------------------------------------------------------------------------------------------------------
--------------------------------------------------------------------------------------------------------------------------------------------------------------------------------------------------------
--------------------------------------------------------------------------------------------------------------------------------------------------------------------------------------------------------
--------------------------------------------------------------------------------------------------------------------------------------------------------------------------------------------------------
--------------------------------------------------------------------------------------------------------------------------------------------------------------------------------------------------------
----------------%%%%---------------------------------------------------------------------------------------------------------%%%------------------------------------------------------------------------
----------------||||---------------------------------------------------------------------------------------------------------|||------------------------------------------------------------------------
----------------||||---------------------------------------------------------------------------------CUCC--------------------|||------------------------------------------------------------------------
----------------|||%%%-------------------------------------------------------------------------------------------------------|||---G--------------------------------------------------------------------
----------------||||||--------------------------------------%%%%%%%----------------------------------------------------------|||---%%%%-----------------------------------------------------------------
----------------||||||--------------%%%%%--%%%%%%%%%%--%%%%%|||||||----------------------#---#-------------------------------|||---|||y--%%%%%%%%F%%%%%%%%%%%%%%%%%%%%%%%%%%%%%%%%%%%%%%%%%%%%%%%%%%%%%%
%%%%%%%%%%%%----||||||---------%%%%%|||||--||||||||||--||||||||||||%%%%--#--#--%%%%%%%--##---##--%%%%%%%%%%---r--%%%%---%%%%%%%%%%%%%%%%%||||||||%||||||||||||||||||||||||||||||||||||||||||||||||||||||
||||||||||||XXXXXXXXXXXXXX---XX||||||||||--||||||||||--||||||||||||||||XXX--XXX|||||||XXXX---XXXX||||||||||XXXXXX||||---||||||||||||||||||||||||||||||||||||||||||||||||||||||||||||||||||||||||||||||||
