HEIGHT=16;WIDTH=201;THEME=0;OVERRIDE=false
--------------------------------------------------------------------------------------------------------------------------------------------------------------------------------------------------------
--------------------------------------------------------------------------------------------------------------------------------------------------------------------------------------------------------
--------------------------------------------------------------------------------------------------------------------------------------------------------------------------------------------------------
--------------------------------------------------------------------------------------------------------------------------------------------------------------------------------------------------------
------------------------------------------------------------------------SU------------------------------------------------------------------------------------------------------------------------------
--------------------------------------------------------------------------------------------------------------------------------------------------------------------------------------------------------
--------------------------------------------------------------------------%-----------------------------------------------------------------------------------------------------------------------------
--------------------------------------------------------------------------|-----------------------------------------------------------------------------------------------------------------------------
------------------------------------------------------------------------%%%-----------------------------------------------------------------------------------------------------------------------------
------------------------------------------------------------------------|||-----------------------------------------------------------------------------------------------------------------------------
------------------------------------------------------------------------|||------------------------2C2CC-2S---------------------------------------------------------------------------------------------
----------------------------------------------#---#---------------------|||-----------------------------------------------------------------------------------------------------------------------------
%%%%%%%%%%%%---------------------------------##---##---%%%%--%%%%---%%%%%||-----------------------------%--------------------------------------%%%%%%%%F%%%%%%%%%%%%%%%%%%%%%%%%%%%%%%%%%%%%%%%%%%%%%%%%
||||||||||||------------------------#--#----###---###--||||--||||---|||||||---%%%--%%%-------------y-y--|y-------------%%%%%%---%%%%-----------||||||||%||||||||||||||||||||||||||||||||||||||||||||||||
||||||||||||----------%%%%%--%%%%%%%%--%%%%%%%%---%%%%%||||--||||---||||||y---|||--|||%%%--%%%----%%%%%%%%%%-----------||||||---||||%%%%%%%%%%%|||||||||||||||||||||||||||||||||||||||||||||||||||||||||
||||||||||||XXXXXXXXXX|||||--||||||||--||||||||---|||||||||--||||XXXXXXXXXXXXX|||--||||||--|||XXXX||||||||||XXXX---XXXX||||||---||||||||||||||||||||||||||||||||||||||||||||||||||||||||||||||||||||||||
