HEIGHT=16;WIDTH=201;THEME=0;OVERRIDE=false
--------------------------------------------------------------------------------------------------------------------------------------------------------------------------------------------------------
--------------------------------------------------------------------------------------------------------------------------------------------------------------------------------------------------------
--------------------------------------------------------------------------------------------------------------------------------------------------------------------------------------------------------
--------------------------------------------------------------------------------------------------------------------------------------------------------------------------------------------------------
--------------------------------------------------------------------------------------------------------------------------------------------------------------------------------------------------------
--------------------------------------------------------------------------------------------------------------------------------------------------------------------------------------------------------
--------------------------------------------------------------------------------------------------------------------------------------------------------------------------------------------------------
--------------------------------------------------------------------------------------------------------------------------------------------------------------------------------------------------------
--------------------------------------------------------------------------------------------------------------------------------------------------------------------------------------------------------
------------------------------------------------------------------------------------------------------------------------------------------k-------------------------------------------------------------
---------------------------------------------------------------------SS-SCS-------------------------------------------------------------%%%%------------------------------------------------------------
----------------------------------------------------------------------------------------------------------------------------------------||||------------------------------------------------------------
%%%%%%%%%%%-----------------#---#----------------------r---------------%----%%%---%%%--------%%--%%-----------------------r--%%%---%%%--||||------------------------------------------------------------
|||||||||||%%--%%---------%%%---%%%---------------%%%%%%%------------y-|----|||---|||--------||--||--------------#--#--%%%%%%|||---|||--||||-------g----------------------------------------------------
|||||||||||||--||%%%---%%%|||---|||---------------|||||||---------%%%%%%%%%%|||---|||--------||--||%%%%%--%%%%%%%%--%%%|||||||||---|||%%%%%%%%%%%%%%%%--------------------------------------------------
|||||||||||||--|||||---||||||---|||XXX---XXXXXXXXXXXXXXXXXXXXXXXXX|||||||||||||---|||XXX--XXX||--|||||||--||||||||--||||||||||||---|||||||||||||||||||XXXXXXXXFXXXXXXXXXXXXXXXXXXXXXXXXXXXXXXXXXXXXXXXXX
