HEIGHT=16;WIDTH=201;THEME=0;OVERRIDE=false
--------------------------------------------------------------------------------------------------------------------------------------------------------------------------------------------------------
--------------------------------------------------------------------------------------------------------------------------------------------------------------------------------------------------------
--------------------------------------------------------------------------------------------------------------------------------------------------------------------------------------------------------
--------------------------------------------------------------------------------------------------------------------------------------------------------------------------------------------------------
--------------------------------------------------------------------------------------------------------------------------------------------------------------------------------------------------------
--------------------------------------------------------------------------------------------------------------------------------------------------------------------------------------------------------
--------------------------------------------------------------------------------------------------------------------------------------------------------------------------------------------------------
--------------------------------------------------------------------------------------------------------------------------------------------------------------------------------------------------------
--------------------------------------------------------------------------------------------------------------------------------------------------------------------------------------------------------
--------------------------------------------------------------------------------------------------------CSSS--------------------------------------------------------------------------------------------
--------------------------------------------------------------------------------------------------------------------------------------------------------------------------------------------------------
--------------------------------------------------------------------------------------------------------------------------------------SSSSC-------------------------------------------------------------
--------------------------------------------------------------------------------------------r----------------%%%%%----------------------------%%%%%%%%F%%%%%%%%%%%%%%%%%%%%%%%%%%%%%%%%%%%%%%%%%%%%%%%%%
------------%%---%%--------%%%%%%%%%--#--#------------%%%%%%%%%%---%%%%%----------------%%%%%%------%%%%%%%%%|||||----------------------------||||||||%|||||||||||||||||||||||||||||||||||||||||||||||||
%%%%%%%%%%%%||---||--------|||||||||%%%--%%%%%%%%%%%%%||||||||||---|||||--------------y-||||||-g----||||||||||||||%%%%%---%%%%%---------------||||||||||||||||||||||||||||||||||||||||||||||||||||||||||
||||||||||||||---||XXXXXXXX||||||||||||--|||||||||||||||||||||||---|||||XXXX---XXXXXXXXXXXXXXXXXXXXX|||||||||||||||||||---|||||XX--XXXXXXXXXXX||||||||||||||||||||||||||||||||||||||||||||||||||||||||||
