HEIGHT=16;WIDTH=201;THEME=0;OVERRIDE=false
--------------------------------------------------------------------------------------------------------------------------------------------------------------------------------------------------------
--------------------------------------------------------------------------------------------------------------------------------------------------------------------------------------------------------
--------------------------------------------------------------------------------------------------------------------------------------------------------------------------------------------------------
--------------------------------------------------------------------------------------------------------------------------------------------------------------------------------------------------------
--------------------------------------------------------------------------------------------------------------------------------------------------------------------------------------------------------
--------------------------------------------------------------------------------------------------------------------------------------------------------------------------------------------------------
--------------------------------------------------------------------------------------------------------------------------------------------------------------------------------------------------------
--------------------------------------------------------------------------------------------------------------------------------------------------------------------------------------------------------
--------------------------------------------------------------------------------------------------------------------------------------------------------------------------------------------------------
------------------------------------------r----r-----------------k------------------------#---#---------------------------------------------------------------------------------------------------------
------------------------------------------%%%%%%%---------------%%%%---------------------##---##------#--#----------------------------------------------------------------------------------------------
------------------------------------------||k|r||-g-------------||||--------------------###---###----##--##---------------------------------------------------------------------------------------------
%%%%%%%%%%%%%--------%%---%%-------------%%%%%%%%%%%------------||||-------%%%--%%%---%%%%%---%%%%%%%%%--%%%%%%%%%%%%%%---%%----------------------------------------------------------------------------
|||||||||||||%%%--%%%||---||-------------|||||||||||---------y--||||-------|||--|||---|||||---|||||||||--||||||||||||||---||----------------------------------------------------------------------------
||||||||||||||||--|||||---||%%%%%---%%%%%|||||||||||--------%%%%%%%%%%%%%%%|||--|||---|||||---|||||||||--||||||||||||||---||%%%%-------------%%%%%%%%F%%%%%%%%%%%%%%%%%%%%%%%%%%%%%%%%%%%%%%%%%%%%%%%%%%
||||||||||||||||--|||||---|||||||---||||||||||||||||XXXXXXXX||||||||||||||||||--|||XXX|||||---|||||||||--||||||||||||||---||||||XXXXX---XXXXX||||||||X||||||||||||||||||||||||||||||||||||||||||||||||||
