HEIGHT=16;WIDTH=201;THEME=0;OVERRIDE=false
--------------------------------------------------------------------------------------------------------------------------------------------------------------------------------------------------------
--------------------------------------------------------------------------------------------------------------------------------------------------------------------------------------------------------
--------------------------------------------------------------------------------------------------------------------------------------------------------------------------------------------------------
--------------------------------------------------------------------------g-----------------------------------------------------------------------------------------------------------------------------
---------------------------------------------------------------------%%%%%%%----------------------------------------------------------------------------------------------------------------------------
---------------------------------------------------------------------|||||||----------------------------------------------------------------------------------------------------------------------------
---------------------------------------------------------------------|||||||----------------------------------------------------------------------------------------------------------------------------
--------------------------------------------------------------------r||g||||----------------------------------------------------------------------------------------------------------------------------
-------------------------------------SS-CCSS-----------------------%%%%%%%||------------------------------------------------SUS-------------------------------------------------------------------------
-------------------------------------------------------------------|||||||||--------------------Tt------------------------------------------------------------------------------------------------------
---------------------------------------|---------------------------|||||||||--------------------tt------------------------------------------------------------------------------------------------------
---------------------------------------y---------------------------|||||||||--------------------tt--%%%-------------------------------------------------------------------------------------------------
------------------------------------%%%%%%%%%----------%%%---%%%%%%%%%%%%%%%%%%%%%---%%%%%%%%%%%%%%-|||k------%%--------%%%%%%%%------------------------------------------------------------------------
------------%%%%---%%%%-------------|||||||||%%%%%%%%%%|||---|||||||||||||||||||||%%%||||||||||||||%%%%%%%%%%%||--tt----||||||||--#---#-----------------------------------------------------------------
------------||||---||||%%%%%---%%%%%||||||||||||||||||||||---|||||||||||||||||||||||||||||||||||||||||||||||||||--tt----||||||||%%%---%%%%%%%%%%%F%%%%%%%%%%%%%%%%%%%%%%%%%%%%%%%%%%%%%%%%%%%%%%%%%%%%%%
XXXXXXXXXXXX||||---|||||||||---|||||||||||||||||||||||||||---|||||||||||||||||||||||||||||||||||||||||||||||||||XXXXXXXX|||||||||||---|||||||||||X||||||||||||||||||||||||||||||||||||||||||||||||||||||
