HEIGHT=16;WIDTH=201;THEME=0;OVERRIDE=false
--------------------------------------------------------------------------------------------------------------------------------------------------------------------------------------------------------
--------------------------------------------------------------------------------------------------------------------------------------------------------------------------------------------------------
--------------------------------------------------------------------------------------------------------------------------------------------------------------------------------------------------------
--------------------------------------------------------------------------------------------------------------------------------------------------------------------------------------------------------
--------------------------------------------------------------------------------------------------------------------------------------------------------------------------------------------------------
--------------------------------------------------------------------------------------------------------------------------------------------------------------------------------------------------------
--------------------------------------------------------------------------------------------------------------------------------------------------------------------------------------------------------
--------------------------------------------------------------------------------------------------------------------------------------------------------------------------------------------------------
------------------------------------------------------------------------------------SSSS2S--------------------------------------------------------------------------------------------------------------
--------------------------------------------------------------------------------------------------------------------------------------------------------------------------------------------------------
--------------------------------------------------------------------------------------------------------------------------------------------------------------------------------------------------------
----------------------------------------------------------------------------SUC2------------------------------------------------------------------------------------------------------------------------
%%%%%%%%%%%%%--------------------------------------------#--#--------------------%%%%%%%%%%%------------------------------%%%%--------------------------------------------------------------------------
|||||||||||||---%%%%%%%%%%%%%%%-------------------------##--##-------------------|||||||||||%%%---%%%---------------------||||--------------------------------------------------------------------------
|||||||||||||%%%|||||||||||||||---------------%%%--%%%%%%%--%%%%%%%%--%%%%-------||||||||||||||---|||---------------------||||%%%--%%%------------------------------------------------------------------
|||||||||||||||||||||||||||||||XXX--XXXXXXXXXX|||--|||||||--||||||||--||||XXXXXXX||||||||||||||---|||XXXXX--XXXXXXXX---XXX|||||||--|||XXX--XXXXXXXXXXXFXXXXXXXXXXXXXXXXXXXXXXXXXXXXXXXXXXXXXXXXXXXXXXXXX
