HEIGHT=16;WIDTH=201;THEME=0;OVERRIDE=false
--------------------------------------------------------------------------------------------------------------------------------------------------------------------------------------------------------
--------------------------------------------------------------------------------------------------------------------------------------------------------------------------------------------------------
--------------------------------------------------------------------------------------------------------------------------------------------------------------------------------------------------------
--------------------------------------------------------------------------------------------------------------------------------------------------------------------------------------------------------
--------------------------------------------------------------------------------------------------------------------------------------------------------------------------------------------------------
--------------------------------------------------------------------------------------------------------------------------------------------------------------------------------------------------------
--------------------------------------------------------------------------------------------------------------------------------------------------------------------------------------------------------
--------------------------------------------------------------------------------------------------------------------------------------------------------------------------------------------------------
--------------------------------------------------------------------------------------------------------------------------------------------------------------------------------------------------------
--------------------------------------------------------------------------------------------------------------------------------------------------------------------------------------------------------
--------------------------------------------------------------------------------------------------------------------------------------------------------------------------------------------------------
--------------------------------------#--#------------------------------#---#---------------------------------------------------------------------------------------------------------------------------
%%%%%%%%%%%%%%----#---#--------------##--##--------------%%%%--%%%%---%%%---%%%-------------------%%%%%%%%%%--#---#-------------------------------------------------------------------------------------
||||||||||||||---##---##-----------%%%%--%%%%%%%%%--%%%%%||||--||||---|||---|||%%---%%--------%%%%||||||||||%%%---%%%%%--%%%%%---%%%--------------------------------------------------------------------
||||||||||||||--###---###--%%%--%%%||||--|||||||||--|||||||||--||||%%%|||---|||||---||%%%--%%%|||||||||||||||||---|||||--|||||---|||------%%%%%%%%F%%%%%%%%%%%%%%%%%%%%%%%%%%%%%%%%%%%%%%%%%%%%%%%%%%%%%
||||||||||||||XXXXX---XXXXX|||--|||||||--|||||||||--|||||||||--||||||||||---|||||---|||||--||||||||||||||||||||---|||||--|||||---|||XX--XX||||||||X|||||||||||||||||||||||||||||||||||||||||||||||||||||
