HEIGHT=16;WIDTH=201;THEME=0;OVERRIDE=false
--------------------------------------------------------------------------------------------------------------------------------------------------------------------------------------------------------
--------------------------------------------------------------------------------------------------------------------------------------------------------------------------------------------------------
--------------------------------------------------------------------------------------------------------------------------------------------------------------------------------------------------------
--------------------------------------------------------------------------------------------------------------------------------------------------------------------------------------------------------
--------------------------------------------------------------------------------------------------------------------------------------------------------------------------------------------------------
--------------------------------------------------------------------------------------------------------------------------------------------------------------------------------------------------------
--------------------------------------------------------------------------------------------------------------------------------------------------------------------------------------------------------
-----------------------------------------------------------------SCSS-----------------------------------------------------------------------------------------------------------------------------------
--------------------------------------------------------------------------------------------------------------------------------------------------------------------------------------------------------
--------------------------------------------------SSCS--------------------------------------------------------------------------------------------------------------------------------------------------
--------------------------------------------------------------------k-----------------------------------------------------------------------------------------------------------------------------------
-----------------------------------------SSC--------------------%%%%%-----------------------------------------------------------------------------------------------------------------------------------
-----------------%%%-----------%%---%%--------------k-----------|||||-----------------------------------------------------------------------------------------------------------------------------------
%%%%%%%%%%----g--|||--r--------||---||--|-------%%%%%%%---------|||||--------#--#----------------------%%%---%%%---#--#------------%%%%---%%%%----------------------------------------------------------
||||||||||%%%%%%%%%%%%%%%------||---||--y----y--|||||||---------|||||-------##--##----#--#-------------|||---|||--##--##-----------||||---||||----------------------------------------------------------
|||||||||||||||||||||||||XX--XX||---||XXXXXXXXXX|||||||XXXXXXXXXXXXXXXXXXXXXXX--XXXXXXX--XXXXXXX---XXXX|||---|||XXXX--XXXXXXX---XXX||||---||||XXXXXXXXFXXXXXXXXXXXXXXXXXXXXXXXXXXXXXXXXXXXXXXXXXXXXXXXXX
