HEIGHT=16;WIDTH=201;THEME=0;OVERRIDE=false
--------------------------------------------------------------------------------------------------------------------------------------------------------------------------------------------------------
--------------------------------------------------------------------------------------------------------------------------------------------------------------------------------------------------------
--------------------------------------------------------------------------------------------------------------------------------------------------------------------------------------------------------
--------------------------------------------------------------------------------------------------------------------------------------------------------------------------------------------------------
--------------------------------------------------------------------------------------------------------------------------------------------------------------------------------------------------------
--------------------------------------------------------------------------------------------------------------------------------------------------------------------------------------------------------
-------------------------------------------y------------------------------------------------------------------------------------------------------------------------------------------------------------
--------------------------------------%%%%%%------------------------------------------------------------------------------------------------------------------------------------------------------------
--------------------------------------||||||-------------------%%%--------------------------------------------------------------------------------------------------------------------------------------
--------------------------------------|||g||-------------------|||--------------------------------------------------------------------------------------------------------------------------------------
------------------------------------%%%%%%%|-------------------|||-------------tt---------#---#---------------------------------------------------------------------------------------------------------
-----------------------------------k|||gr|||----------------g--k||--------Tt---tt--------##---##--------------Tt----------------------------------------------------------------------------------------
---------------------%%%%%---%%%%%%%%%%%%%%%%%%%--%%%%%%%%%%%%%%%%%%%-----tt---tt-------###---###--%%---%%----tt-%%--%%---------------------------------------------------------------------------------
---------------------|||||---|||||||||||||||||||%%|||||||||||||||||||---%%%%%%%%%%%%%%%%%%%---%%%%%||---||----tt-||--||---------%%%---------------------------------------------------------------------
%%%%%%%%%%%%%%%%---%%|||||---||||||||||||||||||||||||||||||||||||||||---|||||||||||||||||||---|||||||---||%%%%%%%||--||%%%---%%%|||--#--#---------------------------------------------------------------
||||||||||||||||---|||||||---||||||||||||||||||||||||||||||||||||||||XXX|||||||||||||||||||---|||||||---|||||||||||--|||||---||||||XXX--XXXXXXXXXXXFXXXXXXXXXXXXXXXXXXXXXXXXXXXXXXXXXXXXXXXXXXXXXXXXXXXX
