HEIGHT=16;WIDTH=201;THEME=0;OVERRIDE=false
--------------------------------------------------------------------------------------------------------------------------------------------------------------------------------------------------------
--------------------------------------------------------------------------------------------------------------------------------------------------------------------------------------------------------
--------------------------------------------------------------------------------------------------------------------------------------------------------------------------------------------------------
--------------------------------------------------------------------------------------------------------------------------------------------------------------------------------------------------------
--------------------------------------------------------------------------------------------------------------------------------------------------------------------------------------------------------
--------------------------------------------------------------------------------------------------------------------------------------------------------------------------------------------------------
--------------------------------------------------------------------------------------------------------------------------------------------------------------------------------------------------------
--------------------------------------------------------------------------------------------------------------------------------------------------------------------------------------------------------
------------------------SSUSSS--------------------------------------------------------------------------------------------------------------------------------------------------------------------------
--------------------------------------------------------------------------------------------------------------tt----------------------------------------------------------------------------------------
--------------------------------------------------------------------------------------------------------------tt----------------------Tt----------------------------------------------------------------
----------------------------r-g----------------------------------------g-kk-----------------------------------tt----------------------tt----------------------------------------------------------------
%%%%%%%%%%%%%%%%%--%%%%%%%%%%%%%%------%%%%---%%%%------------------%%%%%%%----#---#-----------------------%%%%%%%%---------------%%%%%%%---------------------------------------------------------------
|||||||||||||||||--||||||||||||||------||||---||||--------------y---|||||||--%%%---%%%-------------%%%--%%%||||||||%%--%%---------|||||||---------------------------------------------------------------
|||||||||||||||||--||||||||||||||%%--%%||||---||||-------------%%%%%%%%%%%%%%|||---|||--------%%%%%|||--|||||||||||||--||%%%---%%%|||||||---------------------------------------------------------------
|||||||||||||||||--||||||||||||||||--||||||---||||XXXXX---XXXXX|||||||||||||||||---|||XXX--XXX||||||||--|||||||||||||--|||||---||||||||||XXXXXXXXFXXXXXXXXXXXXXXXXXXXXXXXXXXXXXXXXXXXXXXXXXXXXXXXXXXXXXX
