HEIGHT=16;WIDTH=201;THEME=0;OVERRIDE=false
--------------------------------------------------------------------------------------------------------------------------------------------------------------------------------------------------------
--------------------------------------------------------------------------------------------------------------------------------------------------------------------------------------------------------
--------------------------------------------------------------------------------------------------------------------------------------------------------------------------------------------------------
--------------------------------------------------------------------------------------------------------------------------------------------------------------------------------------------------------
--------------------------------------------------------------------------------------------------------------------------------------------------------------------------------------------------------
--------------------------------------------------------------------------------------------------------------------------------------------------------------------------------------------------------
--------------------------------------------------------------------------------------------------------------------------------------------------------------------------------------------------------
--------------------------------------------------------------------------------------------------------------------------------------------------------------------------------------------------------
----------------------------------------------------------------------------------------------------------------------------------------SSUS22----------------------------------------------------------
-------------------------#--#--------#---#--------------------------------------------------------------------------------------------------------------------------------------------------------------
------------------------##--##------##---##--------------------SUSSU------------------------------------------------------------------------------------------------------------------------------------
-----------------------###--###----###---###--------------------------------------------------------------------------------Tt----tt---r----------------------------------------------------------------
---------------------%%%%%--%%%%%%%%%%---%%%%%--------------------------------------------------------------%%--%%----------tt----tt-%%%%%%%%%%---------------------------------------------------------
-----------%%%%--%%%%|||||--||||||||||---|||||%%%%%----------------------------------------#---#------------||--||%%---%%%%%%%%%%%%%%||||||||||---------------------------------------------------------
-----------||||--|||||||||--||||||||||---||||||||||---------%%%%%%%%%%%------------%%%%%%%%%---%%%%%%%--%%%%||--||||---||||||||||||||||||||||||---------------------------------------------------------
XXXXXXXXXXX||||--|||||||||--||||||||||---||||||||||XXX---XXX|||||||||||XXXXX--XXXXX|||||||||---|||||||--||||||--||||---||||||||||||||||||||||||XXXXXXXXFXXXXXXXXXXXXXXXXXXXXXXXXXXXXXXXXXXXXXXXXXXXXXXXX
