HEIGHT=16;WIDTH=201;THEME=0;OVERRIDE=false
--------------------------------------------------------------------------------------------------------------------------------------------------------------------------------------------------------
--------------------------------------------------------------------------------------------------------------------------------------------------------------------------------------------------------
--------------------------------------------------------------------------------------------------------------------------------------------------------------------------------------------------------
--------------------------------------------------------------------------------------------------------------------------------------------------------------------------------------------------------
--------------------------------------------------------------------------------------------------------------------------------------------------------------------------------------------------------
--------------------------------------------------------------------------------------------------------------------------------------------------------------------------------------------------------
-------------------------------------------------------------------------%%%%%--------------------------------------------------------------------------------------------------------------------------
-------------------------------------------------------------------------|||||--------------------------------------------------------------------------------------------------------------------------
-------------------------------------------------------------------------|||||--------------------------------------------------------------------------------------------------------------------------
-------------------------------------------------------------------------|||||--------------------------------------------------------------------------------------------------------------------------
-------------------------------------------------------------------------||||%%%------------------------------------------------------------------------------------------------------------------------
-------------------------------------------------------------------------|||||||------------------------------------------------------------------------------------------------------------------------
%%%%%%%%%%%%----k-------------------%%%%---%%%%--------------------------|||||||--------#--#--------------------------%%%%%--%%%%%----------------------------------------------------------------------
||||||||||||%%%%%%------------------||||---||||%%%%--%%%%-------------%%%%%%%%%%%%%%%%%%%--%%%%%%---%%%------%%--%%---|||||--|||||--#--#--%%%%%%%%F%%%%%%%%%%%%%%%%%%%%%%%%%%%%%%%%%%%%%%%%%%%%%%%%%%%%%
||||||||||||||||||%%%%%--%%%%%------||||---||||||||--||||-----%%%--%%%|||||||||||||||||||--||||||---|||%%--%%||--||%%%|||||--|||||%%%--%%%||||||||%|||||||||||||||||||||||||||||||||||||||||||||||||||||
|||||||||||||||||||||||--|||||XXXXXX||||---||||||||--||||XXXXX|||--||||||||||||||||||||||--||||||---|||||--||||--||||||||||--||||||||--|||||||||||||||||||||||||||||||||||||||||||||||||||||||||||||||||
