HEIGHT=16;WIDTH=201;THEME=0;OVERRIDE=false
--------------------------------------------------------------------------------------------------------------------------------------------------------------------------------------------------------
--------------------------------------------------------------------------------------------------------------------------------------------------------------------------------------------------------
--------------------------------------------------------------------------------------------------------------------------------------------------------------------------------------------------------
--------------------------------------------------------------------------------------------------------------------------------------------------------------------------------------------------------
--------------------------------------------------------------------------------------------------------------------------------------------------------------------------------------------------------
---------------------------------------------------------------------------------------------r----------------------------------------------------------------------------------------------------------
-------------------------------------------------------------------------------------------%%%%%%%------------------------------------------------------------------------------------------------------
-------------------------------------------------------------------------------------------|||||||------------------------------------------------------------------------------------------------------
------------------------------------%%%%-------S2US2---------------------------------------||||||y------------------------------------------------------------------------------------------------------
------------------------------------||||---------------------------------------------------||||%%%%%----------------------------------------------------------------------------------------------------
--------------SSCS------------------||||---------------------------------------------------|||||||||----------------------------------------------------------------------------------------------------
-------------------------------r----g|||------k-----K------------------#--#----------------|||||||||----------------------------------------------------------------------------------------------------
----------------------#---#----%%%%%%%||-----%%%%%%%%%---Tt-tt-tt-----##--##---------------|||||||||-y--------------------------------------------------------------------------------------------------
---------------------##---##---|||||||||k----|||||||||---tt-tt-tt---%%%%--%%%%--#---#------|||||%%%%%%%---------------%%%%------------------------------------------------------------------------------
%%%%%%%%%%%%%%%%%%%%%%%---%%%%%%%%%%%%%%%%%%%|||||||||%%%%%%%%%%%%%%||||--||||%%%---%%%----||||||||||||---------------||||--#---#-----------------------------------------------------------------------
|||||||||||||||||||||||---||||||||||||||||||||||||||||||||||||||||||||||--|||||||---|||XXXXXXXXXXXXXXXXXXXXXXXX--XXXXX||||XXX---XXXXXXX--XXXXXXXXXXXXFXXXXXXXXXXXXXXXXXXXXXXXXXXXXXXXXXXXXXXXXXXXXXXXXXX
