HEIGHT=16;WIDTH=201;THEME=0;OVERRIDE=false
--------------------------------------------------------------------------------------------------------------------------------------------------------------------------------------------------------
--------------------------------------------------------------------------------------------------------------------------------------------------------------------------------------------------------
--------------------------------------------------------------------------------------------------------------------------------------------------------------------------------------------------------
--------------------------------------------------------------------------------------------------------------------------------------------------------------------------------------------------------
--------------------------------------------------------------------------------------------------------------------------------------------------------------------------------------------------------
--------------------------------------------------------------------------------------------------------------------------------------------------------------------------------------------------------
--------------------------------------------------------------------------------------------------------------------------------------------------------------------------------------------------------
--------------------------------------------------------------------------------------------------------------------------------------------------------------------------------------------------------
------------------------------------------------------------------------------------------22C-----------------------------------------------CSS2S2------------------------------------------------------
-------------------------------------------------------------------------------------------------------------------SSSS---------------------------------------------------------------------------------
--------------------------------------------------------------------------------------------------tt----------------------------------------------------------------------------------------------------
---------------------------#--#-------------------------------------#---#----#--#-----------------tt----------------------------------------k--g--------------------------------------------------------
--------------------------##--##---------------%%--%%-------------%%%---%%%%%%--%%%------%%%%%%---tt--------------y---y----%%%%%%%---------%%%%%%%--%%%%%%%%F%%%%%%%%%%%%%%%%%%%%%%%%%%%%%%%%%%%%%%%%%%%
-----------%%%%%--%%%%%--###--###--------------||--||-------%%--%%|||---||||||--|||%%--%%||||||%%%%%%%----------%%%%%%%%%%-|kg||||---------|||||||--||||||||%|||||||||||||||||||||||||||||||||||||||||||
-----------|||||--|||||%%%%%--%%%%%%%%%%--%%%%%||--||-------||--|||||---||||||--|||||--|||||||||||||||%%%%--%%%%||||||||||%%%%%%%%%%--k----||Y||||--||||||||||||||||||||||||||||||||||||||||||||||||||||
XXXXXXXXXXX|||||--||||||||||--||||||||||--|||||||--||XX---XX||--|||||---||||||--|||||--|||||||||||||||||||--||||||||||||||||||||||||XXXXXXXXXXXXXXXX||||||||||||||||||||||||||||||||||||||||||||||||||||
