HEIGHT=16;WIDTH=201;THEME=0;OVERRIDE=false
--------------------------------------------------------------------------------------------------------------------------------------------------------------------------------------------------------
--------------------------------------------------------------------------------------------------------------------------------------------------------------------------------------------------------
--------------------------------------------------------------------------------------------------------------------------------------------------------------------------------------------------------
--------------------------------------------------------------------------------------------------------------------------------------------------------------------------------------------------------
--------------------------------------------------------------------------------------------------------------------------------------------------------------------------------------------------------
--------------------------------------------------------------------------------------------------------------------------------------------------------------------------------------------------------
--------------------------------------------------------------------------------------------------------------------------------------------------------------------------------------------------------
--------------------------------------------------------------------------------------------------------------------------------------------------------------------------------------------------------
---------------%%%%%%----------------------------------------------------------------------------------k------------------------------------------------------------------------------------------------
---------------||||||---------------------------------------------------------------r----------------%%%%%----------------------------------------------------------------------------------------------
---------------||||||------------------------------------------------------------%%%%----------------|||||----------------------SUSSSSS-----------------------------------------------------------------
---------------||||kk-----------#--#--------#--#---------------------------------||||------k---------|||||----------------------------------------------------------------------------------------------
------------%%%%%%%%%%%%%%%%---##--##------##--##------------------------------k-||||------%%%%------|||||----------------------------------------------------------------------------------------------
------------||||||||||||||||--###--###----###--###----------------------%%%%%%%%%%%%%%%%%%-||||------|||||---------%%%%---%%%%--------------------------------------------------------------------------
------------||||||||||||||||%%%%%--%%%%%%%%%%--%%%%%--------------------||||||||||||||||||-||||y-----||k||---------||||---||||%%%%%%%%%%%%%%%%%%F%%%%%%%%%%%%%%%%%%%%%%%%%%%%%%%%%%%%%%%%%%%%%%%%%%%%%%%
XXXXXXXXXXXX|||||||||||||||||||||--||||||||||--|||||XXX---XXXXXXX---XXXX||||||||||||||||||XXXXXXXXXXXXXXXXXXXX---XX||||---||||||||||||||||||||||X|||||||||||||||||||||||||||||||||||||||||||||||||||||||
