HEIGHT=16;WIDTH=201;THEME=0;OVERRIDE=false
--------------------------------------------------------------------------------------------------------------------------------------------------------------------------------------------------------
--------------------------------------------------------------------------------------------------------------------------------------------------------------------------------------------------------
--------------------------------------------------------------------------------------------------------------------------------------------------------------------------------------------------------
--------------------------------------------------------------------------------------------------------------------------------------------------------------------------------------------------------
--------------------------------------------------------------------------------------------------------------------------------------------------------------------------------------------------------
--------------------------------------------------------------------------------------------------------------------------------------------------------------------------------------------------------
--------------------------------------------------------------------------------------------------------------------------------------------------------------------------------------------------------
--------------------------------------------------------------------------------------------------------------------------------------------------------------------------------------------------------
--------------------------------------------------------------------------------------------------------------------------------------------------------------------------------------------------------
--------------------------------------------------Tt-Tt-------------------------------------------------------------------------------------------------------------------------------------------------
--------------------------------------------------tt-tt--------#---#------------------------------------------------------------------------------------------------------------------------------------
--------------------------------------------------tt-tt-------##---##-----#--#--------------------------------------------------------------------------------------------------------------------------
-------------------------------------------------%%%%%%%%%%%%%%%---%%%%--##--##--------------------------------------------------%%%%%--%%%%%-----------------------------------------------------------
-------------------------------------------------|||||||||||||||---||||%%%%--%%%%-----%%%%--%%%%--tt---%%---%%-------------------|||||--|||||%%%%%%%%F%%%%%%%%%%%%%%%%%%%%%%%%%%%%%%%%%%%%%%%%%%%%%%%%%%
-----------------------------%%%%---%%%%%%%%%%%%%|||||||||||||||---||||||||--||||-----||||--||||--tt---||---||%%%%--%%%%%%%---%%%|||||--|||||||||||||%||||||||||||||||||||||||||||||||||||||||||||||||||
XXXXXXXXXXXXXX---XXXXXX--XXXX||||---||||||||||||||||||||||||||||---||||||||--||||XXXXX||||--||||XXXXXXX||---||||||--|||||||---||||||||--||||||||||||||||||||||||||||||||||||||||||||||||||||||||||||||||
