HEIGHT=16;WIDTH=201;THEME=0;OVERRIDE=false
--------------------------------------------------------------------------------------------------------------------------------------------------------------------------------------------------------
--------------------------------------------------------------------------------------------------------------------------------------------------------------------------------------------------------
--------------------------------------------------------------------------------------------------------------------------------------------------------------------------------------------------------
--------------------------------------------------------------------------------------------------------------------------------------------------------------------------------------------------------
--------------------------------------------------------------------------------------------------------------------------------------------------------------------------------------------------------
--------------------------------------------------------------------------------------------------------------------------------------------------------------------------------------------------------
--------------------------------------------------------------------------------------------------------------------------------------------------------------------------------------------------------
--------------------------------------------------------------------------------------------------------------------------------------------------------------------------------------------------------
--------------------------------------------------------------------------------------------------------------------------------------------------------------------------------------------------------
--------------------------------------------------------------------------------------------------------------------------------------------------------------------------------------------------------
-----------------------------#---#--------------------------------------------------------------#---#---------------------------------------------------------------------------------------------------
----------------------------##---##------------------------------------------------------------##---##-----C22CSS---------------------------------------------------------------------------------------
-------------------%%--%%--###---###----------------------------------------%%%%-------------%%%%---%%%%------------------------------------------------------------------------------------------------
-------------#--#--||--||%%%%%---%%%%%----------%%%-------------------------||||-------------||||---||||----------------%%%%----------------------------------------------------------------------------
-----------%%%--%%%||--|||||||---|||||----------|||-------#--#--------------|||k---r---------||||---||||---------------k||||------y---------------------------------------------------------------------
XXXXXXXXXXX|||--|||||--|||||||---|||||XXXX--XXXX|||XXXXXXXX--XXXXXXXXXXXXXXXXXXXXXXXXXXXX--XX||||---||||XXXXXXXXXXXXXXXXXXXXXXXXXXXXXXX---XXXXXXXXXXFXXXXXXXXXXXXXXXXXXXXXXXXXXXXXXXXXXXXXXXXXXXXXXXXXXX
