HEIGHT=16;WIDTH=201;THEME=0;OVERRIDE=false
--------------------------------------------------------------------------------------------------------------------------------------------------------------------------------------------------------
--------------------------------------------------------------------------------------------------------------------------------------------------------------------------------------------------------
--------------------------------------------------------------------------------------------------------------------------------------------------------------------------------------------------------
--------------------------------------------------------------------------------------------------------------------------------------------------------------------------------------------------------
--------------------------------------------------------------------------------------------------------------------------------------------------------------------------------------------------------
--------------------------------------------------------------------------------------------------------------------------------------------------------------------------------------------------------
--------------------------------------------------------------------------------------------------------------------------------------------------------------------------------------------------------
--------------------------------------------------------------------------------------------------------------------------------------------------------------------------------------------------------
-------------------------------------------------------------------------------------------------22CC2-----------SCS------------------------------------------------------------------------------------
---------------------------------%%%%-------------------------------------------------------------------------------------------------------------------------------------------------------------------
---------------------------------||||-------------------------------------------------------------------------------------------------------------------------------------------------------------------
---------------------------------||k|---g-----------------------------------------------------------------------g---------------------------------------------------------------------------------------
-----------%%%%%---%%%%%--------%%%%%%%%%%%%%%%%%%%---%%%----------%%---%%------------%%%%%%%%%%%%%%%%%%%---%%-%%%%%%---%%---%%----------%%%%%%%%F%%%%%%%%%%%%%%%%%%%%%%%%%%%%%%%%%%%%%%%%%%%%%%%%%%%%%%
-----------|||||---|||||--------|||||||||||||||||||---|||----------||---||------------|||||||||||||||||||---||-||||||---||---||----------||||||||%||||||||||||||||||||||||||||||||||||||||||||||||||||||
%%%%%%%%%%%|||||---|||||--rr----|||||||||||||||||||---|||----------||---||------------|||||||||||||||||||---||%%%%%%%%%%||---||%%%%%%%%%%|||||||||||||||||||||||||||||||||||||||||||||||||||||||||||||||
||||||||||||||||---|||||XXXXXXXX|||||||||||||||||||---|||XXXX--XXXX||---||XXXXX--XXXXX|||||||||||||||||||---||||||||||||||---|||||||||||||||||||||||||||||||||||||||||||||||||||||||||||||||||||||||||||
