HEIGHT=16;WIDTH=201;THEME=0;OVERRIDE=false
--------------------------------------------------------------------------------------------------------------------------------------------------------------------------------------------------------
--------------------------------------------------------------------------------------------------------------------------------------------------------------------------------------------------------
--------------------------------------------------------------------------------------------------------------------------------------------------------------------------------------------------------
--------------------------------------------------------------------------------------------------------------------------------------------------------------------------------------------------------
--------------------------------------------------------------------------------------------------------------------------------------------------------------------------------------------------------
--------------------------------------------------------------------------------------------------------------------------------------------------------------------------------------------------------
--------------------------------------------------------------------------------------------------------------------------------------------------------------------------------------------------------
--------------------------------------------------------------------------------------------------------------------------------------------------------------------------------------------------------
--------------------------------------------------------------------------------------------------------------------------------------------------------------------------------------------------------
--------------SSC-----------------------------------------------------------------------------------------------------------#---#-----------------------------------------------------------------------
--------------------------------------------------------------------#---#---------------SCS-S------------------------------##---##----------------------------------------------------------------------
-------------------------------------------------------------------##---##------------------------------------------------###---###---------------------------------------------------------------------
-----------------k--------------------%%--%%%%%%%--%%%%%----------###---###--%%%---%%%-----%----------------------------%%%%%---%%%%%%%%%---%%%%--------------------------------------------------------
-----------%%%%%%%%%-----------%%---%%||--|||||||--|||||%%%--%%%%%%%%---%%%%%|||---|||-----|----------------------------|||||---|||||||||---||||%%%%%%%%F%%%%%%%%%%%%%%%%%%%%%%%%%%%%%%%%%%%%%%%%%%%%%%%
-----------|||||||||%%%%---%%%%||---||||--|||||||--||||||||--||||||||---||||||||---|||%%%%%%%%%-------------------------|||||---|||||||||---||||||||||||%|||||||||||||||||||||||||||||||||||||||||||||||
XXXXXXXXXXX|||||||||||||---||||||---||||--|||||||--||||||||--||||||||---||||||||---||||||||||||XXXX--XXXXXXX--XXXXX---XX|||||---|||||||||---||||||||||||||||||||||||||||||||||||||||||||||||||||||||||||
