HEIGHT=16;WIDTH=201;THEME=0;OVERRIDE=false
--------------------------------------------------------------------------------------------------------------------------------------------------------------------------------------------------------
--------------------------------------------------------------------------------------------------------------------------------------------------------------------------------------------------------
--------------------------------------------------------------------------------------------------------------------------------------------------------------------------------------------------------
--------------------------------------------------------------------------------------------------------------------------------------------------------------------------------------------------------
--------------------------------------------------------------------------------------------------------------------------------------------------------------------------------------------------------
-------------------------------------------------------------------------------------------------------------------------------------------g------------------------------------------------------------
----------------------------------------------------------------------------------------------------------------------------------------%%%%%%----------------------------------------------------------
----------------------------------------------------------------------------------------------------------------------------------------||||||----------------------------------------------------------
------------------------------------------------------------------------------y---------------------------------------------------------||||g|----------------------------------------------------------
--------------------------------------------------------------------------%%%%%---------------------------------------------------------||%%%%%%%-------------------------------------------------------
--------------------------------------------------------------------------|||||---------------------------------------------------------|||||||||-------------------------------------------------------
--------------------------------------------------------------------------|%%%%%%---------------------------------------------G---------|||||||||-------------------------------------------------------
--------------------------------------------------%%--%%--#--#--%%---%%---|||||||-------------------------------------------%%%%%%------k|||||||k-------------------------------------------------------
------------------------%%--%%--------------------||--||%%%--%%%||---||---|||||||------%%%--%%%------%%%%-------------------||||||---%%%%%%%%%%%%%%%%%%%------------------------------------------------
------------------------||--||--------------------||--|||||--|||||---||---|||||||------|||--|||------||||------------#---#--||||||---|||||||||||||||||||------------------------------------------------
XXXXXXXXXXXXXXXXXXXX--XX||--||XX---XXXXXXX---XXXXX||--|||||--|||||---||XXXXXXXXXXXXXXXX|||--|||XX--XX||||XXXX--XXXXXXX---XXX||||||XXX|||||||||||||||||||XXXXXXXXFXXXXXXXXXXXXXXXXXXXXXXXXXXXXXXXXXXXXXXX
