HEIGHT=16;WIDTH=201;THEME=0;OVERRIDE=false
--------------------------------------------------------------------------------------------------------------------------------------------------------------------------------------------------------
--------------------------------------------------------------------------------------------------------------------------------------------------------------------------------------------------------
--------------------------------------------------------------------------------------------------------------------------------------------------------------------------------------------------------
--------------------------------------------------------------------------------------------------------------------------------------------------------------------------------------------------------
--------------------------------------------------------------------------------------------------------------------------------------------------------------------------------------------------------
--------------------------------------------------------------------------------------------------------------------------------------------------------------------------------------------------------
--------------------------g-----------------------------------------------------------------------------------------------------------------------------------------------------------------------------
-------------------------%%%%%--------------------------------------------------------------------------------------------------------------------------------------------------------------------------
-------------------------|||||--------------------------------------------------------------------------------------------------------------------------------------------------------------------------
-----------------------%%%%|||--------------------------------------------------------------------------------------------------------------------------------------------------------------------------
-----------------------|||||||--------------------------------------------------------------------------------------------------------------------------------------------------------------------------
-----------------------|||||||----CS2SSCS----------------------#--#-------------------------------------------------------------------------------------------------------------------------------------
-----------------------|||||||------------%%---%%---------%%%%%%--%%%----#--#--------------------------------------%%---%%--------------------%%%%%%%%F%%%%%%%%%%%%%%%%%%%%%%%%%%%%%%%%%%%%%%%%%%%%%%%%%
----------%%%%--%%%%%%%%%%%%%%%%----------||---||---------||||||--|||---##--##-------------%%%-------------%%%--%%%||---||-------------%%---%%||||||||%|||||||||||||||||||||||||||||||||||||||||||||||||
----------||||--||||||||||||||||--------y-||---||%%%---%%%||||||--|||--###--###------y--G--|||--k----------|||--|||||---||%%%%%---%%%%%||---||||||||||||||||||||||||||||||||||||||||||||||||||||||||||||
XXXXXXXXXX||||--||||||||||||||||XXXXXXXXXX||---|||||---|||||||||--|||XXXXX--XXXXXXXXXXXXXXXXXXXXXXXXXX--XXX|||--|||||---|||||||---|||||||---||||||||||||||||||||||||||||||||||||||||||||||||||||||||||||
