HEIGHT=16;WIDTH=201;THEME=0;OVERRIDE=false
--------------------------------------------------------------------------------------------------------------------------------------------------------------------------------------------------------
--------------------------------------------------------------------------------------------------------------------------------------------------------------------------------------------------------
--------------------------------------------------------------------------------------------------------------------------------------------------------------------------------------------------------
--------------------------------------------------------------------------------------------------------------------------------------------------------------------------------------------------------
--------------------------------------------------------------------------------------------------------------------------------------------------------------------------------------------------------
--------------------------------------------------------------------------------------------------------------------------------------------------------------------------------------------------------
--------------------------------------------------------------------------------------------------------------------------------------------------------------------------------------------------------
--------------------------------------------------------------------------------------------------------------------------------------------------------------------------------------------------------
-------------------SCS----------------------------------------------------------------------------------------------------------------------------------------------------------------------------------
--------------------------------------------------------------------------------------------------------------------------------------------------------------------------------------------------------
------------------%----------------------#--#-----------------------------------------------------------------------------------------------------------------------------------------------------------
------------------|---k-----------------##--##-----#---#---------------------------SSSSC-----------------------------------SCCUC------------------------------------------------------------------------
-----------------%%%%%%%%%------------%%%%--%%%%--##---##----------------------------------------------------%%%--%%%------------------------%%%%%%%%F%%%%%%%%%%%%%%%%%%%%%%%%%%%%%%%%%%%%%%%%%%%%%%%%%%
-----------------|||||||||------------||||--||||%%%%---%%%%%%%%---%%%%---------------------%%---%%----%%---%%|||--|||%%%%--------------------||||||||%||||||||||||||||||||||||||||||||||||||||||||||||||
----------%%%%---|||||||||------------||||--||||||||---||||||||---||||%%%%--%%%%-----------||---||----||---|||||--|||||||----------%%%%--%%%%|||||||||||||||||||||||||||||||||||||||||||||||||||||||||||
XXXXXXXXXX||||XXX|||||||||XXXXX--XXXXX||||--||||||||---||||||||---||||||||--||||XXXXXXXXXXX||---||XXXX||---|||||--|||||||XXXXXXXXXX||||--|||||||||||||||||||||||||||||||||||||||||||||||||||||||||||||||
