HEIGHT=16;WIDTH=201;THEME=0;OVERRIDE=false
--------------------------------------------------------------------------------------------------------------------------------------------------------------------------------------------------------
--------------------------------------------------------------------------------------------------------------------------------------------------------------------------------------------------------
--------------------------------------------------------------------------------------------------------------------------------------------------------------------------------------------------------
--------------------------------------------------------------------------------------------------------------------------------------------------------------------------------------------------------
--------------------------------------------------------------------------------------------------------------------------------------------------------------------------------------------------------
--------------------------------------------------------------------------------------------------------------------------------------------------------------------------------------------------------
--------------------------------------------------------------------------------------------------------------------------------------------------------------------------------------------------------
--------------------------------------------------------------------------------------------------------------------------------------------------------------------------------------------------------
--------------------------------------------------%%%%%----------------------------------------------------------------------------------S2S------------------------------------------------------------
--------------------------------------------------|||||----------------#--#-----------------------------------------------------------------------------------------------------------------------------
------------------------------------------------r-|||||---------------##--##----------------------------------------------------------------------------------------------------------------------------
------------------------------------------------%%%||||----SSS2S-----###--###----------------------------------------------------------------K----------------------------------------------------------
-----------%%%---%%%----------------------------|||||||------------%%%%%--%%%%%%%%%%%%---%%-----------%%%%%%%%%----------------------%%%%%%%%%%%--------------------------------------------------------
-----------|||---|||-------%%---%%%%%%--%%%%----|||||||------------|||||--||||||||||||---||-----------|||||||||--#--#--%%%%----------|||||||||||--------------------------------------------------------
-----------|||---|||%%---%%||---||||||--||||%%%%%%%%%%%%%%--y------|||||--||||||||||||---||-----------|||||||||%%%--%%%||||%%%%%%%%%%|||||||||||--------------------------------------------------------
XXXXXXXXXXX|||---|||||---||||---||||||--||||||||||||||||||XXXXXXXXX|||||--||||||||||||---||XXXX---XXXX||||||||||||--||||||||||||||||||||||||||||XXXXXXXXFXXXXXXXXXXXXXXXXXXXXXXXXXXXXXXXXXXXXXXXXXXXXXXX
