HEIGHT=16;WIDTH=201;THEME=0;OVERRIDE=false
--------------------------------------------------------------------------------------------------------------------------------------------------------------------------------------------------------
--------------------------------------------------------------------------------------------------------------------------------------------------------------------------------------------------------
--------------------------------------------------------------------------------------------------------------------------------------------------------------------------------------------------------
--------------------------------------------------------------------------------------------------------------------------------------------------------------------------------------------------------
--------------------------------------------------------------------------------------------------------------------------------------------------------------------------------------------------------
--------------------------------------------------------------------------------------------------------------------------------------------------------------------------------------------------------
--------------------------------------------------------------------------------------------------------------------------------------------------------------------------------------------------------
--------------------------------------------------------------------------------------------------------------------------------------------------------------------------------------------------------
--------------------------------------------------------------------------------------------------------------------------------------------------------------------------------------------------------
--------------------------------------------------------------------------------------------------------------------------------------------------------------------------------------------------------
---------------------------------tt-------------------------------------------------------------------------------------------------SSCU----------------------------------------------------------------
---------------------------------tt---------------------------------------------------------------------------------------------------------------------------------------------------------------------
-------------#---#--------------%%%%%%%%%------%%%%%--%%%%%--#--#--%%%%---%%%%--------------------------------------------------------------------------------------------------------------------------
-----------%%%---%%%------------|||||||||------|||||--|||||%%%--%%%||||---||||--------------%%%%%---%%%%%%%--%%------%%%%%---%%%%%----r-----%%%%%%%%F%%%%%%%%%%%%%%%%%%%%%%%%%%%%%%%%%%%%%%%%%%%%%%%%%%%
-----------|||---|||%%%%%--%%%%%|||||||||------|||||--||||||||--|||||||---||||--------%%--%%|||||---|||||||--||------|||||---|||||%%%%%%%%%%||||||||%|||||||||||||||||||||||||||||||||||||||||||||||||||
XXXXXXXXXXX|||---||||||||--||||||||||||||XX--XX|||||--||||||||--|||||||---||||XXX--XXX||--|||||||---|||||||--||XX--XX|||||---|||||||||||||||||||||||||||||||||||||||||||||||||||||||||||||||||||||||||||
