HEIGHT=16;WIDTH=201;THEME=0;OVERRIDE=false
--------------------------------------------------------------------------------------------------------------------------------------------------------------------------------------------------------
--------------------------------------------------------------------------------------------------------------------------------------------------------------------------------------------------------
--------------------------------------------------------------------------------------------------------------------------------------------------------------------------------------------------------
--------------------------------------------------------------------------------------------------------------------------------------------------------------------------------------------------------
--------------------------------------------------------------------------------------------------------------------------------------------------------------------------------------------------------
-------------------------------------------------------------------------------------------SCCS-------------------------------SS2-----------------------------------------------------------------------
--------------------------------------------------------------------------------------------------------------------------------------------------------------------------------------------------------
--------------------------------------------------------------------------------------------------------------------------------------------------------------------------------------------------------
---------------------------------------------------------------------------------------------G------------------------------G--g------------------------------------------------------------------------
------------------------------------------------------------------------------------------%%%%%----------------------------%%%%%%%----------------------------------------------------------------------
-----------------------------------------------------------SSS----------------------------|||||--y-g-----------------------|||||||----------------------------------------------------------------------
---------------------------------------------#---#----------------------------------------|||%%%%%%%-----------------------|||||||----------------------------------------------------------------------
-------------%%---%%------------------------##---##--%%---------%%%%%--%%%%%---------g----|r|k|||||kg-------------y--------|||||||----------------------------------------------------------------------
-------------||---||----------------------%%%%---%%%%||---k-y---|||||--|||||--------%%%%%%%%%%%%%%%%%%%----------%%%%%%%%%%%%%%%%%%%%%%---%%%%%%%%%%%F%%%%%%%%%%%%%%%%%%%%%%%%%%%%%%%%%%%%%%%%%%%%%%%%%%
%%%%%%%%%%%%%||---||--------Y---%%%%--%%%%||||---||||||%%%%%%%%%|||||--|||||%%%--%%%|||||||||||||||||||%%%%--%%%%||||||||||||||||||||||---|||||||||||%||||||||||||||||||||||||||||||||||||||||||||||||||
|||||||||||||||---||XXXXXXXXXXXX||||--||||||||---||||||||||||||||||||--||||||||--||||||||||||||||||||||||||--||||||||||||||||||||||||||---||||||||||||||||||||||||||||||||||||||||||||||||||||||||||||||
