HEIGHT=16;WIDTH=201;THEME=0;OVERRIDE=false
--------------------------------------------------------------------------------------------------------------------------------------------------------------------------------------------------------
--------------------------------------------------------------------------------------------------------------------------------------------------------------------------------------------------------
--------------------------------------------------------------------------------------------------------------------------------------------------------------------------------------------------------
--------------------------------------------------------------------------------------------------------------------------------------------------------------------------------------------------------
--------------------------------------------------------------------------------------------------------------------------------------------------------------------------------------------------------
--------------------------------------------------------------------------------------------------------------------------------------------------------------------------------------------------------
--------------------------------------------------------------------------------------------------------------------------------------------------------------------------------------------------------
--------------------------------------------------------------------------------------------------------------------------------------------------------------------------------------------------------
--------------------------------------------------------------------------------------------------------------------------------------------------------------------------------------------------------
-----------------------------------------------------------------------------------------------------SSSUSS---------------------------------------------------------------------------------------------
--------------------------------------------------------------------------------------------------------------------------------------------------------------------------------------------------------
---------------------------------------------------SSC2------------SSCS----------------Tt---------------------------------------------------------------------------------------------------------------
----------------------------------------------------------%%%--%%%---------------------tt----------------ky----#--#---%%%%---%%%%-----------------------------------------------------------------------
%%%%%%%%%%%%%%%%%%---%%%%%----------------#--#------------|||--|||------%%%%%---%%%%%%%%%%%--#---#--%%%%%%%%--##--##--||||---||||%%%%%---%%%%%----------------------------------------------------------
||||||||||||||||||---|||||--------------%%%--%%%------y---|||--|||------|||||---|||||||||||%%%---%%%||||||||%%%%--%%%%||||---|||||||||---|||||----------------------------------------------------------
||||||||||||||||||---|||||XX--XXXXX--XXX|||--|||XXXXXXXXXX|||--|||XXXXXX|||||---||||||||||||||---|||||||||||||||--||||||||---|||||||||---|||||XXXXXXXXFXXXXXXXXXXXXXXXXXXXXXXXXXXXXXXXXXXXXXXXXXXXXXXXXX
