HEIGHT=16;WIDTH=201;THEME=0;OVERRIDE=false
--------------------------------------------------------------------------------------------------------------------------------------------------------------------------------------------------------
--------------------------------------------------------------------------------------------------------------------------------------------------------------------------------------------------------
--------------------------------------------------------------------------------------------------------------------------------------------------------------------------------------------------------
--------------------------------------------------------------------------------------------------------------------------------------------------------------------------------------------------------
--------------------------------------------------------------------------------------------------------------------------------------------------------------------------------------------------------
--------------------------------------------------------------------------------------------------------------------------------------------------------------------------------------------------------
--------------------------------%%%%%%%-----------------------------------------------------------------------------------------------------------------------------------------------------------------
--------------------------------|||||||-----------------------------------------------------------------------------------------------------------------------------------------------------------------
--------------------------------|||||||-----------------------------------------------------------------------------------------------------------------------------------------------------------------
--------------------------------|%%%%%|-----------------------------------------------------------------------------------------------------------------------------------------------------------------
--------------------------------|||||||------------------------------------------------------------------------------Tt---------------------------------------------------------------------------------
--------------------------------||||||g------------------tt----------------------------------------------------------tt---------------------------------------------------------------------------------
------------------------------%%%%%%%%%%%%%----------Tt--tt------------%%%%%--%%%%%------%%---%%---------#---#-------tt--%%%%%%%--%%%%------------------------------------------------------------------
%%%%%%%%%%%%%%%--%%-----------|||||||||||||----------tt--tt------------|||||--|||||%%--%%||---||--------##---##--%%%%%%%%|||||||--||||------------------------------------------------------------------
|||||||||||||||--||--------%%%|||||||||||||---------%%%%%%%%%%%%%%---%%|||||--|||||||--||||---||------%%%%---%%%%|||||||||||||||--||||--------%%%%%%%%F%%%%%%%%%%%%%%%%%%%%%%%%%%%%%%%%%%%%%%%%%%%%%%%%%
|||||||||||||||--||XXX--XXX||||||||||||||||XXX---XXX||||||||||||||---|||||||--|||||||--||||---||XX--XX||||---|||||||||||||||||||--||||XXX--XXX||||||||X|||||||||||||||||||||||||||||||||||||||||||||||||
