HEIGHT=16;WIDTH=201;THEME=0;OVERRIDE=false
--------------------------------------------------------------------------------------------------------------------------------------------------------------------------------------------------------
--------------------------------------------------------------------------------------------------------------------------------------------------------------------------------------------------------
--------------------------------------------------------------------------------------------------------------------------------------------------------------------------------------------------------
--------------------------------------------------------------------------------------------------------------------------------------------------------------------------------------------------------
-------------------------------------------%%%%---------------------------------------------------------------------------------------------------------------------------------------------------------
-------------------------------------------||||---------------------------------------------------------------------------------------------------------------------------------------------------------
-------------------------------------------||||---------------------------------------------------------------------------------------------------------------------------------------------------------
---------------------------------%%%%%%%---||||---------------------------------------------------------------------------------------------------------------------------------------------------------
---------------------------------|||||||---||||--------------------------SCC----------------------------------------------------------------------------------------------------------------------------
---------------------------------|||||||---||||------------------------------------------------------------#---#----------------------------------------------------------------------------------------
---------------------------------|||||||---||||-----------------------------------------------------------##---##---------------------------------------------------------------------------------------
---------------------------------||||||%%%%%%%|----------------#---#-------------------------------------###---###--------------------------------------------------------------------------------------
---------------------------------||||y|||y|||||--%%%%%--%%%%%%%%---%%%%%%%%%%%%------------------------%%%%%---%%%%%----------#---#---------------------------------------------------------------------
%%%%%%%%%%%%%--%%%%%%%%--%%%%%%%%%%%%%%%%%%%%%%%%|||||--||||||||---||||||||||||-----------%%%%%---%%%%%|||||---|||||---------##---##------#---#---------------------------------------------------------
|||||||||||||--||||||||--|||||||||||||||||||||||||||||--||||||||---||||||||||||%%%%%%%%%%%|||||---||||||||||---|||||%%--%%--###---###----##---##--------------------------------------------------------
|||||||||||||--||||||||--|||||||||||||||||||||||||||||--||||||||---||||||||||||||||||||||||||||---||||||||||---|||||||--||XXXXX---XXXXXXXXX---XXXXXXXXXXXXFXXXXXXXXXXXXXXXXXXXXXXXXXXXXXXXXXXXXXXXXXXXXX
