HEIGHT=16;WIDTH=201;THEME=0;OVERRIDE=false
--------------------------------------------------------------------------------------------------------------------------------------------------------------------------------------------------------
--------------------------------------------------------------------------------------------------------------------------------------------------------------------------------------------------------
--------------------------------------------------------------------------------------------------------------------------------------------------------------------------------------------------------
--------------------------------------------------------------------------------------------------------------------------------------------------------------------------------------------------------
--------------------------------------------------------------------------------------------------------------------------------------------------------------------------------------------------------
--------------------------------------------------------------------------------------------------------------------------------------------------------------------------------------------------------
--------------------------------------------------------------------------------------------------------------------------------------------------------------------------------------------------------
--------------------------------------------------------SUU-CCS-----------------------------------------------------------------------------------------------------------------------------------------
--------------------------------------------------------------------------------------------------------------------------------------------------------------------------------------------------------
-----------------------------------------------------------%-----------------------SSCS2C2--------------------------------------------------------------------------------------------------------------
-----------------------------------------------------------|-k------------------------------------------------------------------------------------------------------------------------------------------
--------------------------------------------------------%%%%%%%-----------------------------------------------------------------------------------------------------------------------------------------
----------------------------------%%%---%%%-------------|||||||---------------------------------------#---#---------------------------------------------------------------------------------------------
----------------------------------|||---|||-------------|||||||-------------------%%%%%%%%%%%--------##---##--%%---%%------%%%---%%%%%%-------%%%%%%%%F%%%%%%%%%%%%%%%%%%%%%%%%%%%%%%%%%%%%%%%%%%%%%%%%%
%%%%%%%%%%%-------%%%---%%%-------|||---|||%%%%%--%%%%%-|y||r||----#---#----------|||||||||||%%--%%%%%%---%%%%||---||%%--%%|||---||||||-------||||||||%|||||||||||||||||||||||||||||||||||||||||||||||||
|||||||||||XX---XX|||---|||XX---XX|||---||||||||--|||||XXXXXXXXXXXXX---XXXXXX--XXX|||||||||||||--||||||---||||||---||||--|||||---||||||XX---XX||||||||||||||||||||||||||||||||||||||||||||||||||||||||||
