HEIGHT=16;WIDTH=201;THEME=0;OVERRIDE=false
--------------------------------------------------------------------------------------------------------------------------------------------------------------------------------------------------------
--------------------------------------------------------------------------------------------------------------------------------------------------------------------------------------------------------
--------------------------------------------------------------------------------------------------------------------------------------------------------------------------------------------------------
--------------------------------------------------------------------------------------------------------------------------------------------------------------------------------------------------------
--------------------------------------------------------------------------------------------------------------------------------------------------------------------------------------------------------
--------------------------------------------------------------------------------------------------SSSSCC------------------------------------------------------------------------------------------------
--------------------------C2C---------------------------------------------------------------------------------------------------------------------------------------------------------------------------
--------------------------------------------------------------------------------------------------------------------------------------------------------------------------------------------------------
--------------------------------------------------------------------------------------------------r---y-------------------------------------------------------------------------------------------------
----------------------------------------------------------------------%%%%-----------#--#---------%%%%%%%-----------------------------------------------------------------------------------------------
------------------------%%%%%%----------------------------------------||||----------##--##--------|||||||-----------------------------------------------------------------------------------------------
------------------------||||||----------------------------------------||||---------###--###-------||r||||----------------------SSSSSS-------------------------------------------------------------------
%%%%%%%%%%%%------------|%%%%|----------------------------------------||||-------%%%%%--%%%%%%%%%%%%%%%%%%%%--------------------------------------------------------------------------------------------
||||||||||||------------||||||--------%%%%%--%%%%%-----------------%%%%%%%%%%%%%%|||||--||||||||||||||||||||--------------------------------------------------------------------------------------------
||||||||||||%%%%---%%%%-||||||-----yg-|||||--|||||-----------------|||||||||||||||||||--||||||||||||||||||||----------------------r------%%%%%%%%F%%%%%%%%%%%%%%%%%%%%%%%%%%%%%%%%%%%%%%%%%%%%%%%%%%%%%%
||||||||||||||||---||||XXXXXXXXXXXXXXX|||||--|||||XX---XXXXXX--XXXX|||||||||||||||||||--||||||||||||||||||||XXXXX--XXXXXXX--XXXXXXXXXXXXX||||||||X||||||||||||||||||||||||||||||||||||||||||||||||||||||
