HEIGHT=16;WIDTH=201;THEME=0;OVERRIDE=false
--------------------------------------------------------------------------------------------------------------------------------------------------------------------------------------------------------
--------------------------------------------------------------------------------------------------------------------------------------------------------------------------------------------------------
--------------------------------------------------------------------------------------------------------------------------------------------------------------------------------------------------------
--------------------------------------------------------------------------------------------------------------------------------------------------------------------------------------------------------
--------------------------------------------------------------------------------------------------------------------------------------------------------------------------------------------------------
--------------------------------------------------------------------------------------------------------------------------------------------------------------------------------------------------------
--------------------------------------------------------------------------------------------------------------------------------------------------------------------------------------------------------
--------------------------------------------------------------------------------------------------------------------------------------------------------------------------------------------------------
----------------------------------------------------------------CC2-------------------------------------------------------------------------------------------------------------------------------------
-----------------------------------------------------------------------------------------------------------------------%%%%-----------------------------------------------------------------------------
-----------------------------------------------------------------------tt----Tt----------------------------------------||||-----------------------------------------------------------------------------
---------------------2SS-USS-------------------------------------k-----tt----tt------------------r---------------------|||g-------------Tt--------------------------------------------------------------
%%%%%%%%%%-------------------%%%%--%%%%-----------------------%%%%%%%%%%%%%%%%%%%%-------------%%%%%%-----------------%%%%%%%%%%%%%%----tt-----%%%%%%%%F%%%%%%%%%%%%%%%%%%%%%%%%%%%%%%%%%%%%%%%%%%%%%%%%
||||||||||--------------%----||||--||||-----------------------||||||||||||||||||||-------------||||||-----%%%---%%%---||||||||||||||----tt-----||||||||%||||||||||||||||||||||||||||||||||||||||||||||||
||||||||||%%%%--%%%%----|----||||--||||%%%%--%%%%-------------||||||||||||||||||||%%%%%---%%%%%||||||%%%%%|||---|||---||||||||||||||%%%%%%%%%%%|||||||||||||||||||||||||||||||||||||||||||||||||||||||||
||||||||||||||--||||XXXXXXXXX||||--||||||||--||||XXXXX---XXXXX|||||||||||||||||||||||||---|||||||||||||||||||---|||XXX||||||||||||||||||||||||||||||||||||||||||||||||||||||||||||||||||||||||||||||||||
