HEIGHT=16;WIDTH=201;THEME=0;OVERRIDE=false
--------------------------------------------------------------------------------------------------------------------------------------------------------------------------------------------------------
--------------------------------------------------------------------------------------------------------------------------------------------------------------------------------------------------------
--------------------------------------------------------------------------------------------------------------------------------------------------------------------------------------------------------
--------------------------------------------------------------------------------------------------------------------------------------------------------------------------------------------------------
--------------------------------------------------------------------------------------------------------------------------------------------------------------------------------------------------------
--------------------------------------------------------------------------------------------------------------------------------------------------------------------------------------------------------
--------------------------------------------------------------------------------------------------------------------------------------------------------------------------------------------------------
--------------------------------------------------------------------------------------------------------------------------------------------------------------------------------------------------------
--------------------------------------------------------------------------------------------------------------------------------------------------------------------------------------------------------
--------------------------------------------------------------------------------------------------------------------------------------------------------------------------------------------------------
--------------------------------------------------------------------------------------------------------------------------------------------------------------------------------------------------------
--------------------------------------------------------------------------------------------------------------------------------------------------------------------------------------------------------
---------------------------------------%%%%%---------------------------------------------%%%%%%%--------------------------------------------------------------------------------------------------------
----------%%%%---%%%%------%%%%--------|||||----%%%%%----%%%%%---%%%%%-------------------|||||||--------%%%%%--%%%%%------------------------------------------------------------------------------------
----------||||---||||%%--%%||||-----y-Y||||r-y--|||||----|||||---|||||%%%%%--%%%%%%%%%%--|||||||--------|||||--|||||%%%%%---%%%%%%%---%%%%%%%%%%F%%%%%%%%%%%%%%%%%%%%%%%%%%%%%%%%%%%%%%%%%%%%%%%%%%%%%%%
XXXXXXXXXX||||---||||||--||||||XXXXXXXXXXXXXXXXXXXXXXXXXX|||||---||||||||||--||||||||||XXXXXXXXXXXXXXXXX|||||--||||||||||---|||||||---||||||||||X|||||||||||||||||||||||||||||||||||||||||||||||||||||||
