HEIGHT=16;WIDTH=201;THEME=0;OVERRIDE=false
--------------------------------------------------------------------------------------------------------------------------------------------------------------------------------------------------------
--------------------------------------------------------------------------------------------------------------------------------------------------------------------------------------------------------
--------------------------------------------------------------------------------------------------------------------------------------------------------------------------------------------------------
--------------------------------------------------------------------------------------------------------------------------------------------------------------------------------------------------------
--------------------------------------------------------------------------------------------------------------------------------------------------------------------------------------------------------
--------------------------------------------------------------------------------------------------------------------------------------------------------------------------------------------------------
--------------------------------------------------------------------------------------------------------------------------------------------------------------------------------------------------------
--------------------------------------------------------------------------------------------------------------------------------------------------------------------------------------------------------
---------------------------------CS-------------------------%%%%----------------------------------------------------------------------------------------------------------------------------------------
------------------------------------------------------------||||----------------------------------------------------------------------------------------------------------------------------------------
--------------------------------%------#---#----------------||||-------------------------------#--#-----------------------------------------------------------------------------------------------------
--------------------------------|-----##---##---------------||y|------------------------------##--##--------------------SUSS2---------------------------------------------------------------------------
%%%%%%%%%%------------------%%%%%%%%%%%%---%%%%%%---%%%%%%%%%%%%%%%%%%%%%--%%%---------------###--###---------------------------------%%--%%%%%%%%%%F%%%%%%%%%%%%%%%%%%%%%%%%%%%%%%%%%%%%%%%%%%%%%%%%%%%
||||||||||--#--#------------||||||||||||---||||||---|||||||||||||||||||||--|||-------------%%%%%--%%%%%--------%%-------------%%%%----||--||||||||||%|||||||||||||||||||||||||||||||||||||||||||||||||||
||||||||||%%%--%%%%%%%---k--||||||||||||---||||||---|||||||||||||||||||||--|||-------------|||||--|||||%%%--%%%||%%%%%%-------||||%%%%||--||||||||||||||||||||||||||||||||||||||||||||||||||||||||||||||
|||||||||||||--|||||||XXXXXX||||||||||||---||||||---|||||||||||||||||||||--|||XXXXX---XXXXX|||||--||||||||--|||||||||||XXXXXXX||||||||||--||||||||||||||||||||||||||||||||||||||||||||||||||||||||||||||
