HEIGHT=16;WIDTH=201;THEME=0;OVERRIDE=false
--------------------------------------------------------------------------------------------------------------------------------------------------------------------------------------------------------
--------------------------------------------------------------------------------------------------------------------------------------------------------------------------------------------------------
--------------------------------------------------------------------------------------------------------------------------------------------------------------------------------------------------------
--------------------------------------------------------------------------------------------------------------------------------------------------------------------------------------------------------
--------------------------------------------------------------------------------------------------------------------------------------------------------------------------------------------------------
--------------------------------------------------------------------------------------------------------------------------------------------------------------------------------------------------------
--------------------------------------------------------------------------------------------------------------------------------------------------------------------------------------------------------
--------------------------------------------------------------------------------------------------------------------------------------------------------------------------------------------------------
------------------------------------------r-------------------------------------------------------------------------SS2---------------------------------------------------------------------------------
------------------------------------------%%%%%%%-----------------------------#---#---------------------------------------------------------------------------------------------------------------------
------------------------------------------|||||||----------------------------##---##--------------------------------------------------------------------------------------------------------------------
-------------#---#------------------------|||||||---------------------------###---###-------------------------------------------------------------------------------------------------------------------
%%%%%%%%%%%%%%---%%%----------------------||||r||-----Tt----------#--#----%%%%%---%%%%%--ky-----%%---%%---------tt-%%%%%%%---#---#----------------------------------------------------------------------
||||||||||||||---|||%%%%%%%%%%%-----------|||%%%|-----tt---------##--##---|||||---|||||%%%%%%%%%||---||---------tt-|||||||--##---##--------------%%%%%%%%F%%%%%%%%%%%%%%%%%%%%%%%%%%%%%%%%%%%%%%%%%%%%%%
||||||||||||||---||||||||||||||-----------|||||r|-----tt--------###--###--|||||---||||||||||||||||---||%%---%%%%%%%|||||||%%%%---%%%%%%%%%--%%%%%||||||||%||||||||||||||||||||||||||||||||||||||||||||||
||||||||||||||---||||||||||||||XXXXXXXXXXXXXXXXXXXXXXXXXXXXXXXXXXXX--XXXXX|||||---||||||||||||||||---||||---||||||||||||||||||---|||||||||--||||||||||||||||||||||||||||||||||||||||||||||||||||||||||||
