HEIGHT=16;WIDTH=201;THEME=0;OVERRIDE=false
--------------------------------------------------------------------------------------------------------------------------------------------------------------------------------------------------------
--------------------------------------------------------------------------------------------------------------------------------------------------------------------------------------------------------
--------------------------------------------------------------------------------------------------------------------------------------------------------------------------------------------------------
--------------------------------------------------------------------------------------------------------------------------------------------------------------------------------------------------------
---------------------------------------------------------------------------------------------------------------------------y----------------------------------------------------------------------------
--------------------------------------------------------------------------------------------------------------------------%%%---------------------------------------------------------------------------
-------------------------------------------------y------------------------------------------------------------------------|||---------------------------------------------------------------------------
------------------------------------------------%%%%%%%-------------------------------------------------------------------|||---------------------------------------------------------------------------
------------------------------------------------|||||||-----------------------------------------------------------------ry|||---------------------------------------------------------------------------
------------------------------------------------|||||||-----------------------------------------------------------------%%%%|---------------------------------------------------------------------------
------------------------------------------------||Gg|||-----------------------------------------------------------------|||||---------------------------------------------------------------------------
------------------------------------------------|%%%%%|-----------------------------------------------------------------|||||----g----------------------------------------------------------------------
----------%%--%%---------#--#---%%%%%---%%%%%---|||||||---------------------------------------------------------------%%%%%%%%%%%%%%%%%-----------------------------------------------------------------
----------||--||%%--%%--##--##--|||||---|||||---|k|||||--%%--%%--G--k-----------%%%%---%%%%%%%%-----------------------|||||||||||||||||-----------------------------------------------------------------
%%%%%%%%%%||--||||--||%%%%--%%%%|||||---|||||%%%%%%%%%%%%||--||%%%%%%%%%%%--%%%%||||---||||||||-----------%%%%%--%%%%%|||||||||||||||||%%--%%-----------------------------------------------------------
||||||||||||--||||--||||||--|||||||||---|||||||||||||||||||--|||||||||||||--||||||||---||||||||XXXX---XXXX|||||--||||||||||||||||||||||||--||XXXXXXXXFXXXXXXXXXXXXXXXXXXXXXXXXXXXXXXXXXXXXXXXXXXXXXXXXXX
