HEIGHT=16;WIDTH=201;THEME=0;OVERRIDE=false
--------------------------------------------------------------------------------------------------------------------------------------------------------------------------------------------------------
--------------------------------------------------------------------------------------------------------------------------------------------------------------------------------------------------------
--------------------------------------------------------------------------------------------------------------------------------------------------------------------------------------------------------
--------------------------------------------------------------------------------------------------------------------------------------------------------------------------------------------------------
--------------------------------------------------------------------------------------------------------------------------------------------------------------------------------------------------------
--------------------------------------------------------------------------------------------------------------------------------------------------------------------------------------------------------
--------------------------------------------------------------------------------------------------------------------------------------------------------------------------------------------------------
--------------------------------------------------------------------------------------------------------------------------------------------------------------------------------------------------------
------------------%%%%%%%-------------------------------------------------------------------------------------------------------------------------------------------------------------------------------
------------------|||||||----------------------------------------------------------------------------------------------------------#---#----------------------------------------------------------------
------------------|||||||---------------------------------------------------------------------------------------------------------##---##---------------------------------------------------------------
----------------r-|||||||--------------------------------------------------------------------------------------------------------###---###--------------------------------------------------------------
--------------%%%%%%%%%%%%%--#---#----------%%%---%%%----------------------------------------%%%---%%%%%%%---%%%%%%---%%-------%%%%%---%%%%%------------------------------------------------------------
%%%%%%%%%%%%%%|||||||||||||%%%---%%%%%%--%%%|||---|||---------------------%%%%%--%%%---------|||---|||||||---||||||---||%%---%%|||||---|||||------------------------------------------------------------
||||||||||||||||||||||||||||||---||||||--||||||---|||%%%%%---%%%%%%%%--%%%|||||--|||---------|||---|||||||---||||||---||||---|||||||---|||||%%%%%%%%F%%%%%%%%%%%%%%%%%%%%%%%%%%%%%%%%%%%%%%%%%%%%%%%%%%%
||||||||||||||||||||||||||||||---||||||--||||||---||||||||---||||||||--||||||||--|||XXXXXXXXX|||---|||||||---||||||---||||---|||||||---|||||||||||||X|||||||||||||||||||||||||||||||||||||||||||||||||||
