HEIGHT=16;WIDTH=201;THEME=0;OVERRIDE=false
--------------------------------------------------------------------------------------------------------------------------------------------------------------------------------------------------------
--------------------------------------------------------------------------------------------------------------------------------------------------------------------------------------------------------
--------------------------------------------------------------------------------------------------------------------------------------------------------------------------------------------------------
--------------------------------------------------------------------------------------------------------------------------------------------------------------------------------------------------------
--------------------------------------------------------------------------------------------------------------------------------------------------------------------------------------------------------
--------------------------------------------------------------------------------------------------------------------------------------%%%---------------------------------------------------------------
--------------------------------------------------------------------------------------------------------------------------------------|||---------------------------------------------------------------
--------------------------------------------------------------------------------------------------------------------------------------|||---------------------------------------------------------------
--------------------------------------------------------------------------------------------------------------------------------------|%%%%-------------------------------------------------------------
----------------------------------------r---------------------------------------------------------------------------------------------|||||-------------------------------------------------------------
------------------------------------%%%%%%----------------------------------------------------------kg----------#---#-----------------|||||-------------------------------------------------------------
------------------------------------||||||--------------------------------------------#--#--------%%%%%%%------##---##----------------|||||-------------------------------------------------------------
-------------%%--%%-----------%%%%%%%%%%%%%%%%%%--#--#----------------------%%%--%%%%%%--%%%------|||||k|-----###---###----------%%%%%%%%%%%%%----------------------------------------------------------
-------------||--||-----------||||||||||||||||||%%%--%%%--------%%%%%--%%%%%|||--||||||--|||----%%%%%%%%%%%%%%%%%---%%%%%%%%--%%%|||||||||||||%%%%%%%%F%%%%%%%%%%%%%%%%%%%%%%%%%%%%%%%%%%%%%%%%%%%%%%%%%
-------------||--||-----------|||||||||||||||||||||--|||%%%--%%%|||||--||||||||--||||||--|||----|||||||||||||||||---||||||||--||||||||||||||||||||||||%|||||||||||||||||||||||||||||||||||||||||||||||||
XXXXXXXXXXXXX||--||XXXX---XXXX|||||||||||||||||||||--||||||--||||||||--||||||||--||||||--|||XXXX|||||||||||||||||---||||||||--||||||||||||||||||||||||||||||||||||||||||||||||||||||||||||||||||||||||||
