HEIGHT=16;WIDTH=201;THEME=0;OVERRIDE=false
--------------------------------------------------------------------------------------------------------------------------------------------------------------------------------------------------------
--------------------------------------------------------------------------------------------------------------------------------------------------------------------------------------------------------
--------------------------------------------------------------------------------------------------------------------------------------------------------------------------------------------------------
--------------------------------------------------------------------------------------------------------------------------------------------------------------------------------------------------------
--------------------------------------------------------------------------------------------------------------------------------------------------------------------------------------------------------
--------------------------------------------------------------------------------------------------------------------------------------------------------------------------------------------------------
--------------------------------------------------------------------------------------------------------------------------------------------------------------------------------------------------------
------------------------------------------------------------------------------------------------------------------SSS-----------------------------------------------------------------------------------
--------------------------------------------------------------------------------------------------------------------------------------------------------------------------------------------------------
-------------------------------------------------------------------------------------------------------------------------------------g------------------------------------------------------------------
----------------------------------------------------------------------------------------------------------------y----y--------------%%%%----------------------------------------------------------------
--------------Tt------------------r-----------------------------------------------------------------------------%%%%%%%-------------||||----------------------------------------------------------------
--------------tt---%%%%---%%%%%%%%%%%%%%%%%%---%%%%%-----------------------------------------------#--#---------|||||||------------%%%%%%%%%%%%---------------------------------------------------------
%%%%%%%%%%%%%%%%%%%||||---||||||||||||||||||---|||||%%%%%--%%%%%-------------%%%%%%%%%-----------%%%--%%%-------|||||||-----%%---%%||||||||||||---------------------------------------------------------
|||||||||||||||||||||||---||||||||||||||||||---||||||||||--|||||%%%%%---%%%%%|||||||||%%%%---%%%%|||--|||-------|||||gyr----||---||||||||||||||---------------------------------------------------------
|||||||||||||||||||||||---||||||||||||||||||---||||||||||--||||||||||---||||||||||||||||||---|||||||--|||XXXXXXXXXXXXXXXXXXX||---||||||||||||||XXXXXXXXFXXXXXXXXXXXXXXXXXXXXXXXXXXXXXXXXXXXXXXXXXXXXXXXX
