HEIGHT=16;WIDTH=201;THEME=0;OVERRIDE=false
--------------------------------------------------------------------------------------------------------------------------------------------------------------------------------------------------------
--------------------------------------------------------------------------------------------------------------------------------------------------------------------------------------------------------
--------------------------------------------------------------------------------------------------------------------------------------------------------------------------------------------------------
--------------------------------------------------------------------------------------------------------------------------------------------------------------------------------------------------------
--------------------------------------------------------------------------------------------------------------------------------------------------------------------------------------------------------
--------------------------------------------------------------------------------------------------------------------------------------------------------------------------------------------------------
---------------------------------------------------------------------------------------------------------------------%%%--------------------------------------------------------------------------------
---------------------------------------------------------------------------------------------------------------------|||--------------------------------------------------------------------------------
---------------------------------------------------------------------------------------------------------------------|||--------------------------------------------------------------------------------
--------------------------------------------------------------------------------------------------------%%%%%%-------|||--------------------------------------------------------------------------------
---------------------------------------------G---------------------#---#--------------------------------||||||-------|||--------------------------------------------------------------------------------
------------------------tt-----------------%%%%%%-----------------##---##-------------------------------|||||k----g--|||y-------------------------------------------------------------------------------
%%%%%%%%%%%-------------tt-----------------||||||---------------%%%%---%%%%%%%%--%%%%------------------%%%%%%%%%%%%%%%%%%%%%%%%--%%%%%------------------------------------------------------------------
|||||||||||---------%%%%%%%%%%%-----------%%%%%%%%%%------------||||---||||||||--||||------------------||||||||||||||||||||||||--|||||------------------------------------------------------------------
|||||||||||--#---#--|||||||||||-----------||||||||||%%%%%--%%%%%||||---||||||||--||||%%%---%%%--#---#--||||||||||||||||||||||||--|||||--%%%%%%%%F%%%%%%%%%%%%%%%%%%%%%%%%%%%%%%%%%%%%%%%%%%%%%%%%%%%%%%%
|||||||||||XXX---XXX|||||||||||XXXX---XXXX|||||||||||||||--|||||||||---||||||||--|||||||---|||XXX---XXX||||||||||||||||||||||||--|||||XX||||||||X|||||||||||||||||||||||||||||||||||||||||||||||||||||||
