HEIGHT=16;WIDTH=201;THEME=0;OVERRIDE=false
--------------------------------------------------------------------------------------------------------------------------------------------------------------------------------------------------------
--------------------------------------------------------------------------------------------------------------------------------------------------------------------------------------------------------
--------------------------------------------------------------------------------------------------------------------------------------------------------------------------------------------------------
--------------------------------------------------------------------------------------------------------------------------------------------------------------------------------------------------------
--------------------------------------------------------------------------------------------------------------------------------------------------------------------------------------------------------
--------------------------------------------------------------------------------------------------------------------------------------------------------------------------------------------------------
--------------------------------------------------------------------------------------------------------------------------------------------------------------------------------------------------------
--------------------------------------------------------------------------------------------------------------------------------------------------------------------------------------------------------
---------------SSCS2CC2S---------------------------SUSS---------------------------------------------------------------------------------SSS2SSSSS-------------------------------------------------------
--------------------------------------------------------------------------------------------------------------------------------------------------------------------------------------------------------
----------------------------------------------------------------------Tt-Tt-----------------------------------------------------------------------------------------------------------------------------
----------------------rr----------------------------------------------tt-tt--tt---------------------------------------------------------------y---------------------------------------------------------
--------------%%%%%%%%%%%-----------------#--#----%%%%%%--------------tt-tt--tt-------------------------------------------%%---%%%%--%%%%%%%%%%%%%------------------------------------------------------
%%%%%%%%%%%%%%|||||||||||----------------##--##---||||||----------%%%%%%%%%%%%%%---tt-tt----------------------------------||---||||--|||||||||||||------------------------------------------------------
|||||||||||||||||||||||||---------------###--###--||||||%%%%--%%%%||||||||||||||---tt-tt---%%%%%%%%%%%%--%%%--------------||---||||--|||||||||||||%%%%%%%%F%%%%%%%%%%%%%%%%%%%%%%%%%%%%%%%%%%%%%%%%%%%%%
|||||||||||||||||||||||||XXXXX---XXXXXXXXXX--XXXXX||||||||||--||||||||||||||||||XXXXXXXXXXX||||||||||||--|||XX--XXXXX--XXX||---||||--|||||||||||||||||||||X|||||||||||||||||||||||||||||||||||||||||||||
