HEIGHT=16;WIDTH=201;THEME=0;OVERRIDE=false
--------------------------------------------------------------------------------------------------------------------------------------------------------------------------------------------------------
--------------------------------------------------------------------------------------------------------------------------------------------------------------------------------------------------------
--------------------------------------------------------------------------------------------------------------------------------------------------------------------------------------------------------
--------------------------------------------------------------------------------------------------------------------------------------------------------------------------------------------------------
--------------------------------------------------------------------------------------------------------------------------------------------------------------------------------------------------------
--------------------------------------------------------------------------------------------------------------------------------------------------------------------------------------------------------
--------------------------------------------------------------------------------------------------------------------------------------------------------------------------------------------------------
----------------------------------------y---------------------------------------------------------------------------------------------------------------------------------------------------------------
-------------------------------------%%%%%--------------------------------------------------------------------------------------------------------------------------------------------------------------
-------------------------------------|||||--------------------------------------------------------------------------------------------------------------------------------------------------------------
-------------------------------------|||||--------------------------------------------------------------------------------------------------------------------------------------------------------------
-------------------------------------|||||--------#--#--------%%%---------------------------------------------------------------------------------------------------------------------------------------
%%%%%%%%%%%%----------%%%--%%%-----%%%||||------%%%--%%%------|||r------------------------------------------------------------------------------%%%%%%%%F%%%%%%%%%%%%%%%%%%%%%%%%%%%%%%%%%%%%%%%%%%%%%%%
||||||||||||----------|||--|||-g---|||||||------|||--|||%%%%%%%%%%%%%%%%---------------------------------%%%%---%%%%-----------------%%%%---%%%%||||||||%|||||||||||||||||||||||||||||||||||||||||||||||
||||||||||||----------|||--|||%%%%%%%%%%%%%%%%%%|||--|||||||||||||||||||-------------#--#--%%%%%%%%%%--%%||||---||||%%%---%%%--#--#--||||---||||||||||||||||||||||||||||||||||||||||||||||||||||||||||||
||||||||||||XXXX--XXXX|||--||||||||||||||||||||||||--|||||||||||||||||||XXXX---XXXXXXX--XXX||||||||||--||||||---|||||||---|||XXX--XXX||||---||||||||||||||||||||||||||||||||||||||||||||||||||||||||||||
