HEIGHT=16;WIDTH=201;THEME=0;OVERRIDE=false
--------------------------------------------------------------------------------------------------------------------------------------------------------------------------------------------------------
--------------------------------------------------------------------------------------------------------------------------------------------------------------------------------------------------------
--------------------------------------------------------------------------------------------------------------------------------------------------------------------------------------------------------
--------------------------------------------------------------------------------------------------------------------------------------------------------------------------------------------------------
--------------------------------------------------------------------------------------------------------------------------------------------------------------------------------------------------------
--------------------------------------------------------------------------------------------------------------------------------------------------------------------------------------------------------
--------------------------------------------------------------------------------------------------------------------------------------------------------------------------------------------------------
--------------------------------------------------------------------------------------------------------------------------------------------------------------------------------------------------------
-----------------------------------------------------------------------------------------------------------------------------SUCSS----------------------------------------------------------------------
--------------------------------------------------------------------------------------------------------------------------------------------------------------------------------------------------------
--------------------------------------------------------------------------------------------------------------------------------------------------------------------------------------------------------
-------------------------------------------#--#-----------------#--#------------------------------------------------------------------------------------------------------------------------------------
%%%%%%%%%%%%%%------------%%%--%%%%%%%%%--##--##--%%%%%--%%%%%%%%--%%%------------%%%%---------------------------------%%%%%%%%%%%%%%-------------------------------------------------------------------
||||||||||||||%%%%%--%%%%%|||--|||||||||%%%%--%%%%|||||--||||||||--|||------------||r|k----#---#-----------------------||||||||||||||%%--%%-------------------------------------------------------------
|||||||||||||||||||--||||||||--|||||||||||||--|||||||||--||||||||--|||%%%%%%%%%%%%%%%%%%--##---##--%%%%%%%--%%%%%%%--%%||||||||||||||||--||-------------------------------------------------------------
|||||||||||||||||||--||||||||--|||||||||||||--|||||||||--||||||||--|||||||||||||||||||||XXXX---XXXX|||||||--|||||||--||||||||||||||||||--||XXXXXXXXFXXXXXXXXXXXXXXXXXXXXXXXXXXXXXXXXXXXXXXXXXXXXXXXXXXXX
