HEIGHT=16;WIDTH=201;THEME=0;OVERRIDE=false
--------------------------------------------------------------------------------------------------------------------------------------------------------------------------------------------------------
--------------------------------------------------------------------------------------------------------------------------------------------------------------------------------------------------------
--------------------------------------------------------------------------------------------------------------------------------------------------------------------------------------------------------
--------------------------------------------------------------------------------------------------------------------------------------------------------------------------------------------------------
--------------------------------------------------------------------------------------------------------------------------------------------------------------------------------------------------------
--------------------------------------------------------------------------------------------------------------------------------------------------------------------------------------------------------
----------------------------------------------------------------------------------------------------------------------------------------SSCS2S----------------------------------------------------------
--------------------------------------------------------------------------------------------------------------------------------------------------------------------------------------------------------
-----------------------------------------------------SSUS-----------------------------------------------------------------------------------------------------------------------------------------------
--------------------------------------------------------------------------------------SCS2--------------------------------------------------------------------------------------------------------------
---------------------------------------------------------------------------------------------------------------------------------------%%%%%%%----------------------------------------------------------
----------------------------------------------------g---------------------------------------------------------------------------------k|||g|||----------------------------------------------------------
-----------%%--%%---------%%%%%--%%%%%%%%%---%%%%%%%%%%%%%------------------------------------------------%%---%%--------------------%%%%%%%%%%%--------------------------------------------------------
%%%%%%%%%%%||--||-------%%|||||--|||||||||---|||||||||||||------------------------%%%%%%%%%--%%%%%%%%%%%%%||---||--------------------|||||||||||%%%%%%%%F%%%%%%%%%%%%%%%%%%%%%%%%%%%%%%%%%%%%%%%%%%%%%%%
|||||||||||||--||-------|||||||--|||||||||---|||||||||||||------------------------|||||||||--|||||||||||||||---||%%%%---%%%%---------|||||||||||||||||||%|||||||||||||||||||||||||||||||||||||||||||||||
|||||||||||||--||XX---XX|||||||--|||||||||---|||||||||||||XXXXXXXXXXXXXXXX---XXXXX|||||||||XX|||||||||||||||---||||||---||||XXX---XXX|||||||||||||||||||||||||||||||||||||||||||||||||||||||||||||||||||
