HEIGHT=16;WIDTH=201;THEME=0;OVERRIDE=false
--------------------------------------------------------------------------------------------------------------------------------------------------------------------------------------------------------
--------------------------------------------------------------------------------------------------------------------------------------------------------------------------------------------------------
---------------------------------------------r----------------------------------------------------------------------------------------------------------------------------------------------------------
-----------------------------------------%%%%%%---------------------------------------------------------------------------------------------------------------------------------------------------------
-----------------------------------------||||||---------------------------------------------------------------------------------------------------------------------------------------------------------
-----------------------------------------||||g|---------------------------------------------------------------------------------------------------------------------------------------------------------
-----------------------------------------|%%%%%%%-------------------------------------------------------------------------------------------------------------------------------------------------------
-----------------------------------------||||||||-------------------------------------------------------------------------------------------------------------------------------------------------------
-----------------------------------------||||||||-------------------------------------------------------------------------------------------------------------------------------------------------------
-----------------------------------------|G||||||-------------------------------------------------------------------------------------------------------------------------------------------------------
---------------------------------------%%%%%%||||-------------------------------------------------------------------------------------------------------------------------------------------------------
---------------------------------------||||||||||---------------------------------------------%%%%%%------------------------#---#-----------------------------------------------------------------------
%%%%%%%%%%%%%%---%%--------tt-Tt-------||||||||||---------------%%%%%---%%%%%-----------------||||||---%%%%%---%%%%%------%%%---%%%%%%%--%%%%-----------------------------------------------------------
||||||||||||||---||--------tt-tt----%%%%%%%%%%%%%%%%%%----------|||||---|||||%%%--%%%---------||||||---|||||---|||||------|||---|||||||--||||%%%%%%%%F%%%%%%%%%%%%%%%%%%%%%%%%%%%%%%%%%%%%%%%%%%%%%%%%%%
||||||||||||||---||%%---%%-tt-tt----||||||||||||||||||%%%%--%%%%|||||---||||||||--|||---------||||||---|||||---|||||------|||---|||||||--||||||||||||%||||||||||||||||||||||||||||||||||||||||||||||||||
||||||||||||||---||||---||XXXXXXXXXX||||||||||||||||||||||--|||||||||---||||||||--|||XXXXXXXXXXXXXXXXXX|||||---|||||XX--XX|||---|||||||--|||||||||||||||||||||||||||||||||||||||||||||||||||||||||||||||
