HEIGHT=16;WIDTH=201;THEME=0;OVERRIDE=false
--------------------------------------------------------------------------------------------------------------------------------------------------------------------------------------------------------
--------------------------------------------------------------------------------------------------------------------------------------------------------------------------------------------------------
--------------------------------------------------------------------------------------------------------------------------------------------------------------------------------------------------------
--------------------------------------------------------------------------------------------------------------------------------------------------------------------------------------------------------
--------------------------------------------------------------------------------------------------------------------------------------------------------------------------------------------------------
--------------------------------------------------------------------------------------------------------------------------------------------------------------------------------------------------------
--------------------------------------------------------------------------------------------------------------------------------------------------------------------------------------------------------
--------------------------------------------------------------------------------------------------------------------------------------------------------------------------------------------------------
--------------------------------------------------------------------------------------------------------------------------------------------------------------------------------------------------------
--------------------------------------------------------------------------------------------------------------------------------------------------------------------------------------------------------
----------------------------------------------------------------------------------------------------S-SCS-----------------------------------------------------------------------------------------------
--------------------------------------------------------------------------------------------r-----------------------------------------------------------------------------------------------------------
-------------%%%%%--%%%%%-----k-------r-g--------------------------------------------------%%%%%%%---%-----%%---%%-------------#---#----%%%%%%%%F%%%%%%%%%%%%%%%%%%%%%%%%%%%%%%%%%%%%%%%%%%%%%%%%%%%%%%%
-------------|||||--|||||%%%%%%%------%%%--------------------------------------------------|||||||---|r----||---||%%%---%%%---##---##---||||||||%|||||||||||||||||||||||||||||||||||||||||||||||||||||||
-------------|||||--||||||||||||------|||-r-------------------------------------%%%%%%%%%%%|||||||%%%%%%%%%||---|||||---|||--###---###--||||||||||||||||||||||||||||||||||||||||||||||||||||||||||||||||
XXXXXXXXXXXXX|||||--||||||||||||XXXXXXXXXXXXXXXXXX---XXXXXXXXX---XXXXXXXX---XXXX|||||||||||||||||||||||||||||---|||||---|||XXXXX---XXXXX||||||||||||||||||||||||||||||||||||||||||||||||||||||||||||||||
