HEIGHT=16;WIDTH=201;THEME=0;OVERRIDE=false
--------------------------------------------------------------------------------------------------------------------------------------------------------------------------------------------------------
--------------------------------------------------------------------------------------------------------------------------------------------------------------------------------------------------------
--------------------------------------------------------------------------------------------------------------------------------------------------------------------------------------------------------
--------------------------------------------------------------------------------------------------------------------------------------------------------------------------------------------------------
--------------------------------------------------------------------------------------------------------------------------------------------------------------------------------------------------------
--------------------------------------------------------------------------------------------------------------------------------------------------------------------------------------------------------
--------------------------------------------------------------------------------------------------------------------------------------------------------------------------------------------------------
--------------------------------------------------------------------------------------------------------------------------------------------------------------------------------------------------------
----------------------------------------------------------------------------------------------------S-C-------------------------------------------------------------------------------------------------
-------------------------------------------------#--#---------------------------------------------------------------------------------------------------------------------------------------------------
------------------------------------------------##--##--------------#---#------#--#------------------|--------------------------------------------------------------------------------------------------
-----------------------------------------------###--###----#--#----##---##----##--##---%%%%%%--------Ky-----#---#---------------------------------------------------------------------------------------
----------------------tt---------%%%%%%%---%%%%%%%--%%%%%%%%--%%%%%%%---%%%%%%%%--%%%%-||||||----%%%%%%%%--##---##-------------------------------%%%%%%%%F%%%%%%%%%%%%%%%%%%%%%%%%%%%%%%%%%%%%%%%%%%%%%%
----------------------tt---%%%%%%|||||||---|||||||--||||||||--|||||||---||||||||--||||-||||||k---||||||||%%%%---%%%%---------#---#--%%%%%---%%%%%||||||||%||||||||||||||||||||||||||||||||||||||||||||||
------------%%%--%%%--tt---|||||||||||||---|||||||--||||||||--|||||||---||||||||--||||%%%%%%%%%%%||||||||||||---||||%%---%%%%%---%%%|||||---||||||||||||||||||||||||||||||||||||||||||||||||||||||||||||
XXXXXXXXXXXX|||--|||XXXXXXX|||||||||||||---|||||||--||||||||--|||||||---||||||||--|||||||||||||||||||||||||||---||||||---|||||---||||||||---||||||||||||||||||||||||||||||||||||||||||||||||||||||||||||
