HEIGHT=16;WIDTH=201;THEME=0;OVERRIDE=false
--------------------------------------------------------------------------------------------------------------------------------------------------------------------------------------------------------
--------------------------------------------------------------------------------------------------------------------------------------------------------------------------------------------------------
--------------------------------------------------------------------------------------------------------------------------------------------------------------------------------------------------------
--------------------------------------------------------------------------------------------------------------------------------------------------------------------------------------------------------
--------------------------------------------------------------------------------------------------------------------------------------------------------------------------------------------------------
--------------------------------------------------------------------------------------------------------------------------------------------------------------------------------------------------------
--------------------------------------------------------------------------------------------------------------------------------------------------------------------------------------------------------
--------------------------------------------------------------------------------------------------------------------------------------------------------------------------------------------------------
------------------------------------------------------------------------------------------------------------------------------------CCSC----------------------------------------------------------------
-------------------------------------------------r---g--------------------------------------------------------------------------------------------------------------------------------------------------
-------------------------------CCC---------------%%%%%----------------------------------------k---------------------------------------------------------------------------------------------------------
----------------------------------------#--#----r||||y---------------------------S22--------%%%%------------------------#--#----------------------------------------------------------------------------
--------------%%%%%---%%%%%------------##--##--%%%%%%%%%%%%%%%%%----------------------------g|k|-----------------------##--##---%%%%%%%%%%%%%%%%%%F%%%%%%%%%%%%%%%%%%%%%%%%%%%%%%%%%%%%%%%%%%%%%%%%%%%%%
%%%%%%%%%%%%%%|||||---|||||---y---g--%%%%--%%%%|||||||||||||||||--------%%--%%---------%%%%%%%%%%%--------------------###--###--||||||||||||||||||%|||||||||||||||||||||||||||||||||||||||||||||||||||||
|||||||||||||||||||---|||||%%%%%%%%%%||||--|||||||||||||||||||||--#--#--||--||---------|||||||||||------------------%%%%%--%%%%%||||||||||||||||||||||||||||||||||||||||||||||||||||||||||||||||||||||||
|||||||||||||||||||---|||||||||||||||||||--|||||||||||||||||||||XXX--XXX||--||XXXXXXXXX|||||||||||XX--XXXXXXX--XXXXX|||||--|||||||||||||||||||||||||||||||||||||||||||||||||||||||||||||||||||||||||||||
