HEIGHT=16;WIDTH=201;THEME=0;OVERRIDE=false
--------------------------------------------------------------------------------------------------------------------------------------------------------------------------------------------------------
--------------------------------------------------------------------------------------------------------------------------------------------------------------------------------------------------------
--------------------------------------------------------------------------------------------------------------------------------------------------------------------------------------------------------
--------------------------------------------------------------------------------------------------------------------------------------------------------------------------------------------------------
-----------------------------------------------------------------------r--------------------------------------------------------------------------------------------------------------------------------
---------------------------------------------------------------------%%%%-------------------------------------------------------------------------------------------------------------------------------
---------------------------------------------------------------------||||-------------------------------------------------------------------------------------------------------------------------------
---------------------------------------------------------------------||||-------------------------------------------------------------------------------------------------------------------------------
---------------------------------------------------------------------||%%%%%%---22CSS-------------------------------------------------------------------------------------------------------------------
------------------------------------------------------tt-------------||||||||---------------------------------------------------------------------------------------------------------------------------
------------------------------------------------------tt-------------||||||||---------------------------------------------------------------------------------------------------------------------------
------------------------------------------------------tt-------------||||||||---------------------------------------------------------------------------------------------------------------------------
%%%%%%%%%%-------#---#--------------%%---%%-------%%%%%%%%%%-%%%%%---||||||||--%%%%%%%%%%------------r-------------------------------%%%---%%%----------------------------------------------------------
||||||||||------##---##---%%%%--%%%%||---||%%---%%||||||||||-G||||---||k|||||--||||||||||%%%%---%%%%%%%%%%%%%---#---#----------------|||---|||----------------------------------------------------------
||||||||||-----###---###--||||--||||||---||||---||||||||||||%%%%%%%%%%%%%%%%%%%||||||||||||||---|||||||||||||--##---##--%%%%%---%%%%%|||---|||----------------------------------------------------------
||||||||||XXXXXXXX---XXXXX||||--||||||---||||---|||||||||||||||||||||||||||||||||||||||||||||---|||||||||||||XXXX---XXXX|||||---||||||||---|||XXXXXXXXFXXXXXXXXXXXXXXXXXXXXXXXXXXXXXXXXXXXXXXXXXXXXXXXXX
