HEIGHT=16;WIDTH=201;THEME=0;OVERRIDE=false
--------------------------------------------------------------------------------------------------------------------------------------------------------------------------------------------------------
--------------------------------------------------------------------------------------------------------------------------------------------------------------------------------------------------------
--------------------------------------------------------------------------------------------------------------------------------------------------------------------------------------------------------
--------------------------------------------------------------------------------------------------------------------------------------------------------------------------------------------------------
--------------------------------------------------------------------------------------------------------------------------------------------------------------------------------------------------------
--------------------------------------------------------------------------------------------------------------------------------------------------------------------------------------------------------
--------------------------------------------------------------------------------------------------------------------------------------------------------------------------------------------------------
--------------------------------------------------------------------------------------------------------------------------------------------------------------------------------------------------------
--------------------------------------------------------------------------------------------------------------------------------------------------------------------------------------------------------
---------------------------------------------------------------------------------------------------------------------------------------------------%%%--------------------------------------------------
-----------------------------Tt--------------------------------------------------------------------------------------------------------------------|||--------------------------------------------------
--------------------#--#-----tt-------CSU2--------------------------------------------------------------------------#--#--------C2SS---------------|||--------------------------------------------------
-------------------##--##----tt------------------------%%%---%%%%%%%------%%%%%--%%%%%-----------------------------##--##--------------------------|||--------------------------------------------------
--------------%%--###--###--%%%%%%---------------------|||---|||||||%%--%%|||||--|||||-----------------%%%%%%%----###--###-----------------%%%-----|||--------------------------------------------------
%%%%%%%%%%%%%%||%%%%%--%%%%%||||||----Gg---%%%%%--%%%%%|||---|||||||||--|||||||--|||||-----------------|||k||r--%%%%%--%%%%%-----------g-yk|||---k-|g|--%%%%%%%%F%%%%%%%%%%%%%%%%%%%%%%%%%%%%%%%%%%%%%%%
|||||||||||||||||||||--|||||||||||XXXXXXXXX|||||--||||||||---|||||||||--|||||||--|||||XX---XXXXX---XXXXXXXXXXXXX|||||--|||||XXXXXXXXXXXXXXXXXXXXXXXXXXXX||||||||X|||||||||||||||||||||||||||||||||||||||
