HEIGHT=16;WIDTH=201;THEME=0;OVERRIDE=false
--------------------------------------------------------------------------------------------------------------------------------------------------------------------------------------------------------
--------------------------------------------------------------------------------------------------------------------------------------------------------------------------------------------------------
--------------------------------------------------------------------------------------------------------------------------------------------------------------------------------------------------------
--------------------------------------------------------------------------------------------------------------------------------------------------------------------------------------------------------
--------------------------------------------------------------------------------------------------------------------------------------------------------------------------------------------------------
--------------------------------------------------------------------------------------------------------------------------------------------------------------------------------------------------------
--------------------------------------------------------------------------------------------------------------------------------------------------------------------------------------------------------
--------------------------------------------------------------------------------------------------------------------------------------------------------------------------------------------------------
-------------------------------------------------------------2C2SU--------------------------------------------SCSC2S--2CSSSSSC------------y-------------------------------------------------------------
----------------------------------------------------------------------------------------------------------------------------------------%%%%%-----------------------------------------------------------
----------------%%%%%-------------------------------------------------------------------------------------------------------------------|||||-----------------------------------------------------------
----------------|||y|---------------------------------------rK-yr-k-------------------------------------------y----r--------k----------G|||||-----------------------------------------------------------
----------%%%%%%%%%%%%%%%%%%%-----------------------------%%%%%%%%%%%%%%---%%%-----------------------#--#--%%%%%%%%%%%%%%%%%%%%%%%--%%%%%%%%%%%%%%%%%%%%%%%%%%F%%%%%%%%%%%%%%%%%%%%%%%%%%%%%%%%%%%%%%%%%
%%%%%%%%%%|||||||||||||||||||----------------%%--%%%%---%%||||||||||||||---|||----k----------------%%%--%%%|||||||||||||||||||||||--||||||||||||||||||||||||||%|||||||||||||||||||||||||||||||||||||||||
|||||||||||||||||||||||||||||%%---%%%%%---%%%||--||||---||||||||||||||||---|||%%%%%%%%-------------|||--||||||||||||||||||||||||||--||||||||||||||||||||||||||||||||||||||||||||||||||||||||||||||||||||
|||||||||||||||||||||||||||||||---|||||---|||||--||||---||||||||||||||||---|||||||||||XXXXX---XXXXX|||--||||||||||||||||||||||||||--||||||||||||||||||||||||||||||||||||||||||||||||||||||||||||||||||||
