HEIGHT=16;WIDTH=201;THEME=0;OVERRIDE=false
--------------------------------------------------------------------------------------------------------------------------------------------------------------------------------------------------------
--------------------------------------------------------------------------------------------------------------------------------------------------------------------------------------------------------
--------------------------------------------------------------------------------------------------------------------------------------------------------------------------------------------------------
--------------------------------------------------------------------------------------------------------------------------------------------------------------------------------------------------------
--------------------------------------------------------------------------------------------------------------------------------------------------------------------------------------------------------
--------------------------------------------------------------------------------------------------------------------------------------------------------------------------------------------------------
--------------------------------------------------------------------------------------------------------------------------------------------------------------------------------------------------------
--------------------------------------------------------------------------------------------------------------------------------------------------------------------------------------------------------
--------------------------------------------------------------------------------------------------------------------------------------------------------------------------------------------------------
-----------------------------------------------------------------------------------------------y--------------------------------------------------------------------------------------------------------
--------------------------------------------------------------------------------------------%%%%%%------------------------------------------------------------------------------------------------------
------------------------------------------------------------------------------------------y-||||||------------------------------------------------------------------------------------------------------
------------%%%%%---%%%%%%%--%%--------------------#--#--------Tt-----------------------%%%%%%%%%%%%%%%%%%%---%%%%%%---%%%%-------------------%%%%%%%%F%%%%%%%%%%%%%%%%%%%%%%%%%%%%%%%%%%%%%%%%%%%%%%%%%
------------|||||---|||||||--||-------------------##--##-------tt---%%--%%--------------|||||||||||||||||||---||||||---||||-------------------||||||||%|||||||||||||||||||||||||||||||||||||||||||||||||
%%%%%%%%%%%%|||||---|||||||--||%%%%--%%%%--------###--###------tt---||--||----y-%%%--%%%|||||||||||||||||||---||||||---||||%%%%---%%%%--------||||||||||||||||||||||||||||||||||||||||||||||||||||||||||
|||||||||||||||||---|||||||--||||||--||||XX--XXXXXXX--XXXXXXXXXXXXXX||--||XXXXXX|||--||||||||||||||||||||||---||||||---||||||||---||||XXX--XXX||||||||||||||||||||||||||||||||||||||||||||||||||||||||||
