HEIGHT=16;WIDTH=201;THEME=0;OVERRIDE=false
--------------------------------------------------------------------------------------------------------------------------------------------------------------------------------------------------------
--------------------------------------------------------------------------------------------------------------------------------------------------------------------------------------------------------
--------------------------------------------------------------------------------------------------------------------------------------------------------------------------------------------------------
--------------------------------------------------------------------------------------------------------------------------------------------------------------------------------------------------------
--------------------------------------------------------------------------------------------------------------------------------------------------------------------------------------------------------
--------------------------------------------------------------------------------------------------------------------------------------------------------------------------------------------------------
--------------------------------------------------------------------------------------------------------------------------------------------------------------------------------------------------------
--------------------------------------------------------------------------------------------------------------------------------------------------------------------------------------------------------
-----------SUSSS-S--------------------------------------------------------------------------------------------------------------------------------------------------------------------------------------
----------------------------------------------------------------------------2SSS------------------------------------------------------------------------------------------------------------------------
----------------%---------------------------------------------------------------------------------------------------------------------------------------------------------------------------------------
--------------g-|------------------------------------------------------------------------------------#---#----------------------------------------------------------------------------------------------
-----------%%%%%%%--%%%---%%%---------%%--%%------------------------------------------------%%%%%---##---##---%%%%%---%%%%%-----------------------------------------------------------------------------
-----------|||||y|--|||---|||---------||--||%%%%%%---%%%------%%%%%%%---%%%%%%%%%%%%%---%%%%|||||--###---###--|||||---|||||-----------%%%--%%%----------------------------------------------------------
----------%%%%%%%%%%|||---|||%%%%%%%%%||--||||||||---|||%%%%%%|||||||---|||||||||||||---|||||||||%%%%%---%%%%%|||||---|||||-----------|||--|||----------------------------------------------------------
XXXXXXXXXX|||||||||||||---||||||||||||||--||||||||---||||||||||||||||---|||||||||||||---||||||||||||||---||||||||||---|||||XXXX---XXXX|||--|||XXXXXXXXFXXXXXXXXXXXXXXXXXXXXXXXXXXXXXXXXXXXXXXXXXXXXXXXXX
