HEIGHT=16;WIDTH=201;THEME=0;OVERRIDE=false
--------------------------------------------------------------------------------------------------------------------------------------------------------------------------------------------------------
--------------------------------------------------------------------------------------------------------------------------------------------------------------------------------------------------------
--------------------------------------------------------------------------------------------------------------------------------------------------------------------------------------------------------
--------------------------------------------------------------------------------------------------------------------------------------------------------------------------------------------------------
--------------------------------------------------------------------------------------------------------------------------------------------------------------------------------------------------------
--------------------------------------------------------------------------------------------------------------------------------------------------------------------------------------------------------
--------------------------------------------------------------------------------------------------------------------------------------------------------------------------------------------------------
--------------------------------------------------------------------------------------------------------------------------------------------------------------------------------------------------------
--------------------------------------------------------------------------------------------------------------------------------------------------------------------------------------------------------
---------------------CC---------------------------------------------#---#----------------Yy---r---------------------------------------------------------------------------------------------------------
-------------------------------------------------------------------##---##--------------%%%%%%%----------------------------tt---------------------------------------------------------------------------
-----------------------%-----2-S----------------------------------###---###------#--#---|||||||-r---------------------Tt---tt---------------------------------------------------------------------------
-------------%%--%%----|---------------------------%%%%---------%%%%%---%%%%%--%%%--%%%%%%%%%%%%%%%-------------------tt---tt---------------------------------------------------------------------------
%%%%%%%%%%%%%||--||%%%%%%%%---%--------------------||||%%%---%%%|||||---|||||--|||--|||||||||||||||---------------Tt-%%%%%%%%%%%%-----------------------------------------------------------------------
|||||||||||||||--||||||||||---|--%%%--%%%----------|||||||---||||||||---|||||%%|||--|||||||||||||||%%%%-----------tt-||||||||||||-------%%%%%%%%F%%%%%%%%%%%%%%%%%%%%%%%%%%%%%%%%%%%%%%%%%%%%%%%%%%%%%%%
|||||||||||||||--||||||||||XXXXXX|||--|||XXXX--XXXX|||||||---||||||||---||||||||||--|||||||||||||||||||XXX---XXXXXXXX||||||||||||XX---XX||||||||X|||||||||||||||||||||||||||||||||||||||||||||||||||||||
