HEIGHT=16;WIDTH=201;THEME=0;OVERRIDE=false
--------------------------------------------------------------------------------------------------------------------------------------------------------------------------------------------------------
--------------------------------------------------------------------------------------------------------------------------------------------------------------------------------------------------------
--------------------------------------------------------------------------------------------------------------------------------------------------------------------------------------------------------
--------------------------------------------------------------------------------------------------------------------------------------------------------------------------------------------------------
--------------------------------------------------------------------------------------------------------------------------------------------------------------------------------------------------------
--------------------------------------------------------------------------------------------------------------------------------------------------------------------------------------------------------
--------------------------------------------------------------------------------------------------------------------------------------------------------------------------------------------------------
--------------------------------------------------------------------------------------------------------------------------------------------------------------------------------------------------------
-----------SSSC2S--------------------------------------------------------------------------------SC-----------------------------------------------------------------------------------------------------
----------------------------------------------------------------2CSSUSC---------------------------------------------------------------------------------------------------------------------------------
---------------------------------------------------------------------------------------------------%--------------------Tt-Tt---------------------------------------------------------------------------
------------g-------------------------------------------------------------------------CCC2CS-------|--------------------tt-tt---------------------------------------------------------------------------
----------%%%%%%%%----%%---%%%%--%%-----%%%%%%%%%------------------r---r----------------------%%%%%%%%%--#---#-------%%%%%%%%%--------------------------------------------------------------------------
----------||||||||----||---||||--||-----|||||||||--------------%%%%%%%%%%---#---#-------------|||||||||%%%---%%%-----|||||||||%%%%%%%-------------------------------------------------------------------
%%%%%%%%%%||||||||----||---||||--||%%%%%|||||||||--------------||||||||||--##---##-------y----||||||||||||---|||-----||||||||||||||||%%%---%%%%%%%%%%%F%%%%%%%%%%%%%%%%%%%%%%%%%%%%%%%%%%%%%%%%%%%%%%%%%
||||||||||||||||||XXXX||---||||--||||||||||||||||XX---XXXX---XX||||||||||XXXX---XXXXXXXXXXXXXX||||||||||||---|||XXXXX|||||||||||||||||||---|||||||||||X|||||||||||||||||||||||||||||||||||||||||||||||||
