HEIGHT=16;WIDTH=201;THEME=0;OVERRIDE=false
--------------------------------------------------------------------------------------------------------------------------------------------------------------------------------------------------------
--------------------------------------------------------------------------------------------------------------------------------------------------------------------------------------------------------
--------------------------------------------------------------------------------------------------------------------------------------------------------------------------------------------------------
--------------------------------------------------------------------------------------------------------------------------------------------------------------------------------------------------------
--------------------------------------------------------------------------------------------------------------------------------------------------------------------------------------------------------
--------------------------------------------------------------------------------------------------------------------------------------------------------------------------------------------------------
--------------------------------------------------------------------------------------------------------------------------------------------------------------------------------------------------------
--------------------------------------------------------------------------------------------------------------------------------------------------------------------------------------------------------
--------------------------------------------------------------------------------------------------------------------------------------------------------------------------------------------------------
--------------------------------------------------------------------------------------------------------------------------------------------------------------------------------------------------------
------------------------------------------#--#----------------------------------------------------------------------------------------------------------------------------------------------------------
-----------------------------------------##--##---------------------------------------------------------------------------------------------------------------------------------------------------------
----------------------------------%%%%%%%%%--%%%%---------------------------%%%---%%%--#--#-------------------------------------------------------------------------------------------------------------
----------------------------------|||||||||--||||%%%%%%%%---%%%%%%%%%--%%%%%|||---|||%%%--%%%------tt---tt-----------------------#--#-------------------------------------------------------------------
%%%%%%%%%%%%---%%--#---#----------|||||||||--||||||||||||---|||||||||--||||||||---||||||--|||%%%%--tt---tt-----------%%%---%%%--##--##--%%%%%%%%F%%%%%%%%%%%%%%%%%%%%%%%%%%%%%%%%%%%%%%%%%%%%%%%%%%%%%%%
||||||||||||---||XXX---XXXXXX--XXX|||||||||--||||||||||||---|||||||||--||||||||---||||||--|||||||XXXXXXXXXXXXXX--XXXX|||---|||XXXX--XXXX||||||||X|||||||||||||||||||||||||||||||||||||||||||||||||||||||
