HEIGHT=16;WIDTH=201;THEME=0;OVERRIDE=false
--------------------------------------------------------------------------------------------------------------------------------------------------------------------------------------------------------
--------------------------------------------------------------------------------------------------------------------------------------------------------------------------------------------------------
--------------------------------------------------------------------------------------------------------------------------------------------------------------------------------------------------------
--------------------------------------------------------------------------------------------------------------------------------------------------------------------------------------------------------
--------------------------------------------------------------------------------------------------------------------------------------------------------------------------------------------------------
--------------------------------------------------------------------------------------------------------------------------------------------------------------------------------------------------------
--------------------------------------------------------------------------------------------------------------------------------------------------------------------------------------------------------
----------------------y---------------------------------------------------------------------------------------------------------------------------------------------------------------------------------
--------------------%%%---------------------------------------------------------------------------------------------------------------------------------------------------------------------------------
--------------------|||---------------------------------------------------------------------------------------------------------------------------------------------------------------------------------
--------------------|||----------------------------------------tt------------------------------------------#---#----------------------------------------------------------------------------------------
-------------------g|||-------------------------------#--#-----tt-----------------------------------------##---##-----C2S2CSS---------------------------------------------------------------------------
---------------%%%%%%||--------------------%%%---%%%%%%--%%%---tt-%%--%%%%%%%---%%%%%------------%%%%%%--###---###--------------------------------------------------------------------------------------
---------------||||||||--------------------|||---||||||--|||%%%%%%||--|||||||---|||||------------||||||%%%%%---%%%%%-----------%%%%%--%%%%%-------------------------------------------------------------
---------------||||||||--------------------|||---||||||--|||||||||||--|||||||---|||||------------|||||||||||---|||||-----g-----|||||--|||||-------------------------------------------------------------
XXXXXXXXXXXXXXXXXXXXXXXXXXXX---XXXXXX---XXX|||---||||||--|||||||||||--|||||||---|||||XXXX--XXXXXX|||||||||||---|||||XXXXXXXXXXX|||||--|||||XXXXXXXXFXXXXXXXXXXXXXXXXXXXXXXXXXXXXXXXXXXXXXXXXXXXXXXXXXXXX
