HEIGHT=16;WIDTH=201;THEME=0;OVERRIDE=false
--------------------------------------------------------------------------------------------------------------------------------------------------------------------------------------------------------
--------------------------------------------------------------------------------------------------------------------------------------------------------------------------------------------------------
--------------------------------------------------------------------------------------------------------------------------------------------------------------------------------------------------------
----------------------------------------------------------------------------------------------------CS2-------------------------------------------------------------------------------------------------
--------------------------------------------------------------------------------------------------------------------------------------------------------------------------------------------------------
--------------------------------------------------------------------------------------------------------------------------------------------------------------------------------------------------------
---------------------------------------------------------------------------------------------------r-k--------------------------------------------------------------------------------------------------
--------------------------------------------------------------------------------------------------%%%%%-------------------------------------------------------------------------------------------------
--------------------------------------------------------------------------------------------------|||||-------------------------------------------------------------------------------------------------
--------------------------------------------------------------------------------------------------|||||-------------------------------------------------------------------------------------------------
-------------------------------------CS-CS---------------------------------------------------%%%--|||||---------------SS2-2SS-------------Tt---tt-------------------------------------------------------
---------------------------------------------------------------------------------------------|||--|||||---------------------------Tt------tt---tt-------------------------------------------------------
------------------%%%%%%---------------|-------------------------------------%%%-------------|||--|||||--%%%%%--%%%%%----|--------tt------tt---tt-------------------------------------------------------
-----------%%--%%-||||||--------------gy--------------%%%%%--%%%%%%%%%---%%%%|||%%%%%--g-----|||-r|||||--|||||--|||||--g-rr-------tt--%%%%%%%%%%%%%%%%%%%%%%F%%%%%%%%%%%%%%%%%%%%%%%%%%%%%%%%%%%%%%%%%%%
%%%%%%%%%%%||--||-|g||||---g-------%%%%%%%%%----------|||||--|||||||||---||||||||||||%%%%%%%%%%%%%%%%%%%%|||||--|||||%%%%%%%%%%%%%%%%%||||||||||||||||||||||%|||||||||||||||||||||||||||||||||||||||||||
|||||||||||||--||XXXXXXXXXXXXXXXXXX|||||||||XXXXXXXXXX|||||--|||||||||---|||||||||||||||||||||||||||||||||||||--||||||||||||||||||||||||||||||||||||||||||||||||||||||||||||||||||||||||||||||||||||||||
