HEIGHT=16;WIDTH=201;THEME=0;OVERRIDE=false
--------------------------------------------------------------------------------------------------------------------------------------------------------------------------------------------------------
--------------------------------------------------------------------------------------------------------------------------------------------------------------------------------------------------------
--------------------------------------------------------------------------------------------------------------------------------------------------------------------------------------------------------
--------------------------------------------------------------------------------------------------------------------------------------------------------------------------------------------------------
--------------------------------------------------------------------------------------------------------------------------------------------------------------------------------------------------------
--------------------------------------------------------------------------------------------------------------------------------------------------------------------------------------------------------
--------------------------------------------------------------------------------------------------------------------------------------------------------------------------------------------------------
--------------------------------------------------------------------------------------------------------------------------------------------------------------------------------------------------------
--------------------------------------------------------------------------------------------------------------------------------------------------------------------------------------------------------
--------------------------------------------------------------------------------------------------------------------------------------------------------------------------------------------------------
------------------------------------------------------------------------------------#---#---------------------------------------------------------------------------------------------------------------
--------------------------------------------------------------------------#---#----##---##--------------------------------------------------------------------------------------------------------------
---------------------------------%%%--%%%-----%%--%%--------------------%%%---%%%%%%%---%%%%-----%%%----------------------------------------------------------------------------------------------------
---------------------------------|||--|||-----||--||%%--%%-----%%%---%%%|||---|||||||---||||%%%%%|||--------%%%%--%%%%----------------------------------------------------------------------------------
%%%%%%%%%%%%%%--------%%%%---%%%%|||--|||%%%%%||--||||--||%%%%%|||---||||||---|||||||---||||||||||||--------||||--||||------%%%%%-------------%%%%%%%%F%%%%%%%%%%%%%%%%%%%%%%%%%%%%%%%%%%%%%%%%%%%%%%%%%
||||||||||||||XXX--XXX||||---|||||||--||||||||||--||||--||||||||||---||||||---|||||||---||||||||||||XXXXXXXX||||--||||XX--XX|||||XXXXX---XXXXX||||||||X|||||||||||||||||||||||||||||||||||||||||||||||||
