HEIGHT=16;WIDTH=201;THEME=0;OVERRIDE=false
--------------------------------------------------------------------------------------------------------------------------------------------------------------------------------------------------------
--------------------------------------------------------------------------------------------------------------------------------------------------------------------------------------------------------
--------------------------------------------------------------------------------------------------------------------------------------------------------------------------------------------------------
--------------------------------------------------------------------------------------------------------------------------------------------------------------------------------------------------------
--------------------------------------------------------------------------------------------------------------------------------------------------------------------------------------------------------
--------------------------------------------------------------------------------------------------------------------------------------------------------------------------------------------------------
--------------------------------------------------------------------------------------------------------------------------------------------------------------------------------------------------------
--------------------------------------------------------------------------------------------------------------------------------------------------------------------------------------------------------
--------------------------------------------------------------------------------------------------------------------------------------------------------------------------------------------------------
---------------------------------------------------------------------------------------------------SCUS----SSSCS----------------------------------------------------------------------------------------
--------------SSSS---------------------------------------------------------------------SUCCSC-----------------------------------------------------------------------------------------------------------
----------------------------------#--#------------------------------------------------------------------------------------------------------------------------------------------------------------------
%%%%%%%%%%%----------------------##--##---%%%%%--%%%%%%%%---------------------------------------------k------yg-----------------------------------------------------------------------------------------
|||||||||||--------%%%%---%%%%--###--###--|||||--||||||||--------------#---#-----------r---------%%%%%%%-%%%%%%%-----#---#--%%%%--%%%%%%--%%------------------------------------------------------------
|||||||||||%%%%%%%%||||---||||%%%%%--%%%%%|||||--||||||||%%%%%--%%%%%%%%---%%%--------%%%%%%%%%%%|||||||-|y|||||---%%%---%%%||||--||||||--||%%%%%%%%F%%%%%%%%%%%%%%%%%%%%%%%%%%%%%%%%%%%%%%%%%%%%%%%%%%%
|||||||||||||||||||||||---|||||||||--||||||||||--|||||||||||||--||||||||---|||XXX--XXX||||||||||||||||||XXXXXXXXXXX|||---|||||||--||||||--||||||||||X|||||||||||||||||||||||||||||||||||||||||||||||||||
