HEIGHT=16;WIDTH=201;THEME=0;OVERRIDE=false
--------------------------------------------------------------------------------------------------------------------------------------------------------------------------------------------------------
--------------------------------------------------------------------------------------------------------------------------------------------------------------------------------------------------------
--------------------------------------------------------------------------------------------------------------------------------------------------------------------------------------------------------
--------------------------------------------------------------------------------------------------------------------------------------------------------------------------------------------------------
--------------------------------------------------------------------------------------------------------------------------------------------------------------------------------------------------------
--------------------------------------------------------------------------------------------------------------------------------------------------------------------------------------------------------
--------------------------------------------------------------------------------------------------------------------------------------------------------------------------------------------------------
------------------------y-------------------------------------------------------------------------------------------------------------------------------------------------------------------------------
-----------------------%%%------------------------------------------------------------------------------------------------------------------------------------------------------------------------------
-----------------------|||--------------------------------------------------------------------------------#--#------------------------------------------------------------------------------------------
-----------------------k||------------------------------------------------tt---tt------------------------##--##-----------------------------------------------------------------------------------------
--------------------%%%%||------------------------------------------------tt---tt-----------------------###--###----------------------------------------------------------------------------------------
%%%%%%%%%%%---------||||||-----Tt--%%---%%------------------------------%%%%%%%%%%--------------------%%%%%--%%%%%--------------------------------------------------------------------------------------
|||||||||||---------||||||-----tt--||---||%%%%%---%%%%%%%--%%-----------||||||||||%%%%---%%%%--#---#--|||||--|||||%%%%---%%%%----------------%%%%%%%%F%%%%%%%%%%%%%%%%%%%%%%%%%%%%%%%%%%%%%%%%%%%%%%%%%%
|||||||||||--------g||yy|y-----tt--||---|||||||---|||||||--||-----------||||||||||||||---||||%%%---%%%|||||--|||||||||---||||%%%%--%%%%%%--%%||||||||%||||||||||||||||||||||||||||||||||||||||||||||||||
|||||||||||XX---XXXXXXXXXXXXXXXXXXX||---|||||||---|||||||--||XXXX---XXXX||||||||||||||---|||||||---||||||||--|||||||||---||||||||--||||||--|||||||||||||||||||||||||||||||||||||||||||||||||||||||||||||
