HEIGHT=16;WIDTH=201;THEME=0;OVERRIDE=false
--------------------------------------------------------------------------------------------------------------------------------------------------------------------------------------------------------
--------------------------------------------------------------------------------------------------------------------------------------------------------------------------------------------------------
--------------------------------------------------------------------------------------------------------------------------------------------------------------------------------------------------------
--------------------------------------------------------------------------------------------------------------------------------------------------------------------------------------------------------
--------------------------------------------------------------------------------------------------------------------------------------------------------------------------------------------------------
--------------------------------------------------------------------------------------------------------------------------------------------------------------------------------------------------------
--------------------------------------------------------------------------------------------------------------------------------------------------------------------------------------------------------
--------------------------------------------------------------------------------------------------------------------------------------------------------------------------------------------------------
--------------------------------------------------------------------------------------------------------------------------------------------------------------------------------------------------------
--------------------------------------------------------------------------------------------------------------------------------------------------------------------------------------------------------
---------------------------------------------------------------------------------------------------------------------------------tt---------------------------------------------------------------------
-----------------------------------r-----------------------------------------------------------------------------------#---#-----tt---tt----------------------------------------------------------------
%%%%%%%%%%---#--#----------------%%%%%--------#--#------------%%%%%%%%%%---%%%%%%---%%%%------------------------------##---##----tt---tt----------------------------------------------------------------
||||||||||--##--##-----#---#-----|||||------%%%--%%%%%--------||||||||||---||||||---||||%%%---%%%%%%---%%%-----------###---###--%%%%%%%%%%%%%%%%%%F%%%%%%%%%%%%%%%%%%%%%%%%%%%%%%%%%%%%%%%%%%%%%%%%%%%%%
||||||||||%%%%--%%%%--##---##----|||||---%%%|||--|||||%%%--%%%||||||||||---||||||---|||||||---||||||---|||%%%---%%%%%%%%---%%%%%||||||||||||||||||%|||||||||||||||||||||||||||||||||||||||||||||||||||||
||||||||||||||--||||XXXX---XXXXXXXXXXXXXX||||||--||||||||--|||||||||||||---||||||---|||||||---||||||---||||||---||||||||---|||||||||||||||||||||||||||||||||||||||||||||||||||||||||||||||||||||||||||||
