HEIGHT=16;WIDTH=201;THEME=0;OVERRIDE=false
--------------------------------------------------------------------------------------------------------------------------------------------------------------------------------------------------------
--------------------------------------------------------------------------------------------------------------------------------------------------------------------------------------------------------
--------------------------------------------------------------------------------------------------------------------------------------------------------------------------------------------------------
--------------------------------------------------------------------------------------------------------------------------------------------------------------------------------------------------------
--------------------------------------------------------------------------------------------------------------------------------------------------------------------------------------------------------
--------------------------------------------------------------------------------------------------------------------------------------------------------------------------------------------------------
--------------------------------------------------------------------------------------------------------------------------------------------------------------------------------------------------------
--------------------------------------------------------------------------------------------------------------------------------------------------------------------------------------------------------
--------------------------------------------------------------------------------------------------------------------------------------------------------------------------------------------------------
--------------------------------------------------------------------------------------------------------------------------------------------------------------------------------------------------------
-------------------------------------------------------------------------------------------------------------------------------------%%%%%--------------------------------------------------------------
-----------------------------------------SSSS----------------------------------------------------------------------------------------|||||--------------------------------------------------------------
-------------------------%%%%%---%%%%%-------------------------------------%%--%%----------------------------------------------------|||||------------%%%%%%%%F%%%%%%%%%%%%%%%%%%%%%%%%%%%%%%%%%%%%%%%%%
--------------%%%%---%%%%|||||---|||||-------------------#--#--%%%%--------||--||%%--%%----------------------------------------------|||||---y--------||||||||%|||||||||||||||||||||||||||||||||||||||||
%%%%%%%%%%%%%%||||---|||||||||---|||||-------g--%%---%%%%%--%%%||||%%%--%%%||--||||--||----------------%%%%%--%%%%%----------------%%%%%%%%%%%%%%%%%%%||||||||||||||||||||||||||||||||||||||||||||||||||
||||||||||||||||||---|||||||||---|||||XXXXXXXXXX||---|||||--||||||||||--|||||--||||--||XXX--XXXXX--XXXX|||||--|||||XXXX--XXXXXX--XX|||||||||||||||||||||||||||||||||||||||||||||||||||||||||||||||||||||
