HEIGHT=16;WIDTH=201;THEME=0;OVERRIDE=false
--------------------------------------------------------------------------------------------------------------------------------------------------------------------------------------------------------
--------------------------------------------------------------------------------------------------------------------------------------------------------------------------------------------------------
--------------------------------------------------------------------------------------------------------------------------------------------------------------------------------------------------------
--------------------------------------------------------------------------------------------------------------------------------------------------------------------------------------------------------
--------------------------------------------------------------------------------------------------------------------------------------------------------------------------------------------------------
--------------------------------------------------------------------------------------------------------------------------------------------------------------------------------------------------------
--------------------------------------------------------------------------------------------------------------------------------------------------------------------------------------------------------
--------------------------------------------------------------------------------------------------------------------------------------------------------------------------------------------------------
--------------------------------------------------------------------------------------------------------------------------------------------------------------------------------------------------------
-------------------------------------------------------------------------------------------------------------------------SCSSS2---------USSSCC----------------------------------------------------------
--------------------------------------------------------------------------------------------------------------------------------------------------------------------------------------------------------
---------------------------------------#---#------------------------------------------------------------------------------------------------------------------------------------------------------------
----------------------------%%---%%---##---##---%%%%---%%%%-----------------------#--#----------%%%%--%%%%%%%---%%%----------k---------k-r--g-----------------------------------------------------------
---------------------%%---%%||---||--###---###--||||---||||----------------------##--##---------||||--|||||||---|||------%%%%%%-------%%%%%%%%%%%-------------------------------------------------------
---------------#--#--||---||||---||%%%%%---%%%%%||||---||||-------------#---#--%%%%--%%%%%%---%%||||--|||||||---|||---r--||||||-------|||||||||||%%%%%%%%F%%%%%%%%%%%%%%%%%%%%%%%%%%%%%%%%%%%%%%%%%%%%%%
XXXXXXXXXXXXXXXX--XXX||---||||---|||||||---|||||||||---||||XXXX---XXXXXXX---XXX||||--||||||---||||||--|||||||---|||XXXXXXXXXXXXXXXXXXX|||||||||||||||||||X||||||||||||||||||||||||||||||||||||||||||||||
