HEIGHT=16;WIDTH=201;THEME=0;OVERRIDE=false
--------------------------------------------------------------------------------------------------------------------------------------------------------------------------------------------------------
--------------------------------------------------------------------------------------------------------------------------------------------------------------------------------------------------------
--------------------------------------------------------------------------------------------------------------------------------------------------------------------------------------------------------
--------------------------------------------------------------------------------------------------------------------------------------------------------------------------------------------------------
--------------------------------------------------------------------------------------------------------------------------------------------------------------------------------------------------------
------------------------------------------------------------------------------------y-------------------------------------------------------------------------------------------------------------------
---------------------------------------------------------------------------------%%%%%------------------------------------------------------------------------------------------------------------------
---------------------------------------------------------------------------------|||||kg----------------------------------------------------------------------------------------------------------------
---------------------------------------------------------------------------------||%%%%%%%--------------------------------------------------------------------------------------------------------------
-----------------------------------------------------------tt--tt----------------|||||||||-----------------------2SCSC----------------------------------------------------------------------------------
---------------S2CS----------------------------------------tt--tt----------------|||||||||--------------------------------------------------------------------------------------------------------------
-----------------------------------------------------------tt--tt----------------|||||||||--------------------------------------------------------------------------------------------------------------
%%%%%%%%%%%%%%---------------------#--#----------------%%%%%%%%%%%%%%--------%%%%%%%%%%%%%%%%%%%%%%---%%%%-------------y--------------------------------------------------------------------------------
||||||||||||||--------------------##--##--%%%%%---%%%%%||||||||||||||--------||||||||||||||||||||||---||||----%%%%%%%%%%%-------------------------------------------------------------------------------
||||||||||||||%%%%%%%%----------%%%%--%%%%|||||---|||||||||||||||||||--#--#--||||||||||||||||||||||---||||----|||||||||||%%%--%%%%%--%%-----------------------------------------------------------------
||||||||||||||||||||||XXXX--XXXX||||--|||||||||---|||||||||||||||||||XXX--XXX||||||||||||||||||||||---||||XXXX||||||||||||||--|||||--||XXX--XXXXXXXXXXXFXXXXXXXXXXXXXXXXXXXXXXXXXXXXXXXXXXXXXXXXXXXXXXXX
