HEIGHT=16;WIDTH=201;THEME=0;OVERRIDE=false
--------------------------------------------------------------------------------------------------------------------------------------------------------------------------------------------------------
--------------------------------------------------------------------------------------------------------------------------------------------------------------------------------------------------------
--------------------------------------------------------------------------------------------------------------------------------------------------------------------------------------------------------
--------------------------------------------------------------------------------------------------------------------------------------------------------------------------------------------------------
------------------------------------------------------------------------------2SUS----------------------------------------------------------------------------------------------------------------------
--------------------------------------------------------------------------------------------------------------------------------------------------------------------------------------------------------
--------------------------------------------------------------------------------------------------------------------------------------------------------------------------------------------------------
-----------------------------------------------------------------------------r--------------------------------------------------------------------------------------------------------------------------
---------------------------------------------------------------------------%%%%%%%----------------------------------------------------------------------------------------------------------------------
---------------------------------------------------------------------------|||||||----------------------------------------------------------------------------------------------------------------------
---------------#---#-------------------------------------------------------|||||||----------------------------------------------------------------------------------------------------------------------
--------------##---##---------------------------------------------------y-y|||||||-------------#--#--------#---#----------------------------------------------------------------------------------------
------------%%%%---%%%%-----%%%%%---%%%--------------------#--#--------%%%%%%%%%%%%%%---------##--##------##---##---%%%---%%%-------------%%%%%%%%F%%%%%%%%%%%%%%%%%%%%%%%%%%%%%%%%%%%%%%%%%%%%%%%%%%%%%
%%%%%%%%%%%%||||---||||%%%%%|||||---|||------------------%%%--%%%------||||||||||||||--------###--###----###---###--|||---|||%%%%%---%%%%%||||||||%|||||||||||||||||||||||||||||||||||||||||||||||||||||
||||||||||||||||---||||||||||||||---|||%%%%%--%%%%%%%--%%|||--|||%%%%%%||||||||||||||------%%%%%--%%%%%%%%%%---%%%%%|||---||||||||---|||||||||||||||||||||||||||||||||||||||||||||||||||||||||||||||||||
||||||||||||||||---||||||||||||||---||||||||--|||||||--|||||--|||||||||||||||||||||||XX--XX|||||--||||||||||---||||||||---||||||||---|||||||||||||||||||||||||||||||||||||||||||||||||||||||||||||||||||
