HEIGHT=16;WIDTH=201;THEME=0;OVERRIDE=false
--------------------------------------------------------------------------------------------------------------------------------------------------------------------------------------------------------
--------------------------------------------------------------------------------------------------------------------------------------------------------------------------------------------------------
--------------------------------------------------------------------------------------------------------------------------------------------------------------------------------------------------------
--------------------------------------------------------------------------------------------------------------------------------------------------------------------------------------------------------
--------------------------------------------------------------------------------------------------------------------------------------------------------------------------------------------------------
----------------------------------------------------------------------------------------------------------------------------------%%%-------------------------------------------------------------------
----------------------------------------------------------------------------------------------------------------------------------|||-------------------------------------------------------------------
----------------------------------------------------------------------------------------------------------------------------------|||-------------------------------------------------------------------
----------------------------------------------------------------------------------------------------------------------------------|k|-------------------------------------------------------------------
----------------------------------------------------------------------------------------------------------------------------------|%%%%-----------------------------------------------------------------
----------------------------------------------------------------------------------------------------------------------------------|||||-----------------------------------------------------------------
------------------------------#--#------------------------------------%%%%%%%-----------------------------------------------------|||||-----------------------------------------------------------------
-----------------------%%%%--##--##-----tt--%%%%%--%%%%%--------------|||||||---%%%--%%%-------%%%%%--%%%%%-%%%%%------------y--r-|||||-----------------------------------------------------------------
--------------%%%%%%%%%||||%%%%--%%%%---tt--|||||--|||||%%%%%---%%%%%%%%%%%%%%%%|||--|||-------|||||--|||||-|||||----------%%%%%%%%%%%%%%%--------------------------------------------------------------
%%%%%%%%%%%%%%|||||||||||||||||--||||%%%%%%%|||||--||||||||||---|||||||||||||||||||--|||---r---|||||--|||||-|||||---y------|||||||||||||||%%%%%%%%F%%%%%%%%%%%%%%%%%%%%%%%%%%%%%%%%%%%%%%%%%%%%%%%%%%%%%
|||||||||||||||||||||||||||||||--||||||||||||||||--||||||||||---|||||||||||||||||||--|||XXXXXXX|||||--|||||XXXXXXXXXXXXXXXX|||||||||||||||||||||||X|||||||||||||||||||||||||||||||||||||||||||||||||||||
