HEIGHT=16;WIDTH=201;THEME=0;OVERRIDE=false
--------------------------------------------------------------------------------------------------------------------------------------------------------------------------------------------------------
--------------------------------------------------------------------------------------------------------------------------------------------------------------------------------------------------------
--------------------------------------------------------------------------------------------------------------------------------------------------------------------------------------------------------
--------------------------------------------------------------------------------------------------------------------------------------------------------------------------------------------------------
--------------------------------------------------------------------------------------------------------------------------------------------------------------------------------------------------------
----------------------------------------------------------------------------------------------------------------------k---------------------------------------------------------------------------------
---------------------------------------------------------------------------------------------------------------------%%%%-------------------------------------------------------------------------------
-------------------------------------------------------------------------------------------------------------------k-||||-------------------------------------------------------------------------------
-----------------------------------------CCS---------------------------------------------------------------------%%%%%%%|-------------------------------------------------------------------------------
-----------------------------------------------------------------------------------------------------------------||||||||-------------------------------------------------------------------------------
------------------------------------------------SUSC-------------------------------------------------Tt-Tt-------||||||||-------------------------------------------------------------------------------
------------------------------------------y-----------------------------------#--#-------------------tt-tt-------y|||||||-------------------------------------------------------------------------------
%%%%%%%%%%%%%%%--%%%%%%%---%%%%%%%--%%%%%%%%%----------------------%%%---%%%%%%--%%%%%%%%%%----------tt-tt------%%%%%%%%%%%-----------------------------------------------------------------------------
|||||||||||||||--|||||||---|||||||--|||||||||-------gkk-%%%%---%%%%|||---||||||--||||||||||-------%%%%%%%%%%%%%%|||||||||||%%%%%%%------%%%%%%%%F%%%%%%%%%%%%%%%%%%%%%%%%%%%%%%%%%%%%%%%%%%%%%%%%%%%%%%%
|||||||||||||||--|||||||---|||||||--|||||||||%%%%%%%%%%%||||---|||||||---||||||--||||||||||-------||||||||||||||||||||||||||||||||%%--%%||||||||%|||||||||||||||||||||||||||||||||||||||||||||||||||||||
|||||||||||||||--|||||||---|||||||--||||||||||||||||||||||||---|||||||---||||||--||||||||||XX---XX||||||||||||||||||||||||||||||||||--||||||||||||||||||||||||||||||||||||||||||||||||||||||||||||||||||
