HEIGHT=16;WIDTH=201;THEME=0;OVERRIDE=false
--------------------------------------------------------------------------------------------------------------------------------------------------------------------------------------------------------
--------------------------------------------------------------------------------------------------------------------------------------------------------------------------------------------------------
--------------------------------------------------------------------------------------------------------------------------------------------------------------------------------------------------------
--------------------------------------------------------------------------------------------------------------------------------------------------------------------------------------------------------
--------------------------------------------------------------------------------------------------------------------------------------------------------------------------------------------------------
--------------------------------------------------------------------------------------------------------------------------------------------------------------------------------------------------------
--------------------------------------------------------------------------------------------------------------------------------------------------------------------------------------------------------
--------------------------------------------------------------------------------------------------------------------------------------------------------------------------------------------------------
--------------------------------------------------------------------------------------------------------------------------------------------------------------------------------------------------------
--------------------------K-y----------------------------------------------------------------------------------r----------------------------------------------------------------------------------------
----------------CCSCC----%%%%%%%-------------------------------------------------------SSC2S-----------------%%%%%--------------------------------------------------------------------------------------
-------------------------|||||||----------------------SSSSUS2------------------------------------------------|||||--------------------------------------------------------------------------------------
%%%%%%%%%%%%%%---------%%%%%%%%%%%--------------------------------------------%%%%%-----------%%%%%%%%-------k|||r-r------------------------------------------------------------------------------------
||||||||||||||---------|||||||||||%%--%%--------------------------------------|||||-----------||||||||%%%%%%%%%%%%%%%%%%%-------------------------------------------------------------------------------
||||||||||||||%%%%%%%%%|||||||||||||--||%%%%%---%%%%%-------------------------|||||%%%%%%%%%%%|||||||||||||||||||||||||||-----------%%%%%%--------------------------------------------------------------
||||||||||||||||||||||||||||||||||||--|||||||---|||||XXXXXXXXXXXXXX--XXXXX--XX|||||||||||||||||||||||||||||||||||||||||||XXXX---XXXX||||||XXXXXXXXFXXXXXXXXXXXXXXXXXXXXXXXXXXXXXXXXXXXXXXXXXXXXXXXXXXXXX
