HEIGHT=16;WIDTH=201;THEME=0;OVERRIDE=false
--------------------------------------------------------------------------------------------------------------------------------------------------------------------------------------------------------
--------------------------------------------------------------------------------------------------------------------------------------------------------------------------------------------------------
--------------------------------------------------------------------------------------------------------------------------------------------------------------------------------------------------------
--------------------------------------------------------------------------------------------------------------------------------------------------------------------------------------------------------
--------------------------------------------------------------------------------------------------------------------------------------------------------------------------------------------------------
--------------------------------------------------------------------------------------------------------------------------------------------------------------------------------------------------------
----------------------%%%%------------------------------------------------------------------------------------------------------------------------------------------------------------------------------
----------------------||||------------------------------------------------------------------------------------------------------------------------------------------------------------------------------
----------------------||||------------------------------------------------------------------------------------------------------------------------------------------------------------------------------
----------------------||||------------------------------------------------------------------------------------------------------------------------------------------------------------------------------
-----------------%%%--||||------------------------------------------------------------------------------------------------------------------------------------------------------------------------------
-----------------|||--||||------------------------------------------------------------------------------------------------------------------------------------------------------------------------------
-----------------|||--||||---------------------------#---#---%%%%%--------------------------------------------------------------------------------------------------------------------------------------
----------------%%%%%%%%%%%%%------------%%%---%%%--##---##--|||||%%---%%-----------------------------------------------%%%%---#--#---------------------------------------------------------------------
%%%%%%%%%%------|||||||||||||------------|||---|||%%%%---%%%%|||||||---||%%---------%%%%%---%%%%%-----------------------||||--##--##--%%%%%%%%%%%%F%%%%%%%%%%%%%%%%%%%%%%%%%%%%%%%%%%%%%%%%%%%%%%%%%%%%%
||||||||||XXXXXX|||||||||||||XXXXX--XXXXX|||---|||||||---|||||||||||---||||XXX---XXX|||||---|||||XXXXX--XXXXXXXXX---XXXX||||XXXX--XXXX||||||||||||X|||||||||||||||||||||||||||||||||||||||||||||||||||||
