HEIGHT=16;WIDTH=201;THEME=0;OVERRIDE=false
--------------------------------------------------------------------------------------------------------------------------------------------------------------------------------------------------------
--------------------------------------------------------------------------------------------------------------------------------------------------------------------------------------------------------
--------------------------------------------------------------------------------------------------------------------------------------------------------------------------------------------------------
--------------------------------------------------------------------------------------------------------------------------------------------------------------------------------------------------------
--------------------------------------------------------------------------------------------------------------------------------------------------------------------------------------------------------
--------------------------------------------------------------------------------------------------------------------------------------------------------------------------------------------------------
--------------------------------------------------------------------------------------------------------------------------------------------------------------------------------------------------------
--------------------------------------------------------------------------------------------------------------------------------------------------------------------------------------------------------
-------------------------------------SSU2---------------------------------------------------------------------------------------------------------------------------------------------------------------
----------------------------------------------------------------------------------------%%%%%--------r---------------------SCCS-------------------------------------------------------------------------
------------------------------------%---------------------------------------------------|y|||-------%%%-------------------------------------------------------------------------------------------------
------------------------------------|---------------------------------------------------|%%%%%%-----|||-------------------------------------------------------------------------------------------------
------------%%%---%%%-----------k--%%%%%%%----------------------------------------------||||g|g-----|||---k--y------------------------------------------------------------------------------------------
------------|||---|||-------%%%%%%%|||||||---------#--#---%%---%%----------------------%%%%%%%%%%%%%%%%%%%%%%%%%%%%%--%%%%%%%%%%%%-----------%%%%%%%%F%%%%%%%%%%%%%%%%%%%%%%%%%%%%%%%%%%%%%%%%%%%%%%%%%%
%%%%%%%%%%%%|||---|||%%---%%||||||||||||||--------##--##--||---||%%%%--%%%%%%%%%--%%%%%|||||||||||||||||||||||||||||--||||||||||||%%%%---%%%%||||||||%||||||||||||||||||||||||||||||||||||||||||||||||||
|||||||||||||||---|||||---||||||||||||||||XX--XXXXXX--XXXX||---||||||--|||||||||--||||||||||||||||||||||||||||||||||--||||||||||||||||---|||||||||||||||||||||||||||||||||||||||||||||||||||||||||||||||
