HEIGHT=16;WIDTH=201;THEME=0;OVERRIDE=false
--------------------------------------------------------------------------------------------------------------------------------------------------------------------------------------------------------
--------------------------------------------------------------------------------------------------------------------------------------------------------------------------------------------------------
--------------------------------------------------------------------------------------------------------------------------------------------------------------------------------------------------------
--------------------------------------------------------------------------------------------------------------------------------------------------------------------------------------------------------
----------------------SCCS------------------------------------------------------------------------------------------------------------------------------------------------------------------------------
--------------------------------------------------------------------------------------------------------------------------------------------------------------------------------------------------------
--------------------------------------------------------------------------------------------------------------------------------------------------------------------------------------------------------
--------------------------------------------------------------------------------------------------------------------------------------------------------------------------------------------------------
---------------------%%%%%%-----------------------------------------------------------------------------------------------------------------------------------------------------------------------------
---------------------||||||------------------------------------------------------------------------------2SS2SU2S---------------------------------------------------------------------------------------
---------------------||||||--------------------------------------#--#-----------------------------------------------------------------------------------------------------------------------------------
---------------------||||||--k----------------#--#--------------##--##------------tt--------------------------------------------------------------------------------------------------------------------
---------------------||||%%%%%%%-------------##--##-----------%%%%--%%%%%%----Tt--tt--%%---%%------------g-----r-------------------------%%%%%%%%F%%%%%%%%%%%%%%%%%%%%%%%%%%%%%%%%%%%%%%%%%%%%%%%%%%%%%%
%%%%%%%%%%-----------||||||||r||y----------%%%%--%%%%---------||||--||||||----tt--tt--||---||%%%%%------%%%%%%%%%%%%%%%---%%%%-----------||||||||%||||||||||||||||||||||||||||||||||||||||||||||||||||||
||||||||||%%%---%%%%%%%%%%%%%%%%%%%--------||||--||||%%%%%%%%%||||--||||||%%%%%%%%%%%%||---|||||||%%--%%|||||||||||||||---||||-----------|||||||||||||||||||||||||||||||||||||||||||||||||||||||||||||||
|||||||||||||---|||||||||||||||||||XXX--XXX||||--|||||||||||||||||--||||||||||||||||||||---|||||||||--|||||||||||||||||---||||XXXX---XXXX|||||||||||||||||||||||||||||||||||||||||||||||||||||||||||||||
