HEIGHT=16;WIDTH=201;THEME=0;OVERRIDE=false
--------------------------------------------------------------------------------------------------------------------------------------------------------------------------------------------------------
--------------------------------------------------------------------------------------------------------------------------------------------------------------------------------------------------------
--------------------------------------------------------------------------------------------------------------------------------------------------------------------------------------------------------
--------------------------------------------------------------------------------------------------------------------------------------------------------------------------------------------------------
--------------------------------------------------------------------------------------------------------------------------------------------------------------------------------------------------------
--------------------------------------------------------------------------------------------------------------------------------------------------------------------------------------------------------
--------------------------------------------------------------------------------------------------------------------------------------------------------------------------------------------------------
--------------------------------------------------------------------------------------------------------------------------------------------------------------------------------------------------------
-----------------------------------------------------------------------r--------------------------------------------------------------------------------------------------------------------------------
-----------tt--Tt-tt--------------------------------------------------%%%-------------------------------------------------------------------------------------------------------------------------------
-----------tt--tt-tt--------------------------------------------------|||-------------------------------------------------------------------------------------------------------------------------------
-----------tt--tt-tt---------------------------------------tt---------|||-------------------------------------------------------------------------------------------------------------------------------
----------%%%%%%%%%%%%%---%%%%%%%--------------------------tt---------|||------------------------%%--%%%%%%---%%%%%%%--%%%--------%%%%%---%%%%%---------------------------------------------------------
%%%%%%%%%%|||||||||||||---|||||||----------%%%%%---%%%%%%%%%%%%%%%----|||--%%%%-------#---#------||--||||||---|||||||--|||--------|||||---|||||---------------------------------------------------------
|||||||||||||||||||||||---||||||g---r-%%%%%|||||---|||||||||||||||----|||--||||------##---##--%%%||--||||||---|||||||--|||--------|||||---|||||---------------------------------------------------------
|||||||||||||||||||||||XXXXXXXXXXXXXXX||||||||||---|||||||||||||||XXXXXXXXXXXXXXXXXXXXX---XXXX|||||--||||||---|||||||--|||XXX--XXX|||||---|||||XXXXXXXXFXXXXXXXXXXXXXXXXXXXXXXXXXXXXXXXXXXXXXXXXXXXXXXXX
