HEIGHT=16;WIDTH=201;THEME=0;OVERRIDE=false
--------------------------------------------------------------------------------------------------------------------------------------------------------------------------------------------------------
--------------------------------------------------------------------------------------------------------------------------------------------------------------------------------------------------------
---------------------------------------------------------------------------------------------CSSCS------------------------------------------------------------------------------------------------------
--------------------------------------------------------------------------------------------------------------------------------------------------------------------------------------------------------
--------------------------------------------------------------------------------------------------------------------------------------------------------------------------------------------------------
--------------------------------------------------------------------------------------------r--k--------------------------------------------------------------------------------------------------------
--------------------------------------------------------------------------------------------%%%%%%------------------------------------------------------------------------------------------------------
--------------------------------------------------------------------------------------------||||||------------------------------------------------------------------------------------------------------
--------------------------------------------------------------------------------------------||||||--r---------------------------------------------------------------------------------------------------
--------------------------------------------------------------------------------------------||%%%%%%%-----------------------------S-SSSSS-S-------------------------------------------------------------
--------------------------------------------------------------------------------SSUSSC------|||||||||---------------#--#--------------------------------------------------------------------------------
--------------------------------------------------------------------------------------------|||||||||--------------##--##----------%-----%--------------------------------------------------------------
------------------------%%%%%---%%%%%-------------------------------------------------------|||||||||------------%%%%--%%%%%%%%----|--ky-|--%%%%%%%%F%%%%%%%%%%%%%%%%%%%%%%%%%%%%%%%%%%%%%%%%%%%%%%%%%%%
%%%%%%%%%%%%%%%%%---%%%%|||||---|||||%%--%%--------%%%%%---%%%%%-------------------------%%%%%%%%%%%%%%%%%%------||||--||||||||--%%%%%%%%%%%||||||||%|||||||||||||||||||||||||||||||||||||||||||||||||||
|||||||||||||||||---|||||||||---|||||||--||--------|||||---|||||-----------%%%%%%%%%%%%%%||||||||||||||||||------||||--||||||||--|||||||||||||||||||||||||||||||||||||||||||||||||||||||||||||||||||||||
|||||||||||||||||---|||||||||---|||||||--||XXX--XXX|||||---|||||XXXX---XXXX||||||||||||||||||||||||||||||||XX--XX||||--||||||||XX|||||||||||||||||||||||||||||||||||||||||||||||||||||||||||||||||||||||
