HEIGHT=16;WIDTH=201;THEME=0;OVERRIDE=false
--------------------------------------------------------------------------------------------------------------------------------------------------------------------------------------------------------
--------------------------------------------------------------------------------------------------------------------------------------------------------------------------------------------------------
--------------------------------------------------------------------------------------------------------------------------------------------------------------------------------------------------------
--------------------------------------------------------------------------------------------------------------------------------------------------------------------------------------------------------
--------------------------------------------------------------------------------------------------------------------------------------------------------------------------------------------------------
--------------------------------------------------------------------------------------------------------------------------------------------------------------------------------------------------------
--------------------------------------------------------------------------------------------------------------------------------------------------------------------------------------------------------
--------------------------------------------------------------------------------------------------------------------------------------------------------------------------------------------------------
--------------------------------------------------------------------------------------------------------------------------------------------------------------------------------------------------------
---------------------------------------------------------------------------------------------------------------------------r----------------------------------------------------------------------------
------------------------------------------------------------------------------------------------------tt---------------%%%%%------tt--------------------------------------------------------------------
---------------------------------------------------------------------------------------g--y--------tt-tt---------------|||||------tt--------------------------------------------------------------------
%%%%%%%%%%%%%%-----------------------------------------------------------#---#------%%%%%%%--------tt-tt---------------|||||---%%%%%%%%%%%%%%%%%%F%%%%%%%%%%%%%%%%%%%%%%%%%%%%%%%%%%%%%%%%%%%%%%%%%%%%%%
||||||||||||||%%--%%----------------------------------------------------##---##-----|||||k|----%%%%%%%%%%%%%%--#--#--%%%%%%%%%%||||||||||||||||||%||||||||||||||||||||||||||||||||||||||||||||||||||||||
||||||||||||||||--||%%---%%%%%%%--%%%%%-------------------%%%%---%%%%--###---###--%%%%%%%%%%%%%||||||||||||||%%%--%%%|||||||||||||||||||||||||||||||||||||||||||||||||||||||||||||||||||||||||||||||||||
||||||||||||||||--||||---|||||||--|||||XX--XXXXXXX---XXXXX||||---||||XXXXX---XXXXX||||||||||||||||||||||||||||||--||||||||||||||||||||||||||||||||||||||||||||||||||||||||||||||||||||||||||||||||||||||
