HEIGHT=16;WIDTH=201;THEME=0;OVERRIDE=false
--------------------------------------------------------------------------------------------------------------------------------------------------------------------------------------------------------
--------------------------------------------------------------------------------------------------------------------------------------------------------------------------------------------------------
--------------------------------------------------------------------------------------------------------------------------------------------------------------------------------------------------------
--------------------------------------------------------------------------------------------------------------------------------------------------------------------------------------------------------
--------------------------------------------------------------------------------------------------------------------------------------------------------------------------------------------------------
--------------------------------------------------------------------------------------------------------------------------------------------------------------------------------------------------------
----------------------------------------------------------------------------------------------------------------------------------%%%%%%----------------------------------------------------------------
----------------------------------------------------------------------------------------------------------------------------------||||||----------------------------------------------------------------
----------------------------------------------------------------------------------------------------------------------------------||||||----------------------------------------------------------------
----------------------------------------------------------------------------------------------------------------------------------||||||----------------------------------------------------------------
--------------------------------------------------------------------------------------#---#------------------------%%%%%%---------||||%%%%--------------------------------------------------------------
-------------------------------------------------#--#--------------------------------##---##-----------------------||||||---------||||||||--------------------------------------------------------------
------------------------------------%%%%---%%%%%%%--%%%-----%%%---%%%%%%%%---%%%%%--###---###----------------------||||||---------||||||||--------------------------------------------------------------
%%%%%%%%%%%%------------------------||||---|||||||--|||%%%%%|||---||||||||---|||||%%%%%---%%%%%------------------Kk||r|||---------||||||||--------------------------------------------------------------
||||||||||||-----------%%%%%---%%%%%||||---|||||||--|||||||||||---||||||||---||||||||||---|||||-----------%%%%%%%%%%%%%%%%%%%%%%%%%%%%%%%%%%%%%%%%%%%F%%%%%%%%%%%%%%%%%%%%%%%%%%%%%%%%%%%%%%%%%%%%%%%%%%
||||||||||||XXXX---XXXX|||||---|||||||||---|||||||--|||||||||||---||||||||---||||||||||---|||||XXXX---XXXX|||||||||||||||||||||||||||||||||||||||||||X||||||||||||||||||||||||||||||||||||||||||||||||||
