HEIGHT=16;WIDTH=201;THEME=0;OVERRIDE=false
--------------------------------------------------------------------------------------------------------------------------------------------------------------------------------------------------------
--------------------------------------------------------------------------------------------------------------------------------------------------------------------------------------------------------
--------------------------------------------------------------------------------------------------------------------------------------------------------------------------------------------------------
--------------------------------------------------------------------------------------------------------------------------------------------------------------------------------------------------------
--------------------------------------------------------------------------------------------------------------------------------------------------------------------------------------------------------
--------------------------------------------------------------------------------------------------------------------------------------------------------------------------------------------------------
--------------------------------------------------------------------------------------------------------------------------------------------------------------------------------------------------------
--------------------------------------------------------------------------------------------------------------------------------------------------------------------------------------------------------
--------------------------------------------------------------------------------------------------------------------------------------------------------------------------------------------------------
------------------------------------------------------------------------------------------------------------#---#-----SSCCS----------tt-----------------------------------------------------------------
----------------------------#---#--------------------------------------------------y-----------------------##---##-------------------tt-tt--------------------------------------------------------------
---------------------------##---##-------------------------------------------------%%%--------------------###---###------------------tt-tt--------------------------------------------------------------
--------------------------###---###--%%%%---%%%%%%%%%---%%%%%----------------------|||------------------%%%%%---%%%%%-------%%--%%%%%%%%%%%%%-----------------------------------------------------------
%%%%%%%%%%%%------%%--%%%%%%%---%%%%%||||---|||||||||---|||||%%%%%%%---------------|||------------------|||||---|||||%%%%%%%||--|||||||||||||-----------------------------------------------------------
||||||||||||------||--|||||||---|||||||||---|||||||||---||||||||||||---------------|||------------%%--%%|||||---||||||||||||||--|||||||||||||-----------------------------------------------------------
||||||||||||XX--XX||--|||||||---|||||||||---|||||||||---||||||||||||XXXXX--XXXXXXXXXXXXXXXXXXXXXXX||--|||||||---||||||||||||||--|||||||||||||XXXXXXXXFXXXXXXXXXXXXXXXXXXXXXXXXXXXXXXXXXXXXXXXXXXXXXXXXXX
