HEIGHT=16;WIDTH=201;THEME=0;OVERRIDE=false
--------------------------------------------------------------------------------------------------------------------------------------------------------------------------------------------------------
--------------------------------------------------------------------------------------------------------------------------------------------------------------------------------------------------------
--------------------------------------------------------------------------------------------------------------------------------------------------------------------------------------------------------
--------------------------------------------------------------------------------------------------------------------------------------------------------------------------------------------------------
--------------------------------------------------------------------------------------------------------------------------------------------------------------------------------------------------------
--------------------------------------------------------------------------------------------------------------------------------------------------------------------------------------------------------
--------------------------------------------------------------------------------------------------------------------------------------------------------------------------------------------------------
--------------------------------------------------------------------------------------------------------------------------------------------------------------------------------------------------------
----------------------------------------------------------------------SCS-----SSSS----------------------------------------------------------------------------------------------------------------------
--------------------------------------------------------------------------------------------------------------------------------------------------------------------------------------------------------
-----------------------------------------------------------------------------------------%%%------------------------------------------------------------------------------------------------------------
-----------------------------------------------------------------------------------------|||---------------------------------#--#-----------------------------------------------------------------------
-----------------#---#-----------------------%%%%%---%%%%%-----------%%%%%%%%%%%%%%------|||-------#--#------#---#----------##--##----------------------------------------------------------------------
%%%%%%%%%%%%%---##---##-----r----------------|||||---|||||%%%%---%%%%||||||||||||||------k|y-r----##--##----##---##--%%%%%%%%%--%%%%--------------------------------------------------------------------
|||||||||||||--###---###--%%%%%%%%%%%%---%%%%|||||---|||||||||---||||||||||||||||||%%%%%%%%%%%%%%%%%--%%%%%%%%---%%%%|||||||||--||||--------------------------------------------------------------------
|||||||||||||XXXXX---XXXXX||||||||||||---|||||||||---|||||||||---|||||||||||||||||||||||||||||||||||--||||||||---|||||||||||||--||||XXXX--XXXXXXXXXXXXFXXXXXXXXXXXXXXXXXXXXXXXXXXXXXXXXXXXXXXXXXXXXXXXXX
