HEIGHT=16;WIDTH=201;THEME=0;OVERRIDE=false
--------------------------------------------------------------------------------------------------------------------------------------------------------------------------------------------------------
--------------------------------------------------------------------------------------------------------------------------------------------------------------------------------------------------------
--------------------------------------------------------------------------------------------------------------------------------------------------------------------------------------------------------
--------------------------------------------------------------------------------------------------------------------------------------------------------------------------------------------------------
--------------------------------------------------------------------------------------------------------------------------------------------------------------------------------------------------------
--------------------------------------------------------------------------------------------------------------------------------------------------------------------------------------------------------
--------------------------------------------------------------------------------------------------------------------------------------------------------------------------------------------------------
--------------------------------------------------------------------------------------------------------------------------------------------------------------------------------------------------------
--------------------------------------------------------------------------------------------------------------------------------------------------------------------------------------------------------
----------------------------------------------------------------------------------------------------------------tt---tt---------------------------------------------------------------------------------
----------------------------------------------------------------------------------------------------------------tt---tt---------------Tt----------------------------------------------------------------
---------------------------------------------------------------------k---------------------------------y--------tt---tt---------------tt----------------------------------------------------------------
---------------------------------------------------------------g----%%%%%%----------%%---%%%%---%%-----%%%---%%%%%%%%%%%%%%%%---%%%%%-tt---%%%%%%%%F%%%%%%%%%%%%%%%%%%%%%%%%%%%%%%%%%%%%%%%%%%%%%%%%%%%%
-----------------------%%%--%%%%%--%%------------------%%--%%%%%%%%%||||||----------||---||||---||-----|||---||||||||||||||||---|||||%%%%%%||||||||%||||||||||||||||||||||||||||||||||||||||||||||||||||
-----------%%%%%--%%%%%|||--|||||--||------------------||--|||||||||||||||----------||---||||---||-r---kk|-r-||||||||||||||||---||||||||||||||||||||||||||||||||||||||||||||||||||||||||||||||||||||||||
XXXXXXXXXXX|||||--||||||||--|||||--||XXXXX--XXXXXXXXXXX||--|||||||||||||||XXXX--XXXX||---||||---||XXXXXXXXXXX||||||||||||||||---||||||||||||||||||||||||||||||||||||||||||||||||||||||||||||||||||||||||
