HEIGHT=16;WIDTH=201;THEME=0;OVERRIDE=false
--------------------------------------------------------------------------------------------------------------------------------------------------------------------------------------------------------
--------------------------------------------------------------------------------------------------------------------------------------------------------------------------------------------------------
--------------------------------------------------------------------------------------------------------------------------------------------------------------------------------------------------------
--------------------------------------------------------------------------------------------------------------------------------------------------------------------------------------------------------
--------------------------------------------------------------------------------------------------------------------------------------------------------------------------------------------------------
--------------------------------------------------------------------------------------------------------------------------------------------------------------------------------------------------------
--------------------------------------------------------------------------------------------------------------------------------------------------------------------------------------------------------
--------------------------------------------------------------------------------------------------------------------------------------------------------------------------------------------------------
------------------------------------------------------r-------------------------------------------------------------------------------------------------------------------------------------------------
---------------------SSU--------#--#-------------%%%%%%%------------------------------------------------------------------------------------------------------------------------------------------------
-------------------------------##--##------------|||||||-----------CSSU---------------------------------------------------------------------------------------------------------------------------------
------------------------------###--###-----------|||||||----------------------------------#---#---------------------------------------------------------------------------------------------------------
%%%%%%%%%%%%%---------------%%%%%--%%%%%---------|||||k|-----r------------%%%%%%%--------##---##-----------%%---%%%%%--%%%-------%%%%---%%%%%%%%F%%%%%%%%%%%%%%%%%%%%%%%%%%%%%%%%%%%%%%%%%%%%%%%%%%%%%%%
|||||||||||||------%%%%%%%%%|||||--|||||--------%%%%%%%%%%%%%%%------g----|||||||-------###---###----#--#--||---|||||--|||-------||||---||||||||%|||||||||||||||||||||||||||||||||||||||||||||||||||||||
|||||||||||||------||||||||||||||--|||||%%%--%%%|||||||||||||||%%%%%%%%%%%|||||||%%%%%%%%%%---%%%%%%%%--%%%||---|||||--|||%%%%%%%%%%%%%%||||||||||||||||||||||||||||||||||||||||||||||||||||||||||||||||
|||||||||||||XX--XX||||||||||||||--||||||||--||||||||||||||||||||||||||||||||||||||||||||||---||||||||--|||||---|||||--|||||||||||||||||||||||||||||||||||||||||||||||||||||||||||||||||||||||||||||||||
