HEIGHT=16;WIDTH=201;THEME=0;OVERRIDE=false
--------------------------------------------------------------------------------------------------------------------------------------------------------------------------------------------------------
--------------------------------------------------------------------------------------------------------------------------------------------------------------------------------------------------------
--------------------------------------------------------------------------------------------------------------------------------------------------------------------------------------------------------
--------------------------------------------------------------------------------------------------------------------------------------------------------------------------------------------------------
--------------------------------------------------------------------------------------------------------------------------------------------------------------------------------------------------------
--------------------------------------------------------------------------------------------------------------------------------------------------------------------------------------------------------
--------------------------------------------------------------------------------------------------------------------------------------------------------------------------------------------------------
--------------------------------------------------------------------------------------------------------------------------------------------------------------------------------------------------------
--------------------------------------------------------------------------------------------------------------------------------------------------------------------------------------------------------
-------------------------------------------SSS----------------------------------------------------------------------------------------------------------------------------------------------------------
--------------------------------------------------------------------------------------------------------------------------------------------------------------------------------------------------------
--------------------------------SSSCS------------------------------------------------------------------%%%%---------------------------------------------------------------------------------------------
--------------------%%--%%-----------------r----------------#---#------------%%%--%%%----#--#----------||K|---%%%%%--%%%%%%%---%%-----------------------------------------------------------------------
------------%%%--%%%||--||--------------%%%%%%%%%----------##---##-----------|||--|||---##--##---%%%%%%%%%%%%%|||||--|||||||---||-----------------------------------------------------------------------
%%%%%%%%%%%%|||--|||||--||--------------|||||||||--------%%%%---%%%%%%%---%%%|||--|||--###--###--||||||||||||||||||--|||||||---||%%--%%-------------%%%%%%%%F%%%%%%%%%%%%%%%%%%%%%%%%%%%%%%%%%%%%%%%%%%%
|||||||||||||||--|||||--||XXXXXXXXXXXXXX|||||||||XXX--XXX||||---|||||||---||||||--|||XXXXX--XXXXX||||||||||||||||||--|||||||---||||--||XXXXX---XXXXX||||||||X|||||||||||||||||||||||||||||||||||||||||||
