HEIGHT=16;WIDTH=201;THEME=0;OVERRIDE=false
--------------------------------------------------------------------------------------------------------------------------------------------------------------------------------------------------------
--------------------------------------------------------------------------------------------------------------------------------------------------------------------------------------------------------
--------------------------------------------------------------------------------------------------------------------------------------------------------------------------------------------------------
--------------------------------------------------------------------------------------------------------------------------------------------------------------------------------------------------------
--------------------------------------------------------------------------------------------------------------------------------------------------------------------------------------------------------
--------------------------------------------------------------------------------------------------------------------------------------------------------------------------------------------------------
--------------------------------------------------------------------------------------------------------------------------------------------------------------------------------------------------------
--------------------------------------------------------------------------------------------------------------------------------------------------------------------------------------------------------
--------------------------------------------------------------------------------------------------------------------------------------------------------------------------------------------------------
----------------%%%--------------------------------------------------------------------------------------------------SCCS-------------------------------------------------------------------------------
----------------|||---------------------------------SCSS------------------#---#-------------------------------------------------------------------------------------------------------------------------
----------------|||-----y------------------------------------------------##---##----2U2----------------------CCS------------#--#------------------------------------------------------------------------
-----------%%%%%%%%%%%%%%%----------------------------------------------###---###--------------------------------------rk-%%%--%%%----------------------------------------------------------------------
-----------|||||||||||||||-------------------------k------------------%%%%%---%%%%%----------------%%%--%%%---------%%%%%%|||--|||%%%%%---%%%%%---------------------------------------------------------
%%%%%%%%%%%|||||||||||||||%%%%---%%%%-------------%%%%%%%%%%%%%---%%%%|||||---|||||----------------|||--|||---k---k-|||||||||--||||||||---|||||---------------------------------------------------------
||||||||||||||||||||||||||||||---||||XXXXX---XXXXX|||||||||||||---|||||||||---|||||XXXXXXXXXX--XXXX|||--|||XXXXXXXXX|||||||||--||||||||---|||||XXXXXXXXFXXXXXXXXXXXXXXXXXXXXXXXXXXXXXXXXXXXXXXXXXXXXXXXX
