HEIGHT=16;WIDTH=201;THEME=0;OVERRIDE=false
--------------------------------------------------------------------------------------------------------------------------------------------------------------------------------------------------------
--------------------------------------------------------------------------------------------------------------------------------------------------------------------------------------------------------
--------------------------------------------------------------------------------------------------------------------------------------------------------------------------------------------------------
--------------------------------------------------------------------------------------------------------------------------------------------------------------------------------------------------------
--------------------------------------------------------------------------------------------------------------------------------------------------------------------------------------------------------
--------------------------------------------------------------------------------------------------------------------------------------------------------------------------------------------------------
--------------------------------------------------------------------------------------------------------------------------------------------------------------------------------------------------------
------------------------------------------------------------------------------------------%%%%%%--------------------------------------------------------------------------------------------------------
------------------------------------------------------------------------------------------||||||--------------------------------------------------------------------------------------------------------
------------------------------------------------------------------------------------------|||g||--------------------------------------------------------------------------------------------------------
------------------------------------------------------------------------------------------|%%%%%%%------------------------------------------------------------------------------------------------------
------------------------------------------------------------------------------------------||||||||------------------------------------------------------------------------------------------------------
-----------------------%%%%%%%----------------%%%%%--%%%%%----Tt--------------------------r|||||||------------------------------------------------------------------------------------------------------
-----------------#--#--|||||||%%--------------|||||--|||||----tt--tt------#---#---%%%%%%%%%%%%%%%%%%----------------------------------------------------------------------------------------------------
---------------%%%--%%%|||||||||%%%%%--#---#--|||||--|||||----tt--tt-----##---##--||||||||||||||||||%%%%--#--#-------------------------------%%%%%%%%F%%%%%%%%%%%%%%%%%%%%%%%%%%%%%%%%%%%%%%%%%%%%%%%%%%
XXXXXXXXXXXXXXX|||--|||||||||||||||||XXX---XXX|||||--|||||XXXXXXXXXXXXXXXXX---XXXX||||||||||||||||||||||XXX--XXXXXXX---XXXXXXXXX--XXXXXXX--XX||||||||X||||||||||||||||||||||||||||||||||||||||||||||||||
