HEIGHT=16;WIDTH=201;THEME=0;OVERRIDE=false
--------------------------------------------------------------------------------------------------------------------------------------------------------------------------------------------------------
--------------------------------------------------------------------------------------------------------------------------------------------------------------------------------------------------------
--------------------------------------------------------------------------------------------------------------------------------------------------------------------------------------------------------
--------------------------------------------------------------------------------------------------------------------------------------------------------------------------------------------------------
--------------------------------------------------------------------------------------------------------------------------------------------------------------------------------------------------------
--------------------------------------------------------------------------------------------------------------------------------------------------------------------------------------------------------
--------------------------------------------------------------------------------------------------------------------------------------------------------------------------------------------------------
--------------------------------------------------------------------------------------------------------------------------------------------------------------------------------------------------------
--------------------------------------------------------------------------------------------------------------------------------------------------------------------------------------------------------
--------------------------------------------------------------------------------------------------------------------------------------------------------------------------------------------------------
------------------------------------------------------------tt-------------------------------------------------------------------------%%%%-------------------------------------------------------------
------------------------------------------------------------tt-------------------------------------------------------------------------||||--ry---------------------------------------------------------
%%%%%%%%%%%%---Tt-------------------------------------------tt-----------Tt---------%%---%%%%--%%-----%%%%-------%%%--%%%--------------|%%%%%%%---------------------------------------------------------
||||||||||||---tt--%%%%%%%%%%%--------------------------%%%%%%%%%%%%%%%--tt--Tt--tt-||---||||--||-----||||-------|||--|||%%%%%---------||||||||----%%%%%%%%F%%%%%%%%%%%%%%%%%%%%%%%%%%%%%%%%%%%%%%%%%%%%
||||||||||||---tt--|||||||||||%%%%%---%%%%%-------------|||||||||||||||--tt--tt--tt-||---||||--||-----||||%%---%%|||--||||||||------%%%%%%%%%%%%%%%||||||||%||||||||||||||||||||||||||||||||||||||||||||
||||||||||||XXXXXXX||||||||||||||||---|||||XXXXX---XXXXX|||||||||||||||XXXXXXXXXXXXX||---||||--||XXXXX||||||---|||||--||||||||XX--XX||||||||||||||||||||||||||||||||||||||||||||||||||||||||||||||||||||
