HEIGHT=16;WIDTH=201;THEME=0;OVERRIDE=false
--------------------------------------------------------------------------------------------------------------------------------------------------------------------------------------------------------
--------------------------------------------------------------------------------------------------------------------------------------------------------------------------------------------------------
--------------------------------------------------------------------------------------------------------------------------------------------------------------------------------------------------------
--------------------------------------------------------------------------------------------------------------------------------------------------------------------------------------------------------
--------------------------------------------------------------------------------------------------------------------------------------------------------------------------------------------------------
--------------------------------------------------------------------------------------------------------------------------------------------------------------------------------------------------------
--------------------------------------------------------------------------------------------------------------------------------------------------------------------------------------------------------
--------------------------------------------------------------------------------------------------------------------------------------------------------------------------------------------------------
--------------------------------------------------------------------------------------------------------------------------------------------------------------------------------------------------------
--------------------------------------------------------------------------------------------------------------------------------------------------------------------------------------------------------
------------------------------------------------------------------------------------------------k-------------------------------------------------------------------------------------------------------
-----------------------------------------------------------#--#------------------------------%%%%-------------------------------------------------------------------------------------------------------
------------------------%%%--%%%%%%%%--%%%%%--------------##--##-----------------------------||||-----------------------%%---%%-------------------------------------------------------------------------
-----------------#--#---|||--||||||||--|||||-------------###--###----------%%---%%%%%%--%%%%-||||-----------------------||---||----------%%%%%%%%F%%%%%%%%%%%%%%%%%%%%%%%%%%%%%%%%%%%%%%%%%%%%%%%%%%%%%%
----------------##--##--|||--||||||||--|||||-----------%%%%%--%%%%%--------||---||||||--||||-||||--g-r------------------||---||----------||||||||%||||||||||||||||||||||||||||||||||||||||||||||||||||||
XXXXXXXXXXXXXXXXXX--XXXX|||--||||||||--|||||XXXX---XXXX|||||--|||||XXX--XXX||---||||||--||||XXXXXXXXXXXXXXXXXXXXXXXXXXXX||---||XXXX--XXXX|||||||||||||||||||||||||||||||||||||||||||||||||||||||||||||||
