HEIGHT=16;WIDTH=201;THEME=0;OVERRIDE=false
--------------------------------------------------------------------------------------------------------------------------------------------------------------------------------------------------------
--------------------------------------------------------------------------------------------------------------------------------------------------------------------------------------------------------
--------------------------------------------------------------------------------------------------------------------------------------------------------------------------------------------------------
--------------------------------------------------------------------------------------------------------------------------------------------------------------------------------------------------------
--------------------------------------------------------------------------------------------------------------------------------------------------------------------------------------------------------
--------------------------------------------------------------------------------------------------------------------------------------------------------------------------------------------------------
--------------------------------------------------------------------------------------------------------------------------------------------------------------------------------------------------------
--------------------------------------------------------------------------------------------------------------------------------------------------------------------------------------------------------
--------------------------------------------------------------------------------------------------------------------------------------------------------------------------------------------------------
--------------------------#---#-------------------------------------------------------------------------------------------------------------------------------------------------------------------------
-------------------------##---##------#---#-------------------------------------------------------------------------------------------------------------------------------------------------------------
------------------------###---###----##---##--------------k---------------------------------------------------------------------------------------------------------------------------------------------
%%%%%%%%%%%-----------%%%%%---%%%%%%%%%---%%%%%%%---%%%--%%%%---------------------------------------#--#----%%%%%---%%%%%----#--#----%%%%%%%------------------------------------------------------------
|||||||||||%%%%---%%%%|||||---|||||||||---|||||||---|||-r||||------g-------------------------------##--##---|||||---|||||---##--##---|||||||------------------------------------------------------------
|||||||||||||||---|||||||||---|||||||||---|||||||---|||%%%%%%%%%%%%%%%%%%--%%%%%%--%%%%--#---#----###--###--|||||---|||||--###--###--|||||||%%%%%%%%F%%%%%%%%%%%%%%%%%%%%%%%%%%%%%%%%%%%%%%%%%%%%%%%%%%%
|||||||||||||||---|||||||||---|||||||||---|||||||---|||||||||||||||||||||--||||||--||||XXX---XXXXXXXX--XXXXX|||||---|||||XXXXX--XXXXX|||||||||||||||X|||||||||||||||||||||||||||||||||||||||||||||||||||
