HEIGHT=16;WIDTH=201;THEME=0;OVERRIDE=false
--------------------------------------------------------------------------------------------------------------------------------------------------------------------------------------------------------
--------------------------------------------------------------------------------------------------------------------------------------------------------------------------------------------------------
--------------------------------------------------------------------------------------------------------------------------------------------------------------------------------------------------------
--------------------------------------------------------------------------------------------------------------------------------------------------------------------------------------------------------
--------------------------------------------------------------------------------------------------------------------------------------------------------------------------------------------------------
--------------------------------------------------------------------------------------------------------------------------------------------------------------------------------------------------------
--------------------------------------------------------------------------------------------------------------------------------------------------------------------------------------------------------
--------------------------------------------------------------------------------------------------------------------------------------------------------------------------------------------------------
--------------------------------------------------------------------------------------------------------------------------------------------------------------------------------------------------------
-----------------------------------------------------------------------#---#-------------------Y--------------------------------------------------------------------------------------------------------
-------------------------------------------------------Tt------Tt-----##---##------------------%%%------------------------------------------------------------------------------------------------------
-------------------------------------------------------tt--tt--tt----###---###-----------------|||----------------------------SSS2U2CCS-----------------------------------------------------------------
-------------%%%%---%%%%-----------------%%%%%---%%%%%-tt--tt--tt--%%%%%---%%%%%---------------|||------------%%--%%%%%---%%%---------------------------------------------------------------------------
-------------||||---||||%%%--%%%--#---#--|||||---|||||%%%%%%%%%%%%%|||||---|||||%%%%%---%%%%%%%%%%%%%%%-------||--|||||---|||---------------------------------------------------------------------------
%%%%%%%%%%%%%||||---|||||||--|||%%%---%%%|||||---|||||||||||||||||||||||---||||||||||---|||||||||||||||%%---%%||--|||||---|||-----------%%%%%%%%F%%%%%%%%%%%%%%%%%%%%%%%%%%%%%%%%%%%%%%%%%%%%%%%%%%%%%%%
|||||||||||||||||---|||||||--||||||---||||||||---|||||||||||||||||||||||---||||||||||---|||||||||||||||||---||||--|||||---|||XXXXXXXXXXX||||||||X|||||||||||||||||||||||||||||||||||||||||||||||||||||||
