HEIGHT=16;WIDTH=201;THEME=0;OVERRIDE=false
--------------------------------------------------------------------------------------------------------------------------------------------------------------------------------------------------------
--------------------------------------------------------------------------------------------------------------------------------------------------------------------------------------------------------
--------------------------------------------------------------------------------------------------------------------------------------------------------------------------------------------------------
--------------------------------------------------------------------------------------------------------------------------------------------------------------------------------------------------------
--------------------------------------------------------------------------------------------------------------------------------------------------------------------------------------------------------
--------------------------------------------------------------------------------------------------------------------------------------------------------------------------------------------------------
--------------------------------------------------------------------------------------------------------------------------------------------------------------------------------------------------------
--------------------------------------------------------------------------------------------------------------------------------------------------------------------------------------------------------
--------------------------------------------------------------------------------------------------------------------------------------------------------------------------------------------------------
-------------------------------------------------------------------SCCS----------------------------------------------------------#--#-------------------------------------------------------------------
------------------------------------------------------------------------------------------tt--tt--------------------------------##--##------------------------------------------------------------------
--------------------------------------------------------------------------------%%%%------tt--tt----------------Tt-Tt----------###--###-----------------------------------------------------------------
-------------------------------%%%--%%%-------%%---%%--------k------------------||||------tt--tt----------------tt-tt--------%%%%%--%%%%%---------------------------------------------------------------
------------%%%----------------|||--|||-------||---||---%%%%%%--%%%%%%%%%%--y--r||||--%%%%%%%%%%%------------%%%%%%%%%%%-----|||||--|||||---------------------------------------------------------------
%%%%%%%%%%%%|||-------%%%---%%%|||--|||-------||---||---||||||--||||||||||%%%%%%%%%%%%|||||||||||------------|||||||||||%%%%%|||||--|||||%%%%%%%%F%%%%%%%%%%%%%%%%%%%%%%%%%%%%%%%%%%%%%%%%%%%%%%%%%%%%%%
|||||||||||||||XX---XX|||---||||||--|||XXXXXXX||---||XXXXXXXXXXX|||||||||||||||||||||||||||||||||XXXXX--XXXXX|||||||||||||||||||||--|||||||||||||X||||||||||||||||||||||||||||||||||||||||||||||||||||||
