HEIGHT=16;WIDTH=201;THEME=0;OVERRIDE=false
--------------------------------------------------------------------------------------------------------------------------------------------------------------------------------------------------------
--------------------------------------------------------------------------------------------------------------------------------------------------------------------------------------------------------
--------------------------------------------------------------------------------------------------------------------------------------------------------------------------------------------------------
--------------------------------------------------------------------------------------------------------------------------------------------------------------------------------------------------------
--------------------------------------------------------------------------------------------------------------------------------------------------------------------------------------------------------
--------------------------------------------------------------------------------------------------------------------------------------------------------------------------------------------------------
--------------------------------------------------------------------------------------------------------------------------------------------------------------------------------------------------------
--------------------------------------------------------------------------------------------------------------------------------------------------------------------------------------------------------
--------------------------------------------------------------------------------------------------------------------------------------------------------------------------------------------------------
-----------------------------------------tt-----------------------------------------g---k---------------------------------------------------------------------------------------------------------------
------------------------------------tt---tt-------------------------------#---#-----%%%%%---------------------------------------------------------------------------------------------------------------
------------------------------------tt---tt------------------------------##---##----|||||------------#--#-----------------------------------------------------------------------------------------------
------------------------------------tt--%%%%%%%%-----------------------%%%%---%%%%--|Gy||----k------##--##--------%%%--%%%------------------------------------------------------------------------------
-----------------------------------%%%%%||||||||-----------------------||||---||||%%%%%%%%%%%%%%%%%%%%--%%%%------|||--|||---#---#----------------------------------------------------------------------
-----------------------------%%%%%%|||||||||||||-----------------------||||---||||||||||||||||||||||||--||||%%--%%|||--|||--##---##--%%--%%%%%%%%%%F%%%%%%%%%%%%%%%%%%%%%%%%%%%%%%%%%%%%%%%%%%%%%%%%%%%%
XXXXXXXXXXXXXXXX--XXXXX---XXX|||||||||||||||||||XXXXX--XXXXXXXXX---XXXX||||---||||||||||||||||||||||||--||||||--|||||--|||XXXX---XXXX||--||||||||||X||||||||||||||||||||||||||||||||||||||||||||||||||||
