HEIGHT=16;WIDTH=201;THEME=0;OVERRIDE=false
--------------------------------------------------------------------------------------------------------------------------------------------------------------------------------------------------------
--------------------------------------------------------------------------------------------------------------------------------------------------------------------------------------------------------
--------------------------------------------------------------------------------------------------------------------------------------------------------------------------------------------------------
--------------------------------------------------------------------------------------------------------------------------------------------------------------------------------------------------------
--------------------------------------------------------------------------------------------------------------------------------------------------------------------------------------------------------
--------------------------------------------------------------------------------------------------------------------------------------------------------------------------------------------------------
--------------------------------------------------------------------------------------------------------------------------------------------------------------------------------------------------------
--------------------------------------------------------------------------------------------------------------------------------------------------------------------------------------------------------
----------------------------------------------------------------------------------------------------------2SCC------------------------------------------------------------------------------------------
--------------------------------------------------------------------------------------------------------------------------------------------------------------------------------------------------------
-----------------------------------------------------------------------#--#-------------------------------------------------------------#--#------------------------------------------------------------
-----------------------------------------#--#-------------------------##--##----------------------------krg-g--------------------------##--##-----------------------------------------------------------
%%%%%%%%%%%%%-----------------%%---%%---##--##-------%%%%%%%%%%%%%%%%%%%--%%%%-------------------------%%%%%%%%%-------------%%%--%%%%%%%--%%%%---------------------------------------------------------
|||||||||||||--------%%%---%%%||---||--###--###------|||||||||||||||||||--||||--#--#--%%---%%----------|||||||||----------%%%|||--|||||||--||||%%%%%%%%F%%%%%%%%%%%%%%%%%%%%%%%%%%%%%%%%%%%%%%%%%%%%%%%%
|||||||||||||%%------|||---|||||---||%%%%%--%%%%%----|||||||||||||||||||--||||%%%--%%%||---||----------|||||||||%%%%--%%%%||||||--|||||||--||||||||||||%||||||||||||||||||||||||||||||||||||||||||||||||
|||||||||||||||XX--XX|||---|||||---|||||||--|||||XXXX|||||||||||||||||||--|||||||--|||||---||XXXX--XXXX|||||||||||||--||||||||||--|||||||--|||||||||||||||||||||||||||||||||||||||||||||||||||||||||||||
